channel_id,sequence,send_height,ack_height,block_delay,send_time,ack_time,time_delay_sec
channel-75,844950,30280033,30280038,5,2025-02-24 20:01:36.005041,2025-02-24 20:01:42.545394,6.540353
channel-75,844951,30280072,30280080,8,2025-02-24 20:02:32.787620,2025-02-24 20:02:43.739211,10.951591
channel-75,844952,30280604,30280610,6,2025-02-24 20:14:17.923148,2025-02-24 20:14:25.169958,7.24681
channel-75,844953,30280889,30280896,7,2025-02-24 20:20:30.287686,2025-02-24 20:20:38.292960,8.005274
channel-75,844954,30281664,30281671,7,2025-02-24 20:37:22.783189,2025-02-24 20:37:31.654062,8.870873
channel-75,844955,30281737,30281743,6,2025-02-24 20:38:58.968761,2025-02-24 20:39:06.486674,7.517913
channel-75,844956,30281887,30281895,8,2025-02-24 20:42:15.995040,2025-02-24 20:42:25.476518,9.481478
channel-75,844957,30281895,30281899,4,2025-02-24 20:42:25.476518,2025-02-24 20:42:31.252423,5.775905
channel-75,844958,30282162,30282169,7,2025-02-24 20:48:22.919558,2025-02-24 20:48:31.653832,8.734274
channel-75,844959,30282182,30282191,9,2025-02-24 20:48:48.901005,2025-02-24 20:49:02.883069,13.982064
channel-75,844960,30282249,30282258,9,2025-02-24 20:50:17.618440,2025-02-24 20:50:32.723435,15.104995
channel-75,844961,30282300,30282310,10,2025-02-24 20:51:25.607895,2025-02-24 20:51:38.154034,12.546139
channel-75,844962,30282483,30282489,6,2025-02-24 20:55:29.691397,2025-02-24 20:55:38.889018,9.197621
channel-75,844963,30282661,30282670,9,2025-02-24 20:59:22.594156,2025-02-24 20:59:34.277972,11.683816
channel-75,844964,30282708,30282715,7,2025-02-24 21:00:27.153610,2025-02-24 21:00:35.652559,8.498949
channel-75,844965,30282753,30282761,8,2025-02-24 21:01:25.237690,2025-02-24 21:01:34.854995,9.617305
channel-75,844966,30282827,30282836,9,2025-02-24 21:03:06.969600,2025-02-24 21:03:17.853043,10.883443
channel-75,844967,30283387,30283394,7,2025-02-24 21:15:23.837087,2025-02-24 21:15:33.664251,9.827164
channel-75,844968,30283875,30283886,11,2025-02-24 21:26:03.839450,2025-02-24 21:26:18.044042,14.204592
channel-75,844969,30284025,30284033,8,2025-02-24 21:29:20.186486,2025-02-24 21:29:29.461960,9.275474
channel-75,844970,30284051,30284058,7,2025-02-24 21:29:53.075239,2025-02-24 21:30:06.516559,13.44132
channel-75,844971,30284204,30284213,9,2025-02-24 21:33:18.553273,2025-02-24 21:33:30.341546,11.788273
channel-75,844972,30284277,30284285,8,2025-02-24 21:34:58.900467,2025-02-24 21:35:09.673893,10.773426
channel-75,844973,30284473,30284482,9,2025-02-24 21:39:13.919722,2025-02-24 21:39:24.906879,10.987157
channel-75,844974,30284801,30284807,6,2025-02-24 21:46:24.068498,2025-02-24 21:46:32.306939,8.238441
channel-75,844975,30284801,30284807,6,2025-02-24 21:46:24.068498,2025-02-24 21:46:32.306939,8.238441
channel-75,844976,30284909,30284917,8,2025-02-24 21:48:47.432451,2025-02-24 21:48:57.227843,9.795392
channel-75,844977,30284978,30284985,7,2025-02-24 21:50:19.480127,2025-02-24 21:50:27.487711,8.007584
channel-75,844978,30285442,30285449,7,2025-02-24 22:00:27.269404,2025-02-24 22:00:35.723634,8.45423
channel-75,844979,30285555,30285562,7,2025-02-24 22:03:19.529267,2025-02-24 22:03:28.398613,8.869346
channel-75,844980,30285567,30285574,7,2025-02-24 22:03:35.497154,2025-02-24 22:03:45.309506,9.812352
channel-75,844981,30285868,30285887,19,2025-02-24 22:10:30.597420,2025-02-24 22:10:55.874502,25.277082
channel-75,844982,30285893,30285899,6,2025-02-24 22:11:04.114830,2025-02-24 22:11:16.399726,12.284896
channel-75,844983,30286220,30286234,14,2025-02-24 22:18:25.347919,2025-02-24 22:18:47.489265,22.141346
channel-75,844984,30287173,30287179,6,2025-02-24 22:39:23.825563,2025-02-24 22:39:35.627800,11.802237
channel-75,844985,30287386,30287394,8,2025-02-24 22:44:07.246959,2025-02-24 22:44:17.443658,10.196699
channel-75,844986,30287413,30287422,9,2025-02-24 22:44:44.841363,2025-02-24 22:44:55.364520,10.523157
channel-75,844987,30287424,30287429,5,2025-02-24 22:44:57.704979,2025-02-24 22:45:04.711953,7.006974
channel-75,844988,30287424,30287437,13,2025-02-24 22:44:57.704979,2025-02-24 22:45:15.313559,17.60858
channel-75,844989,30287434,30287440,6,2025-02-24 22:45:11.911486,2025-02-24 22:45:21.159821,9.248335
channel-75,844990,30288026,30288042,16,2025-02-24 22:58:27.133249,2025-02-24 22:58:49.895222,22.761973
channel-75,844991,30288034,30288039,5,2025-02-24 22:58:37.754699,2025-02-24 22:58:44.547756,6.793057
channel-75,844992,30288058,30288064,6,2025-02-24 22:59:15.360899,2025-02-24 22:59:22.426817,7.065918
channel-75,844993,30288280,30288288,8,2025-02-24 23:04:17.235662,2025-02-24 23:04:26.608292,9.37263
channel-75,844994,30289094,30289112,18,2025-02-24 23:22:11.919907,2025-02-24 23:22:33.591897,21.67199
channel-75,844995,30289342,30289349,7,2025-02-24 23:27:41.034075,2025-02-24 23:27:50.454136,9.420061
channel-75,844996,30289414,30289423,9,2025-02-24 23:29:16.352132,2025-02-24 23:29:29.180352,12.82822
channel-75,844997,30289795,30289801,6,2025-02-24 23:37:50.191700,2025-02-24 23:37:58.438281,8.246581
channel-75,844998,30290023,30290031,8,2025-02-24 23:42:58.928892,2025-02-24 23:43:08.944293,10.015401
channel-75,844999,30290106,30290113,7,2025-02-24 23:44:49.477782,2025-02-24 23:44:58.826698,9.348916
channel-75,845000,30290418,30290425,7,2025-02-24 23:51:45.621566,2025-02-24 23:51:55.151068,9.529502
channel-75,845001,30290502,30290508,6,2025-02-24 23:53:34.942867,2025-02-24 23:53:42.093774,7.150907
channel-75,845002,30290606,30290613,7,2025-02-24 23:55:51.795298,2025-02-24 23:56:00.308872,8.513574
channel-75,845003,30290715,30290722,7,2025-02-24 23:58:14.918448,2025-02-24 23:58:23.164428,8.24598
channel-75,845004,30290886,30290893,7,2025-02-25 00:01:58.920637,2025-02-25 00:02:08.203352,9.282715
channel-75,845005,30291102,30291109,7,2025-02-25 00:06:48.996704,2025-02-25 00:06:58.359787,9.363083
channel-75,845006,30291121,30291127,6,2025-02-25 00:07:14.795042,2025-02-25 00:07:25.235251,10.440209
channel-75,845007,30291192,30291199,7,2025-02-25 00:08:49.434004,2025-02-25 00:08:57.520766,8.086762
channel-75,845008,30291209,30291217,8,2025-02-25 00:09:15.566536,2025-02-25 00:09:24.945374,9.378838
channel-75,845009,30291449,30291455,6,2025-02-25 00:14:38.685132,2025-02-25 00:14:47.025662,8.34053
channel-75,845010,30291465,30291473,8,2025-02-25 00:15:02.368557,2025-02-25 00:15:12.478552,10.109995
channel-75,845011,30292241,30292247,6,2025-02-25 00:32:17.162522,2025-02-25 00:32:25.377142,8.21462
channel-75,845012,30292515,30292523,8,2025-02-25 00:38:20.203240,2025-02-25 00:38:30.182600,9.97936
channel-75,845013,30292577,30292584,7,2025-02-25 00:39:39.195128,2025-02-25 00:39:47.252470,8.057342
channel-75,845014,30292692,30292700,8,2025-02-25 00:42:10.552133,2025-02-25 00:42:20.059108,9.506975
channel-75,845015,30295199,30295206,7,2025-02-25 01:37:30.630915,2025-02-25 01:37:38.807355,8.17644
channel-75,845016,30295376,30295384,8,2025-02-25 01:41:27.968868,2025-02-25 01:41:37.233227,9.264359
channel-75,845017,30295418,30295426,8,2025-02-25 01:42:22.692024,2025-02-25 01:42:33.623549,10.931525
channel-75,845018,30295505,30295511,6,2025-02-25 01:44:19.310500,2025-02-25 01:44:27.229902,7.919402
channel-75,845019,30295946,30295952,6,2025-02-25 01:54:01.050963,2025-02-25 01:54:08.096837,7.045874
channel-75,845020,30298368,30298375,7,2025-02-25 02:47:25.629383,2025-02-25 02:47:33.825057,8.195674
channel-75,845021,30299510,30299518,8,2025-02-25 03:14:00.794078,2025-02-25 03:14:11.212651,10.418573
channel-75,845022,30299527,30299549,22,2025-02-25 03:14:23.822501,2025-02-25 03:14:52.090237,28.267736
channel-75,845023,30299775,30299783,8,2025-02-25 03:20:36.747533,2025-02-25 03:20:47.244884,10.497351
channel-75,845024,30299826,30299842,16,2025-02-25 03:21:45.966787,2025-02-25 03:22:08.508484,22.541697
channel-75,845025,30300791,30300798,7,2025-02-25 03:42:58.432517,2025-02-25 03:43:07.357246,8.924729
channel-75,845026,30301047,30301056,9,2025-02-25 03:48:37.452977,2025-02-25 03:48:49.075017,11.62204
channel-75,845027,30301116,30301123,7,2025-02-25 03:50:11.708627,2025-02-25 03:50:19.444381,7.735754
channel-75,845028,30301206,30301214,8,2025-02-25 03:52:06.784885,2025-02-25 03:52:16.834535,10.04965
channel-75,845029,30301626,30301638,12,2025-02-25 04:01:10.472797,2025-02-25 04:01:25.838150,15.365353
channel-75,845030,30301700,30301708,8,2025-02-25 04:02:45.620493,2025-02-25 04:02:56.422900,10.802407
channel-75,845031,30301754,30301762,8,2025-02-25 04:03:58.047492,2025-02-25 04:04:08.643494,10.596002
channel-75,845032,30301833,30301841,8,2025-02-25 04:05:38.156395,2025-02-25 04:05:47.545902,9.389507
channel-75,845033,30302055,30302072,17,2025-02-25 04:10:23.038349,2025-02-25 04:10:44.682733,21.644384
channel-75,845034,30302767,30302774,7,2025-02-25 04:25:41.286158,2025-02-25 04:25:53.295087,12.008929
channel-75,845035,30303224,30303233,9,2025-02-25 04:35:35.080939,2025-02-25 04:35:46.140248,11.059309
channel-75,845036,30303369,30303377,8,2025-02-25 04:38:40.382492,2025-02-25 04:38:49.922872,9.54038
channel-75,845037,30303443,30303450,7,2025-02-25 04:40:16.645667,2025-02-25 04:40:25.964486,9.318819
channel-75,845038,30304427,30304434,7,2025-02-25 05:01:28.800026,2025-02-25 05:01:36.965097,8.165071
channel-75,845039,30304464,30304472,8,2025-02-25 05:02:15.570012,2025-02-25 05:02:24.507862,8.93785
channel-75,845040,30304498,30304505,7,2025-02-25 05:02:57.069174,2025-02-25 05:03:06.241600,9.172426
channel-75,845041,30304506,30304511,5,2025-02-25 05:03:07.418813,2025-02-25 05:03:14.219644,6.800831
channel-75,845042,30304532,30304541,9,2025-02-25 05:03:44.028774,2025-02-25 05:03:55.187764,11.15899
channel-75,845043,30304656,30304671,15,2025-02-25 05:06:23.351137,2025-02-25 05:06:41.746272,18.395135
channel-75,845044,30305271,30305277,6,2025-02-25 05:19:44.138890,2025-02-25 05:19:53.749111,9.610221
channel-75,845045,30305577,30305584,7,2025-02-25 05:26:24.633496,2025-02-25 05:26:34.223049,9.589553
channel-75,845046,30305766,30305773,7,2025-02-25 05:30:27.230063,2025-02-25 05:30:37.149822,9.919759
channel-75,845047,30305968,30305976,8,2025-02-25 05:34:47.187129,2025-02-25 05:34:56.777407,9.590278
channel-75,845048,30306020,30306029,9,2025-02-25 05:35:55.399565,2025-02-25 05:36:05.541294,10.141729
channel-75,845049,30306687,30306694,7,2025-02-25 05:50:13.665078,2025-02-25 05:50:22.679668,9.01459
channel-75,845050,30306868,30306874,6,2025-02-25 05:54:10.782550,2025-02-25 05:54:19.696190,8.91364
channel-75,845051,30306872,30306880,8,2025-02-25 05:54:17.433008,2025-02-25 05:54:26.980250,9.547242
channel-75,845052,30307019,30307025,6,2025-02-25 05:57:25.029999,2025-02-25 05:57:32.773524,7.743525
channel-75,845053,30307259,30307273,14,2025-02-25 06:02:44.363771,2025-02-25 06:03:01.898162,17.534391
channel-75,845054,30307266,30307273,7,2025-02-25 06:02:52.756637,2025-02-25 06:03:01.898162,9.141525
channel-75,845055,30307550,30307557,7,2025-02-25 06:09:02.586188,2025-02-25 06:09:13.790425,11.204237
channel-75,845056,30307632,30307638,6,2025-02-25 06:10:49.752892,2025-02-25 06:10:58.454983,8.702091
channel-75,845057,30307748,30307757,9,2025-02-25 06:13:21.363222,2025-02-25 06:13:32.886297,11.523075
channel-75,845058,30308194,30308200,6,2025-02-25 06:22:56.910131,2025-02-25 06:23:04.891424,7.981293
channel-75,845059,30308610,30308619,9,2025-02-25 06:31:57.631580,2025-02-25 06:32:08.284313,10.652733
channel-75,845060,30308703,30308710,7,2025-02-25 06:33:51.886964,2025-02-25 06:34:02.937417,11.050453
channel-75,845061,30308733,30308749,16,2025-02-25 06:34:32.651737,2025-02-25 06:34:51.099680,18.447943
channel-75,845062,30309270,30309278,8,2025-02-25 06:46:10.434738,2025-02-25 06:46:20.151863,9.717125
channel-75,845063,30309471,30309477,6,2025-02-25 06:50:32.787879,2025-02-25 06:50:40.227447,7.439568
channel-75,845064,30309575,30309582,7,2025-02-25 06:52:43.973918,2025-02-25 06:52:54.301831,10.327913
channel-75,845065,30309642,30309649,7,2025-02-25 06:54:13.081169,2025-02-25 06:54:23.060878,9.979709
channel-75,845066,30309651,30309657,6,2025-02-25 06:54:25.385148,2025-02-25 06:54:33.694251,8.309103
channel-75,845067,30309951,30309956,5,2025-02-25 07:00:49.634376,2025-02-25 07:00:58.028804,8.394428
channel-75,845068,30309964,30309971,7,2025-02-25 07:01:09.814659,2025-02-25 07:01:18.640519,8.82586
channel-75,845069,30310052,30310057,5,2025-02-25 07:03:02.756225,2025-02-25 07:03:08.423772,5.667547
channel-75,845070,30310067,30310073,6,2025-02-25 07:03:25.505681,2025-02-25 07:03:34.011141,8.50546
channel-75,845071,30310152,30310161,9,2025-02-25 07:05:16.049092,2025-02-25 07:05:27.772619,11.723527
channel-75,845072,30310207,30310225,18,2025-02-25 07:06:25.403853,2025-02-25 07:06:47.539622,22.135769
channel-75,845073,30310243,30310256,13,2025-02-25 07:07:15.202532,2025-02-25 07:07:35.631461,20.428929
channel-75,845074,30310256,30310264,8,2025-02-25 07:07:35.631461,2025-02-25 07:07:44.967791,9.33633
channel-75,845075,30310471,30310480,9,2025-02-25 07:12:17.306990,2025-02-25 07:12:27.795018,10.488028
channel-75,845076,30310570,30310583,13,2025-02-25 07:14:21.268174,2025-02-25 07:14:40.014907,18.746733
channel-75,845077,30310782,30310791,9,2025-02-25 07:19:00.842318,2025-02-25 07:19:12.404975,11.562657
channel-75,845078,30310803,30310810,7,2025-02-25 07:19:27.574682,2025-02-25 07:19:35.869197,8.294515
channel-75,845079,30310906,30310913,7,2025-02-25 07:21:40.533193,2025-02-25 07:21:48.602130,8.068937
channel-75,845080,30310960,30310969,9,2025-02-25 07:22:53.250301,2025-02-25 07:23:04.153627,10.903326
channel-75,845081,30310968,30310980,12,2025-02-25 07:23:02.922412,2025-02-25 07:23:19.080821,16.158409
channel-75,845082,30311064,30311071,7,2025-02-25 07:25:08.531303,2025-02-25 07:25:16.659247,8.127944
channel-75,845083,30311108,30311115,7,2025-02-25 07:26:12.480120,2025-02-25 07:26:21.005946,8.525826
channel-75,845084,30311111,30311117,6,2025-02-25 07:26:16.131005,2025-02-25 07:26:23.261256,7.130251
channel-75,845085,30311448,30311455,7,2025-02-25 07:33:32.179271,2025-02-25 07:33:40.771219,8.591948
channel-75,845086,30311570,30311578,8,2025-02-25 07:36:14.208731,2025-02-25 07:36:24.189748,9.981017
channel-75,845087,30311652,30311660,8,2025-02-25 07:37:59.417514,2025-02-25 07:38:10.470404,11.05289
channel-75,845088,30311759,30311767,8,2025-02-25 07:40:24.286899,2025-02-25 07:40:33.827242,9.540343
channel-75,845089,30311862,30311871,9,2025-02-25 07:42:38.959392,2025-02-25 07:42:49.590333,10.630941
channel-75,845090,30311882,30311890,8,2025-02-25 07:43:04.749381,2025-02-25 07:43:14.233384,9.484003
channel-75,845091,30312477,30312481,4,2025-02-25 07:56:07.812807,2025-02-25 07:56:16.759189,8.946382
channel-75,845092,30312670,30312678,8,2025-02-25 08:00:20.159022,2025-02-25 08:00:29.847524,9.688502
channel-75,845093,30312725,30312732,7,2025-02-25 08:01:28.663328,2025-02-25 08:01:38.316250,9.652922
channel-75,845094,30312833,30312844,11,2025-02-25 08:03:58.682016,2025-02-25 08:04:12.631986,13.94997
channel-75,845095,30312967,30312974,7,2025-02-25 08:06:53.519676,2025-02-25 08:07:02.076371,8.556695
channel-75,845096,30313115,30313123,8,2025-02-25 08:10:06.029015,2025-02-25 08:10:15.282028,9.253013
channel-75,845097,30313312,30313320,8,2025-02-25 08:14:23.082504,2025-02-25 08:14:32.622008,9.539504
channel-75,845098,30313315,30313323,8,2025-02-25 08:14:26.503591,2025-02-25 08:14:36.049974,9.546383
channel-75,845099,30313697,30313703,6,2025-02-25 08:22:45.456737,2025-02-25 08:22:55.524064,10.067327
channel-75,845100,30313759,30313768,9,2025-02-25 08:24:05.868158,2025-02-25 08:24:16.433801,10.565643
channel-75,845101,30313832,30313840,8,2025-02-25 08:25:42.735256,2025-02-25 08:25:53.875958,11.140702
channel-75,845102,30314894,30314902,8,2025-02-25 08:48:43.981221,2025-02-25 08:48:53.867269,9.886048
channel-75,845103,30314950,30314957,7,2025-02-25 08:49:57.045864,2025-02-25 08:50:05.271931,8.226067
channel-75,845104,30314975,30314982,7,2025-02-25 08:50:28.607208,2025-02-25 08:50:37.393620,8.786412
channel-75,845105,30315767,30315772,5,2025-02-25 09:07:38.977469,2025-02-25 09:07:46.871921,7.894452
channel-75,845106,30315787,30315794,7,2025-02-25 09:08:05.240494,2025-02-25 09:08:13.454079,8.213585
channel-75,845107,30315839,30315849,10,2025-02-25 09:09:10.718562,2025-02-25 09:09:23.189043,12.470481
channel-75,845108,30316193,30316198,5,2025-02-25 09:16:56.612291,2025-02-25 09:17:04.963214,8.350923
channel-75,845109,30316400,30316407,7,2025-02-25 09:21:36.925838,2025-02-25 09:21:47.083558,10.15772
channel-75,845110,30317229,30317236,7,2025-02-25 09:39:48.716470,2025-02-25 09:39:57.638682,8.922212
channel-75,845111,30317285,30317293,8,2025-02-25 09:41:00.165715,2025-02-25 09:41:10.105812,9.940097
channel-75,845112,30317436,30317454,18,2025-02-25 09:44:19.020677,2025-02-25 09:44:42.197418,23.176741
channel-75,845113,30317460,30317478,18,2025-02-25 09:44:50.820676,2025-02-25 09:45:12.562743,21.742067
channel-75,845114,30317737,30317744,7,2025-02-25 09:50:45.179752,2025-02-25 09:50:57.628783,12.449031
channel-75,845115,30317926,30317935,9,2025-02-25 09:55:05.153074,2025-02-25 09:55:15.418655,10.265581
channel-75,845116,30318247,30318266,19,2025-02-25 10:02:26.713498,2025-02-25 10:02:53.963825,27.250327
channel-75,845117,30318361,30318370,9,2025-02-25 10:05:01.996740,2025-02-25 10:05:12.844529,10.847789
channel-75,845118,30318817,30318827,10,2025-02-25 10:15:21.180657,2025-02-25 10:15:32.791615,11.610958
channel-75,845119,30318823,30318831,8,2025-02-25 10:15:28.144216,2025-02-25 10:15:37.339510,9.195294
channel-75,845120,30318875,30318881,6,2025-02-25 10:16:35.964233,2025-02-25 10:16:43.183501,7.219268
channel-75,845121,30318893,30318903,10,2025-02-25 10:16:59.016140,2025-02-25 10:17:11.658256,12.642116
channel-75,845122,30318911,30318915,4,2025-02-25 10:17:23.388462,2025-02-25 10:17:30.993227,7.604765
channel-75,845123,30318920,30318926,6,2025-02-25 10:17:36.895530,2025-02-25 10:17:48.162409,11.266879
channel-75,845124,30318941,30318949,8,2025-02-25 10:18:06.822080,2025-02-25 10:18:16.112334,9.290254
channel-75,845125,30318978,30318983,5,2025-02-25 10:18:56.259523,2025-02-25 10:19:01.903591,5.644068
channel-75,845126,30318983,30318991,8,2025-02-25 10:19:01.903591,2025-02-25 10:19:13.032924,11.129333
channel-75,845127,30319014,30319023,9,2025-02-25 10:19:45.891920,2025-02-25 10:19:55.853098,9.961178
channel-75,845128,30319049,30319056,7,2025-02-25 10:20:32.202913,2025-02-25 10:20:40.668247,8.465334
channel-75,845129,30319058,30319066,8,2025-02-25 10:20:44.129021,2025-02-25 10:20:53.269047,9.140026
channel-75,845130,30319083,30319089,6,2025-02-25 10:21:19.750752,2025-02-25 10:21:26.809298,7.058546
channel-75,845131,30319102,30319109,7,2025-02-25 10:21:46.360845,2025-02-25 10:21:54.946407,8.585562
channel-75,845132,30319141,30319148,7,2025-02-25 10:22:33.809474,2025-02-25 10:22:42.839986,9.030512
channel-75,845133,30319564,30319573,9,2025-02-25 10:32:14.154005,2025-02-25 10:32:28.448142,14.294137
channel-75,845134,30319707,30319714,7,2025-02-25 10:35:33.552288,2025-02-25 10:35:42.818592,9.266304
channel-75,845135,30319958,30319966,8,2025-02-25 10:41:13.767385,2025-02-25 10:41:24.052790,10.285405
channel-75,845136,30320024,30320032,8,2025-02-25 10:42:35.504428,2025-02-25 10:42:46.571428,11.067
channel-75,845137,30320606,30320615,9,2025-02-25 10:55:35.348357,2025-02-25 10:55:45.657037,10.30868
channel-75,845138,30321244,30321252,8,2025-02-25 11:09:54.476864,2025-02-25 11:10:04.347223,9.870359
channel-75,845139,30321393,30321401,8,2025-02-25 11:13:08.396079,2025-02-25 11:13:17.735411,9.339332
channel-75,845140,30321991,30321998,7,2025-02-25 11:26:30.857630,2025-02-25 11:26:40.293231,9.435601
channel-75,845141,30322159,30322166,7,2025-02-25 11:30:18.110470,2025-02-25 11:30:27.608540,9.49807
channel-75,845142,30323205,30323212,7,2025-02-25 11:53:38.217655,2025-02-25 11:53:47.297554,9.079899
channel-75,845143,30323589,30323610,21,2025-02-25 12:01:57.623682,2025-02-25 12:02:25.872756,28.249074
channel-75,845144,30323666,30323673,7,2025-02-25 12:03:36.395082,2025-02-25 12:03:46.620679,10.225597
channel-75,845145,30323735,30323742,7,2025-02-25 12:05:06.162972,2025-02-25 12:05:15.463465,9.300493
channel-75,845146,30323855,30323864,9,2025-02-25 12:07:42.870279,2025-02-25 12:07:52.950818,10.080539
channel-75,845147,30323932,30323941,9,2025-02-25 12:09:22.096312,2025-02-25 12:09:34.583651,12.487339
channel-75,845148,30324018,30324026,8,2025-02-25 12:11:15.194988,2025-02-25 12:11:24.789062,9.594074
channel-75,845149,30324023,30324029,6,2025-02-25 12:11:21.448321,2025-02-25 12:11:28.589084,7.140763
channel-75,845150,30324039,30324046,7,2025-02-25 12:11:41.465930,2025-02-25 12:11:51.475733,10.009803
channel-75,845151,30324048,30324054,6,2025-02-25 12:11:54.757529,2025-02-25 12:12:02.181826,7.424297
channel-75,845152,30324062,30324069,7,2025-02-25 12:12:11.809580,2025-02-25 12:12:20.276687,8.467107
channel-75,845153,30324492,30324498,6,2025-02-25 12:21:32.376817,2025-02-25 12:21:40.050525,7.673708
channel-75,845154,30324682,30324692,10,2025-02-25 12:25:36.445191,2025-02-25 12:25:53.228296,16.783105
channel-75,845155,30324762,30324770,8,2025-02-25 12:27:27.244620,2025-02-25 12:27:36.355003,9.110383
channel-75,845156,30325041,30325047,6,2025-02-25 12:33:27.489220,2025-02-25 12:33:36.422625,8.933405
channel-75,845157,30325201,30325208,7,2025-02-25 12:36:53.715600,2025-02-25 12:37:03.148806,9.433206
channel-75,845158,30325235,30325241,6,2025-02-25 12:37:42.247741,2025-02-25 12:37:50.586553,8.338812
channel-75,845159,30325528,30325536,8,2025-02-25 12:43:59.747677,2025-02-25 12:44:10.125728,10.378051
channel-75,845160,30325555,30325561,6,2025-02-25 12:44:35.896982,2025-02-25 12:44:43.109108,7.212126
channel-75,845161,30325569,30325575,6,2025-02-25 12:44:52.697959,2025-02-25 12:45:01.652455,8.954496
channel-75,845162,30325578,30325586,8,2025-02-25 12:45:05.279140,2025-02-25 12:45:15.984990,10.70585
channel-75,845163,30325598,30325606,8,2025-02-25 12:45:32.534037,2025-02-25 12:45:42.510968,9.976931
channel-75,845164,30325666,30325674,8,2025-02-25 12:47:04.318290,2025-02-25 12:47:14.066012,9.747722
channel-75,845165,30325739,30325747,8,2025-02-25 12:48:36.467568,2025-02-25 12:48:47.249700,10.782132
channel-75,845166,30325760,30325765,5,2025-02-25 12:49:02.978854,2025-02-25 12:49:10.602454,7.6236
channel-75,845167,30325839,30325848,9,2025-02-25 12:50:44.786723,2025-02-25 12:50:55.135377,10.348654
channel-75,845168,30325845,30325852,7,2025-02-25 12:50:51.814619,2025-02-25 12:51:00.746311,8.931692
channel-75,845169,30325934,30325942,8,2025-02-25 12:52:49.739437,2025-02-25 12:52:58.844465,9.105028
channel-75,845170,30325963,30325968,5,2025-02-25 12:53:24.553604,2025-02-25 12:53:31.822971,7.269367
channel-75,845171,30326265,30326271,6,2025-02-25 13:00:02.670760,2025-02-25 13:00:16.744586,14.073826
channel-75,845172,30326301,30326310,9,2025-02-25 13:00:53.402425,2025-02-25 13:01:06.021077,12.618652
channel-75,845173,30326304,30326312,8,2025-02-25 13:00:56.634067,2025-02-25 13:01:09.238219,12.604152
channel-75,845174,30326319,30326326,7,2025-02-25 13:01:17.362260,2025-02-25 13:01:25.902402,8.540142
channel-75,845175,30326328,30326335,7,2025-02-25 13:01:28.222819,2025-02-25 13:01:36.878793,8.655974
channel-75,845176,30326352,30326361,9,2025-02-25 13:01:56.687174,2025-02-25 13:02:10.975148,14.287974
channel-75,845177,30326569,30326577,8,2025-02-25 13:06:36.977695,2025-02-25 13:06:46.538227,9.560532
channel-75,845178,30326713,30326721,8,2025-02-25 13:09:44.429693,2025-02-25 13:09:54.729112,10.299419
channel-75,845179,30326786,30326793,7,2025-02-25 13:11:17.494493,2025-02-25 13:11:27.349021,9.854528
channel-75,845180,30326808,30326815,7,2025-02-25 13:11:45.780477,2025-02-25 13:11:54.510267,8.72979
channel-75,845181,30327018,30327027,9,2025-02-25 13:16:16.958087,2025-02-25 13:16:28.088962,11.130875
channel-75,845182,30327094,30327102,8,2025-02-25 13:17:58.180770,2025-02-25 13:18:07.531802,9.351032
channel-75,845183,30327494,30327503,9,2025-02-25 13:26:35.302934,2025-02-25 13:26:46.867632,11.564698
channel-75,845184,30327523,30327531,8,2025-02-25 13:27:15.936011,2025-02-25 13:27:25.072291,9.13628
channel-75,845185,30327538,30327544,6,2025-02-25 13:27:33.180686,2025-02-25 13:27:41.282563,8.101877
channel-75,845186,30327570,30327577,7,2025-02-25 13:28:17.637942,2025-02-25 13:28:25.964054,8.326112
channel-75,845187,30327583,30327593,10,2025-02-25 13:28:32.728418,2025-02-25 13:28:46.317187,13.588769
channel-75,845188,30327595,30327602,7,2025-02-25 13:28:48.567489,2025-02-25 13:28:56.542448,7.974959
channel-75,845189,30327659,30327667,8,2025-02-25 13:30:11.221083,2025-02-25 13:30:21.322356,10.101273
channel-75,845190,30327677,30327684,7,2025-02-25 13:30:33.154326,2025-02-25 13:30:42.833077,9.678751
channel-75,845191,30327717,30327722,5,2025-02-25 13:31:25.243249,2025-02-25 13:31:34.166333,8.923084
channel-75,845192,30327767,30327775,8,2025-02-25 13:32:32.928563,2025-02-25 13:32:42.217931,9.289368
channel-75,845193,30327819,30327825,6,2025-02-25 13:33:37.770936,2025-02-25 13:33:46.637804,8.866868
channel-75,845194,30327838,30327847,9,2025-02-25 13:34:03.416644,2025-02-25 13:34:14.056102,10.639458
channel-75,845195,30327841,30327847,6,2025-02-25 13:34:07.281823,2025-02-25 13:34:14.056102,6.774279
channel-75,845196,30327877,30327887,10,2025-02-25 13:34:51.504649,2025-02-25 13:35:03.728716,12.224067
channel-75,845197,30327949,30327955,6,2025-02-25 13:36:26.072559,2025-02-25 13:36:34.777382,8.704823
channel-75,845198,30328015,30328023,8,2025-02-25 13:37:52.029029,2025-02-25 13:38:01.235087,9.206058
channel-75,845199,30328061,30328068,7,2025-02-25 13:38:50.313052,2025-02-25 13:38:58.575495,8.262443
channel-75,845200,30328090,30328098,8,2025-02-25 13:39:27.904807,2025-02-25 13:39:38.920429,11.015622
channel-75,845201,30328098,30328106,8,2025-02-25 13:39:38.920429,2025-02-25 13:39:49.210324,10.289895
channel-75,845202,30328107,30328113,6,2025-02-25 13:39:50.281593,2025-02-25 13:39:58.721210,8.439617
channel-75,845203,30328123,30328128,5,2025-02-25 13:40:11.211403,2025-02-25 13:40:17.850217,6.638814
channel-75,845204,30328142,30328150,8,2025-02-25 13:40:38.421723,2025-02-25 13:40:49.403977,10.982254
channel-75,845205,30328195,30328202,7,2025-02-25 13:41:45.613186,2025-02-25 13:41:53.441733,7.828547
channel-75,845206,30328275,30328282,7,2025-02-25 13:43:27.674017,2025-02-25 13:43:36.304575,8.630558
channel-75,845207,30328409,30328415,6,2025-02-25 13:46:19.362275,2025-02-25 13:46:28.133678,8.771403
channel-75,845208,30328520,30328527,7,2025-02-25 13:48:43.310548,2025-02-25 13:48:51.538695,8.228147
channel-75,845209,30328560,30328564,4,2025-02-25 13:49:33.445549,2025-02-25 13:49:41.189982,7.744433
channel-75,845210,30328562,30328570,8,2025-02-25 13:49:35.832374,2025-02-25 13:49:49.159172,13.326798
channel-75,845211,30328581,30328589,8,2025-02-25 13:50:06.930313,2025-02-25 13:50:17.545171,10.614858
channel-75,845212,30328662,30328670,8,2025-02-25 13:51:49.912970,2025-02-25 13:51:59.369718,9.456748
channel-75,845213,30328667,30328673,6,2025-02-25 13:51:55.972435,2025-02-25 13:52:03.712156,7.739721
channel-75,845214,30328667,30328673,6,2025-02-25 13:51:55.972435,2025-02-25 13:52:03.712156,7.739721
channel-75,845215,30328748,30328756,8,2025-02-25 13:53:40.172216,2025-02-25 13:53:49.650898,9.478682
channel-75,845216,30328813,30328823,10,2025-02-25 13:55:05.883851,2025-02-25 13:55:18.322369,12.438518
channel-75,845217,30328823,30328832,9,2025-02-25 13:55:18.322369,2025-02-25 13:55:28.848305,10.525936
channel-75,845218,30328875,30328882,7,2025-02-25 13:56:24.668443,2025-02-25 13:56:32.518132,7.849689
channel-75,845219,30328881,30328887,6,2025-02-25 13:56:31.388513,2025-02-25 13:56:40.402095,9.013582
channel-75,845220,30328889,30328895,6,2025-02-25 13:56:42.762874,2025-02-25 13:56:49.930796,7.167922
channel-75,845221,30328926,30328933,7,2025-02-25 13:57:29.395172,2025-02-25 13:57:38.635594,9.240422
channel-75,845222,30328947,30328955,8,2025-02-25 13:57:55.690563,2025-02-25 13:58:04.793722,9.103159
channel-75,845223,30328971,30328978,7,2025-02-25 13:58:30.658778,2025-02-25 13:58:39.158616,8.499838
channel-75,845224,30329011,30329018,7,2025-02-25 13:59:25.403593,2025-02-25 13:59:34.481770,9.078177
channel-75,845225,30329249,30329257,8,2025-02-25 14:04:34.360214,2025-02-25 14:04:43.626529,9.266315
channel-75,845226,30329375,30329382,7,2025-02-25 14:07:15.384606,2025-02-25 14:07:24.248164,8.863558
channel-75,845227,30329479,30329486,7,2025-02-25 14:09:32.199987,2025-02-25 14:09:40.234134,8.034147
channel-75,845228,30329541,30329547,6,2025-02-25 14:10:48.666123,2025-02-25 14:10:56.808464,8.142341
channel-75,845229,30329610,30329619,9,2025-02-25 14:12:23.208849,2025-02-25 14:12:33.984033,10.775184
channel-75,845230,30329661,30329668,7,2025-02-25 14:13:30.227223,2025-02-25 14:13:38.832268,8.605045
channel-75,845231,30329700,30329705,5,2025-02-25 14:14:20.315862,2025-02-25 14:14:29.277252,8.96139
channel-75,845232,30329733,30329740,7,2025-02-25 14:15:04.255765,2025-02-25 14:15:14.114529,9.858764
channel-75,845233,30329747,30329767,20,2025-02-25 14:15:22.384195,2025-02-25 14:15:47.799990,25.415795
channel-75,845234,30329752,30329761,9,2025-02-25 14:15:30.072348,2025-02-25 14:15:40.338204,10.265856
channel-75,845235,30329766,30329775,9,2025-02-25 14:15:46.685270,2025-02-25 14:15:57.834498,11.149228
channel-75,845236,30329887,30329894,7,2025-02-25 14:18:25.811785,2025-02-25 14:18:34.365969,8.554184
channel-75,845237,30329898,30329905,7,2025-02-25 14:18:39.159296,2025-02-25 14:18:47.460285,8.300989
channel-75,845238,30330018,30330026,8,2025-02-25 14:21:14.412332,2025-02-25 14:21:27.322240,12.909908
channel-75,845239,30330124,30330131,7,2025-02-25 14:23:32.223917,2025-02-25 14:23:42.833514,10.609597
channel-75,845240,30330179,30330186,7,2025-02-25 14:24:42.176160,2025-02-25 14:24:51.357667,9.181507
channel-75,845241,30330339,30330346,7,2025-02-25 14:28:10.929048,2025-02-25 14:28:23.875127,12.946079
channel-75,845242,30330454,30330461,7,2025-02-25 14:30:45.387715,2025-02-25 14:30:53.813811,8.426096
channel-75,845243,30330466,30330473,7,2025-02-25 14:31:02.982399,2025-02-25 14:31:10.774373,7.791974
channel-75,845244,30330635,30330639,4,2025-02-25 14:34:39.821212,2025-02-25 14:34:47.558484,7.737272
channel-75,845245,30330660,30330668,8,2025-02-25 14:35:12.150456,2025-02-25 14:35:22.399452,10.248996
channel-75,845246,30330672,30330680,8,2025-02-25 14:35:27.028948,2025-02-25 14:35:35.835577,8.806629
channel-75,845247,30330706,30330712,6,2025-02-25 14:36:10.647274,2025-02-25 14:36:19.613035,8.965761
channel-75,845248,30330726,30330732,6,2025-02-25 14:36:37.366436,2025-02-25 14:36:45.479568,8.113132
channel-75,845249,30330732,30330743,11,2025-02-25 14:36:45.479568,2025-02-25 14:36:59.463606,13.984038
channel-75,845250,30330807,30330815,8,2025-02-25 14:38:22.238956,2025-02-25 14:38:32.080825,9.841869
channel-75,845251,30330833,30330841,8,2025-02-25 14:38:54.790223,2025-02-25 14:39:03.890953,9.10073
channel-75,845252,30330878,30330886,8,2025-02-25 14:39:55.795973,2025-02-25 14:40:06.010649,10.214676
channel-75,845253,30330948,30330956,8,2025-02-25 14:41:30.111502,2025-02-25 14:41:40.721196,10.609694
channel-75,845254,30331043,30331050,7,2025-02-25 14:43:30.330297,2025-02-25 14:43:42.008562,11.678265
channel-75,845255,30331171,30331180,9,2025-02-25 14:46:22.370116,2025-02-25 14:46:33.502720,11.132604
channel-75,845256,30331192,30331199,7,2025-02-25 14:46:49.320020,2025-02-25 14:46:57.529399,8.209379
channel-75,845257,30331258,30331262,4,2025-02-25 14:48:15.918495,2025-02-25 14:48:20.539955,4.62146
channel-75,845258,30331295,30331302,7,2025-02-25 14:49:07.506903,2025-02-25 14:49:15.325971,7.819068
channel-75,845259,30331389,30331398,9,2025-02-25 14:51:08.813037,2025-02-25 14:51:21.674112,12.861075
channel-75,845260,30331639,30331645,6,2025-02-25 14:56:34.460033,2025-02-25 14:56:41.880782,7.420749
channel-75,845261,30331841,30331848,7,2025-02-25 15:01:01.384721,2025-02-25 15:01:11.188566,9.803845
channel-75,845262,30331888,30331896,8,2025-02-25 15:02:04.568731,2025-02-25 15:02:15.809713,11.240982
channel-75,845263,30331965,30331972,7,2025-02-25 15:03:42.179975,2025-02-25 15:03:51.577726,9.397751
channel-75,845264,30332080,30332086,6,2025-02-25 15:06:17.307418,2025-02-25 15:06:25.603607,8.296189
channel-75,845265,30332136,30332143,7,2025-02-25 15:07:31.814037,2025-02-25 15:07:41.359386,9.545349
channel-75,845266,30332265,30332271,6,2025-02-25 15:10:20.963314,2025-02-25 15:10:28.640914,7.6776
channel-75,845267,30332411,30332427,16,2025-02-25 15:13:30.562837,2025-02-25 15:13:52.830246,22.267409
channel-75,845268,30332440,30332448,8,2025-02-25 15:14:10.379164,2025-02-25 15:14:19.979356,9.600192
channel-75,845269,30332515,30332524,9,2025-02-25 15:15:51.797646,2025-02-25 15:16:05.837740,14.040094
channel-75,845270,30333294,30333304,10,2025-02-25 15:32:58.700159,2025-02-25 15:33:12.247562,13.547403
channel-75,845271,30333534,30333542,8,2025-02-25 15:38:20.754051,2025-02-25 15:38:30.426652,9.672601
channel-75,845272,30333860,30333864,4,2025-02-25 15:45:39.528996,2025-02-25 15:45:47.428775,7.899779
channel-75,845273,30333864,30333870,6,2025-02-25 15:45:47.428775,2025-02-25 15:45:55.216083,7.787308
channel-75,845274,30333923,30333931,8,2025-02-25 15:47:04.427931,2025-02-25 15:47:13.713601,9.28567
channel-75,845275,30333969,30333974,5,2025-02-25 15:48:06.964383,2025-02-25 15:48:15.220821,8.256438
channel-75,845276,30334002,30334009,7,2025-02-25 15:48:50.661115,2025-02-25 15:48:59.748674,9.087559
channel-75,845277,30334062,30334069,7,2025-02-25 15:50:09.829697,2025-02-25 15:50:17.879360,8.049663
channel-75,845278,30334085,30334091,6,2025-02-25 15:50:39.397373,2025-02-25 15:50:47.891075,8.493702
channel-75,845279,30334195,30334202,7,2025-02-25 15:53:05.217795,2025-02-25 15:53:18.414921,13.197126
channel-75,845280,30334340,30334349,9,2025-02-25 15:56:22.027584,2025-02-25 15:56:33.253206,11.225622
channel-75,845281,30334354,30334363,9,2025-02-25 15:56:42.484760,2025-02-25 15:56:52.990650,10.50589
channel-75,845282,30334642,30334652,10,2025-02-25 16:03:05.815084,2025-02-25 16:03:17.855428,12.040344
channel-75,845283,30335392,30335401,9,2025-02-25 16:19:35.417082,2025-02-25 16:19:46.125312,10.70823
channel-75,845284,30335499,30335505,6,2025-02-25 16:21:56.564526,2025-02-25 16:22:03.921939,7.357413
channel-75,845285,30335631,30335636,5,2025-02-25 16:24:53.213997,2025-02-25 16:25:00.812800,7.598803
channel-75,845286,30335833,30335837,4,2025-02-25 16:29:14.258351,2025-02-25 16:29:18.647605,4.389254
channel-75,845287,30335941,30335947,6,2025-02-25 16:31:38.899260,2025-02-25 16:31:45.898108,6.998848
channel-75,845288,30336318,30336322,4,2025-02-25 16:39:50.971075,2025-02-25 16:39:56.684933,5.713858
channel-75,845289,30336324,30336331,7,2025-02-25 16:40:03.499984,2025-02-25 16:40:13.600236,10.100252
channel-75,845290,30336422,30336429,7,2025-02-25 16:42:13.956563,2025-02-25 16:42:22.771022,8.814459
channel-75,845291,30336424,30336432,8,2025-02-25 16:42:16.297094,2025-02-25 16:42:26.349172,10.052078
channel-75,845292,30336475,30336482,7,2025-02-25 16:43:25.115887,2025-02-25 16:43:33.382949,8.267062
channel-75,845293,30336512,30336517,5,2025-02-25 16:44:13.518653,2025-02-25 16:44:20.636970,7.118317
channel-75,845294,30336663,30336671,8,2025-02-25 16:47:31.764472,2025-02-25 16:47:41.184668,9.420196
channel-75,845295,30336976,30336982,6,2025-02-25 16:54:28.875439,2025-02-25 16:54:37.158645,8.283206
channel-75,845296,30336983,30336990,7,2025-02-25 16:54:38.447126,2025-02-25 16:54:46.907940,8.460814
channel-75,845297,30337131,30337142,11,2025-02-25 16:57:57.067238,2025-02-25 16:58:11.006461,13.939223
channel-75,845298,30337211,30337218,7,2025-02-25 16:59:45.699826,2025-02-25 16:59:55.252428,9.552602
channel-75,845299,30337549,30337558,9,2025-02-25 17:07:14.023719,2025-02-25 17:07:25.051878,11.028159
channel-75,845300,30337796,30337804,8,2025-02-25 17:12:36.098193,2025-02-25 17:12:46.888355,10.790162
channel-75,845301,30337843,30337850,7,2025-02-25 17:13:39.432907,2025-02-25 17:13:48.060568,8.627661
channel-75,845302,30337935,30337942,7,2025-02-25 17:15:40.297611,2025-02-25 17:15:48.108522,7.810911
channel-75,845303,30338238,30338259,21,2025-02-25 17:23:05.632144,2025-02-25 17:23:32.096946,26.464802
channel-75,845304,30338347,30338352,5,2025-02-25 17:25:31.231109,2025-02-25 17:25:38.246339,7.01523
channel-75,845305,30338447,30338454,7,2025-02-25 17:27:40.807682,2025-02-25 17:27:50.316389,9.508707
channel-75,845306,30338497,30338504,7,2025-02-25 17:28:47.020646,2025-02-25 17:28:56.435828,9.415182
channel-75,845307,30338528,30338536,8,2025-02-25 17:29:35.522975,2025-02-25 17:29:45.064276,9.541301
channel-75,845308,30338715,30338723,8,2025-02-25 17:33:47.573438,2025-02-25 17:33:57.210129,9.636691
channel-75,845309,30340277,30340284,7,2025-02-25 18:08:18.387760,2025-02-25 18:08:26.583301,8.195541
channel-75,845310,30340397,30340403,6,2025-02-25 18:10:52.534126,2025-02-25 18:11:02.902054,10.367928
channel-75,845311,30340576,30340583,7,2025-02-25 18:14:49.625638,2025-02-25 18:14:59.545964,9.920326
channel-75,845312,30340913,30340922,9,2025-02-25 18:22:11.427204,2025-02-25 18:22:22.525084,11.09788
channel-75,845313,30341660,30341664,4,2025-02-25 18:38:34.925864,2025-02-25 18:38:43.012459,8.086595
channel-75,845314,30342144,30342152,8,2025-02-25 18:49:09.396226,2025-02-25 18:49:19.875315,10.479089
channel-75,845315,30342590,30342596,6,2025-02-25 18:58:39.955873,2025-02-25 18:58:48.343280,8.387407
channel-75,845316,30342639,30342645,6,2025-02-25 18:59:41.888046,2025-02-25 18:59:49.276079,7.388033
channel-75,845317,30342979,30342986,7,2025-02-25 19:07:14.662282,2025-02-25 19:07:23.003753,8.341471
channel-75,845318,30343009,30343017,8,2025-02-25 19:07:56.938268,2025-02-25 19:08:07.572809,10.634541
channel-75,845319,30343122,30343130,8,2025-02-25 19:10:25.325716,2025-02-25 19:10:35.468068,10.142352
channel-75,845320,30343476,30343493,17,2025-02-25 19:18:03.838923,2025-02-25 19:18:28.225817,24.386894
channel-75,845321,30343497,30343515,18,2025-02-25 19:18:32.720448,2025-02-25 19:18:56.574321,23.853873
channel-75,845322,30343630,30343645,15,2025-02-25 19:21:26.311913,2025-02-25 19:21:44.634890,18.322977
channel-75,845323,30343941,30343948,7,2025-02-25 19:28:07.021786,2025-02-25 19:28:21.262258,14.240472
channel-75,845324,30343983,30343991,8,2025-02-25 19:29:05.504466,2025-02-25 19:29:14.770073,9.265607
channel-75,845325,30344072,30344083,11,2025-02-25 19:30:58.673522,2025-02-25 19:31:11.977737,13.304215
channel-75,845326,30344434,30344442,8,2025-02-25 19:38:41.897974,2025-02-25 19:38:51.454913,9.556939
channel-75,845327,30344968,30344976,8,2025-02-25 19:50:11.010683,2025-02-25 19:50:25.243722,14.233039
channel-75,845328,30345029,30345035,6,2025-02-25 19:51:36.645250,2025-02-25 19:51:43.494805,6.849555
channel-75,845329,30345892,30345899,7,2025-02-25 20:10:24.521176,2025-02-25 20:10:33.062534,8.541358
channel-75,845330,30345896,30345903,7,2025-02-25 20:10:29.483074,2025-02-25 20:10:38.530174,9.0471
channel-75,845331,30346367,30346382,15,2025-02-25 20:20:50.182154,2025-02-25 20:21:09.076409,18.894255
channel-75,845332,30346397,30346420,23,2025-02-25 20:21:26.633546,2025-02-25 20:21:57.941484,31.307938
channel-75,845333,30346419,30346429,10,2025-02-25 20:21:56.702101,2025-02-25 20:22:11.542459,14.840358
channel-75,845334,30346424,30346442,18,2025-02-25 20:22:05.967952,2025-02-25 20:22:27.906627,21.938675
channel-75,845335,30346467,30346473,6,2025-02-25 20:23:04.984414,2025-02-25 20:23:12.447313,7.462899
channel-75,845336,30347141,30347158,17,2025-02-25 20:37:43.122912,2025-02-25 20:38:04.864583,21.741671
channel-75,845337,30347197,30347217,20,2025-02-25 20:38:54.282746,2025-02-25 20:39:18.296092,24.013346
channel-75,845338,30347300,30347319,19,2025-02-25 20:41:10.334336,2025-02-25 20:41:33.875329,23.540993
channel-75,845339,30347359,30347378,19,2025-02-25 20:42:25.088779,2025-02-25 20:42:49.262544,24.173765
channel-75,845340,30347408,30347416,8,2025-02-25 20:43:29.065494,2025-02-25 20:43:38.468614,9.40312
channel-75,845341,30347600,30347616,16,2025-02-25 20:47:36.545833,2025-02-25 20:47:56.470113,19.92428
channel-75,845342,30347935,30347943,8,2025-02-25 20:54:48.056812,2025-02-25 20:54:56.800887,8.744075
channel-75,845343,30348146,30348160,14,2025-02-25 20:59:17.797869,2025-02-25 20:59:36.540516,18.742647
channel-75,845344,30348230,30348237,7,2025-02-25 21:01:04.070073,2025-02-25 21:01:12.165020,8.094947
channel-75,845345,30348304,30348326,22,2025-02-25 21:02:43.554459,2025-02-25 21:03:10.252568,26.698109
channel-75,845346,30348320,30348328,8,2025-02-25 21:03:03.528316,2025-02-25 21:03:13.589768,10.061452
channel-75,845347,30348397,30348406,9,2025-02-25 21:04:43.272593,2025-02-25 21:04:56.905382,13.632789
channel-75,845348,30348461,30348469,8,2025-02-25 21:06:07.912772,2025-02-25 21:06:18.401241,10.488469
channel-75,845349,30348597,30348604,7,2025-02-25 21:09:03.271658,2025-02-25 21:09:11.473639,8.201981
channel-75,845350,30348608,30348615,7,2025-02-25 21:09:16.585543,2025-02-25 21:09:28.804778,12.219235
channel-75,845351,30348728,30348734,6,2025-02-25 21:11:57.798533,2025-02-25 21:12:04.687642,6.889109
channel-75,845352,30349005,30349022,17,2025-02-25 21:17:53.295500,2025-02-25 21:18:15.138454,21.842954
channel-75,845353,30349146,30349154,8,2025-02-25 21:20:55.608772,2025-02-25 21:21:05.066780,9.458008
channel-75,845354,30349226,30349241,15,2025-02-25 21:22:40.008535,2025-02-25 21:22:57.880999,17.872464
channel-75,845355,30349373,30349381,8,2025-02-25 21:25:45.657175,2025-02-25 21:25:56.840362,11.183187
channel-75,845356,30349575,30349581,6,2025-02-25 21:30:08.099545,2025-02-25 21:30:15.944614,7.845069
channel-75,845357,30349841,30349849,8,2025-02-25 21:35:49.594447,2025-02-25 21:35:58.833950,9.239503
channel-75,845358,30350210,30350218,8,2025-02-25 21:43:40.224371,2025-02-25 21:43:50.002173,9.777802
channel-75,845359,30350219,30350228,9,2025-02-25 21:43:52.374633,2025-02-25 21:44:02.742893,10.36826
channel-75,845360,30350224,30350230,6,2025-02-25 21:43:58.113506,2025-02-25 21:44:06.014496,7.90099
channel-75,845361,30351002,30351008,6,2025-02-25 22:00:40.113398,2025-02-25 22:00:49.323915,9.210517
channel-75,845362,30351013,30351019,6,2025-02-25 22:00:56.001169,2025-02-25 22:01:03.587785,7.586616
channel-75,845363,30351043,30351049,6,2025-02-25 22:01:35.697040,2025-02-25 22:01:44.027405,8.330365
channel-75,845364,30351083,30351099,16,2025-02-25 22:02:24.560753,2025-02-25 22:02:44.418505,19.857752
channel-75,845365,30351367,30351373,6,2025-02-25 22:08:35.125319,2025-02-25 22:08:43.827276,8.701957
channel-75,845366,30351547,30351554,7,2025-02-25 22:12:26.367222,2025-02-25 22:12:35.639647,9.272425
channel-75,845367,30351582,30351592,10,2025-02-25 22:13:13.801590,2025-02-25 22:13:24.878487,11.076897
channel-75,845368,30351650,30351655,5,2025-02-25 22:14:40.905335,2025-02-25 22:14:48.904458,7.999123
channel-75,845369,30351949,30351955,6,2025-02-25 22:21:06.877425,2025-02-25 22:21:14.435630,7.558205
channel-75,845370,30351956,30351963,7,2025-02-25 22:21:16.793261,2025-02-25 22:21:25.606014,8.812753
channel-75,845371,30351993,30352002,9,2025-02-25 22:22:07.089058,2025-02-25 22:22:17.350552,10.261494
channel-75,845372,30352267,30352275,8,2025-02-25 22:27:56.652493,2025-02-25 22:28:06.786412,10.133919
channel-75,845373,30352444,30352451,7,2025-02-25 22:31:45.774023,2025-02-25 22:31:53.994690,8.220667
channel-75,845374,30352534,30352543,9,2025-02-25 22:33:39.203962,2025-02-25 22:33:49.224235,10.020273
channel-75,845375,30352576,30352585,9,2025-02-25 22:34:29.086640,2025-02-25 22:34:42.775441,13.688801
channel-75,845376,30352865,30352872,7,2025-02-25 22:40:45.945874,2025-02-25 22:40:54.662479,8.716605
channel-75,845377,30352927,30352936,9,2025-02-25 22:42:02.943692,2025-02-25 22:42:16.529865,13.586173
channel-75,845378,30353306,30353314,8,2025-02-25 22:50:12.590762,2025-02-25 22:50:23.071275,10.480513
channel-75,845379,30353321,30353327,6,2025-02-25 22:50:30.902483,2025-02-25 22:50:38.973472,8.070989
channel-75,845380,30353333,30353346,13,2025-02-25 22:50:46.164328,2025-02-25 22:51:01.724031,15.559703
channel-75,845381,30353583,30353590,7,2025-02-25 22:56:07.185631,2025-02-25 22:56:15.225732,8.040101
channel-75,845382,30353637,30353645,8,2025-02-25 22:57:15.611224,2025-02-25 22:57:25.792939,10.181715
channel-75,845383,30353638,30353645,7,2025-02-25 22:57:16.794476,2025-02-25 22:57:25.792939,8.998463
channel-75,845384,30353710,30353719,9,2025-02-25 22:58:52.687767,2025-02-25 22:59:02.752023,10.064256
channel-75,845385,30353839,30353846,7,2025-02-25 23:01:35.470565,2025-02-25 23:01:43.436082,7.965517
channel-75,845386,30353954,30353964,10,2025-02-25 23:04:01.549466,2025-02-25 23:04:15.919665,14.370199
channel-75,845387,30354376,30354387,11,2025-02-25 23:13:05.999173,2025-02-25 23:13:18.641961,12.642788
channel-75,845388,30355618,30355626,8,2025-02-25 23:39:44.742071,2025-02-25 23:39:53.790770,9.048699
channel-75,845389,30356784,30356792,8,2025-02-26 00:04:50.496327,2025-02-26 00:05:00.442017,9.94569
channel-75,845390,30357616,30357624,8,2025-02-26 00:22:44.971176,2025-02-26 00:22:54.370667,9.399491
channel-75,845391,30358793,30358801,8,2025-02-26 00:47:54.903026,2025-02-26 00:48:06.587731,11.684705
channel-75,845392,30359473,30359479,6,2025-02-26 01:02:39.014700,2025-02-26 01:02:46.414624,7.399924
channel-75,845393,30359502,30359512,10,2025-02-26 01:03:15.496494,2025-02-26 01:03:27.565136,12.068642
channel-75,845394,30360014,30360032,18,2025-02-26 01:14:26.127051,2025-02-26 01:14:47.854834,21.727783
channel-75,845395,30360229,30360236,7,2025-02-26 01:19:01.033329,2025-02-26 01:19:11.484352,10.451023
channel-75,845396,30360387,30360405,18,2025-02-26 01:22:27.505165,2025-02-26 01:22:50.272125,22.76696
channel-75,845397,30361400,30361407,7,2025-02-26 01:44:20.393530,2025-02-26 01:44:28.358560,7.96503
channel-75,845398,30361958,30361967,9,2025-02-26 01:56:13.722348,2025-02-26 01:56:24.075159,10.352811
channel-75,845399,30362018,30362025,7,2025-02-26 01:57:30.070977,2025-02-26 01:57:38.699399,8.628422
channel-75,845400,30362088,30362096,8,2025-02-26 01:58:57.745422,2025-02-26 01:59:07.859963,10.114541
channel-75,845401,30362139,30362146,7,2025-02-26 02:00:01.469060,2025-02-26 02:00:13.206213,11.737153
channel-75,845402,30362217,30362225,8,2025-02-26 02:01:43.205449,2025-02-26 02:01:52.482455,9.277006
channel-75,845403,30362318,30362324,6,2025-02-26 02:03:51.986710,2025-02-26 02:04:01.090593,9.103883
channel-75,845404,30362628,30362645,17,2025-02-26 02:10:26.437671,2025-02-26 02:10:46.695451,20.25778
channel-75,845405,30362662,30362671,9,2025-02-26 02:11:07.205233,2025-02-26 02:11:17.797952,10.592719
channel-75,845406,30362946,30362954,8,2025-02-26 02:17:12.218654,2025-02-26 02:17:22.138588,9.919934
channel-75,845407,30363520,30363527,7,2025-02-26 02:29:25.880585,2025-02-26 02:29:33.896483,8.015898
channel-75,845408,30364577,30364586,9,2025-02-26 02:52:01.860133,2025-02-26 02:52:11.995034,10.134901
channel-75,845409,30365129,30365136,7,2025-02-26 03:03:55.289001,2025-02-26 03:04:03.605194,8.316193
channel-75,845410,30365253,30365258,5,2025-02-26 03:06:35.129330,2025-02-26 03:06:41.842530,6.7132
channel-75,845411,30365750,30365757,7,2025-02-26 03:17:06.653812,2025-02-26 03:17:15.703945,9.050133
channel-75,845412,30366878,30366885,7,2025-02-26 03:41:10.621963,2025-02-26 03:41:18.661969,8.040006
channel-75,845413,30367421,30367427,6,2025-02-26 03:52:53.231001,2025-02-26 03:53:00.224305,6.993304
channel-75,845414,30367606,30367614,8,2025-02-26 03:56:57.446981,2025-02-26 03:57:08.796465,11.349484
channel-75,845415,30368058,30368066,8,2025-02-26 04:06:39.183776,2025-02-26 04:06:48.398408,9.214632
channel-75,845416,30368160,30368168,8,2025-02-26 04:08:46.430347,2025-02-26 04:08:59.162473,12.732126
channel-75,845417,30368237,30368244,7,2025-02-26 04:10:24.883424,2025-02-26 04:10:35.148854,10.26543
channel-75,845418,30368420,30368427,7,2025-02-26 04:14:19.074767,2025-02-26 04:14:28.065724,8.990957
channel-75,845419,30368461,30368469,8,2025-02-26 04:15:10.234169,2025-02-26 04:15:22.513843,12.279674
channel-75,845420,30368875,30368880,5,2025-02-26 04:23:59.076487,2025-02-26 04:24:05.995798,6.919311
channel-75,845421,30369305,30369312,7,2025-02-26 04:33:07.393563,2025-02-26 04:33:15.994998,8.601435
channel-75,845422,30369694,30369700,6,2025-02-26 04:41:26.476524,2025-02-26 04:41:34.541141,8.064617
channel-75,845423,30370069,30370078,9,2025-02-26 04:49:20.168402,2025-02-26 04:49:31.242072,11.07367
channel-75,845424,30371191,30371198,7,2025-02-26 05:13:17.592203,2025-02-26 05:13:25.733281,8.141078
channel-75,845425,30371595,30371601,6,2025-02-26 05:21:58.135549,2025-02-26 05:22:05.268078,7.132529
channel-75,845426,30371709,30371715,6,2025-02-26 05:24:24.804498,2025-02-26 05:24:33.258235,8.453737
channel-75,845427,30372172,30372178,6,2025-02-26 05:34:17.641436,2025-02-26 05:34:27.211455,9.570019
channel-75,845428,30372270,30372279,9,2025-02-26 05:36:22.642510,2025-02-26 05:36:32.803157,10.160647
channel-75,845429,30372285,30372293,8,2025-02-26 05:36:39.615915,2025-02-26 05:36:49.722941,10.107026
channel-75,845430,30372351,30372358,7,2025-02-26 05:38:07.044149,2025-02-26 05:38:15.304491,8.260342
channel-75,845431,30372436,30372444,8,2025-02-26 05:39:56.011003,2025-02-26 05:40:05.080441,9.069438
channel-75,845432,30373971,30373980,9,2025-02-26 06:12:50.028852,2025-02-26 06:13:01.808158,11.779306
channel-75,845433,30374601,30374609,8,2025-02-26 06:26:14.980841,2025-02-26 06:26:26.135928,11.155087
channel-75,845434,30375677,30375686,9,2025-02-26 06:49:13.063687,2025-02-26 06:49:23.657041,10.593354
channel-75,845435,30376395,30376404,9,2025-02-26 07:04:28.392640,2025-02-26 07:04:39.743703,11.351063
channel-75,845436,30376476,30376482,6,2025-02-26 07:06:13.979208,2025-02-26 07:06:22.448517,8.469309
channel-75,845437,30376931,30376940,9,2025-02-26 07:15:56.797966,2025-02-26 07:16:08.172447,11.374481
channel-75,845438,30378394,30378401,7,2025-02-26 07:47:03.595036,2025-02-26 07:47:14.634498,11.039462
channel-75,845439,30378599,30378606,7,2025-02-26 07:51:30.914649,2025-02-26 07:51:41.107306,10.192657
channel-75,845440,30379049,30379056,7,2025-02-26 08:01:05.656471,2025-02-26 08:01:13.840490,8.184019
channel-75,845441,30379505,30379514,9,2025-02-26 08:10:50.686512,2025-02-26 08:11:00.764902,10.07839
channel-75,845442,30379577,30379584,7,2025-02-26 08:12:23.908194,2025-02-26 08:12:32.372734,8.46454
channel-75,845443,30379883,30379892,9,2025-02-26 08:18:53.389555,2025-02-26 08:19:04.130928,10.741373
