channel_id,sequence,send_height,ack_height,block_delay,send_time,ack_time,time_delay_sec
channel-750,682273,30280025,30280029,4,2025-02-24 20:01:26.182512,2025-02-24 20:01:31.413946,5.231434
channel-750,682274,30280037,30280049,12,2025-02-24 20:01:41.245720,2025-02-24 20:02:00.832210,19.58649
channel-750,682275,30280042,30280058,16,2025-02-24 20:01:50.266910,2025-02-24 20:02:15.878692,25.611782
channel-750,682276,30280045,30280058,13,2025-02-24 20:01:55.176266,2025-02-24 20:02:15.878692,20.702426
channel-750,682277,30280103,30280116,13,2025-02-24 20:03:14.309819,2025-02-24 20:03:33.614693,19.304874
channel-750,682278,30280128,30280145,17,2025-02-24 20:03:48.312847,2025-02-24 20:04:08.886567,20.57372
channel-750,682279,30280170,30280192,22,2025-02-24 20:04:40.626131,2025-02-24 20:05:10.351587,29.725456
channel-750,682280,30280175,30280179,4,2025-02-24 20:04:47.507219,2025-02-24 20:04:52.221933,4.714714
channel-750,682281,30280259,30280273,14,2025-02-24 20:06:37.885047,2025-02-24 20:06:55.022650,17.137603
channel-750,682282,30280260,30280275,15,2025-02-24 20:06:39.558843,2025-02-24 20:06:57.230164,17.671321
channel-750,682283,30280295,30280299,4,2025-02-24 20:07:24.597505,2025-02-24 20:07:30.305287,5.707782
channel-750,682284,30280340,30280343,3,2025-02-24 20:08:27.652588,2025-02-24 20:08:35.533430,7.880842
channel-750,682285,30280358,30280380,22,2025-02-24 20:08:54.365570,2025-02-24 20:09:21.497820,27.13225
channel-750,682286,30280375,30280392,17,2025-02-24 20:09:15.548410,2025-02-24 20:09:38.647473,23.099063
channel-750,682287,30280410,30280421,11,2025-02-24 20:10:00.120342,2025-02-24 20:10:14.839662,14.71932
channel-750,682288,30280410,30280421,11,2025-02-24 20:10:00.120342,2025-02-24 20:10:14.839662,14.71932
channel-750,682289,30280437,30280444,7,2025-02-24 20:10:39.149430,2025-02-24 20:10:47.364753,8.215323
channel-750,682290,30280437,30280457,20,2025-02-24 20:10:39.149430,2025-02-24 20:11:03.354115,24.204685
channel-750,682291,30280471,30280476,5,2025-02-24 20:11:20.528713,2025-02-24 20:11:26.311446,5.782733
channel-750,682292,30280482,30280492,10,2025-02-24 20:11:34.403184,2025-02-24 20:11:47.209548,12.806364
channel-750,682293,30280490,30280499,9,2025-02-24 20:11:44.951084,2025-02-24 20:11:56.960139,12.009055
channel-750,682294,30280515,30280521,6,2025-02-24 20:12:17.544083,2025-02-24 20:12:26.399676,8.855593
channel-750,682295,30280520,30280524,4,2025-02-24 20:12:24.821871,2025-02-24 20:12:33.171096,8.349225
channel-750,682296,30280557,30280568,11,2025-02-24 20:13:15.406034,2025-02-24 20:13:29.661531,14.255497
channel-750,682297,30280566,30280571,5,2025-02-24 20:13:27.230987,2025-02-24 20:13:33.035632,5.804645
channel-750,682298,30280596,30280607,11,2025-02-24 20:14:04.898603,2025-02-24 20:14:21.719207,16.820604
channel-750,682299,30280614,30280619,5,2025-02-24 20:14:30.765421,2025-02-24 20:14:37.922391,7.15697
channel-750,682300,30280630,30280664,34,2025-02-24 20:14:53.168099,2025-02-24 20:15:35.953802,42.785703
channel-750,682301,30280651,30280657,6,2025-02-24 20:15:18.413806,2025-02-24 20:15:26.731996,8.31819
channel-750,682302,30280677,30280683,6,2025-02-24 20:15:53.244190,2025-02-24 20:16:00.111423,6.867233
channel-750,682303,30280689,30280694,5,2025-02-24 20:16:09.011970,2025-02-24 20:16:14.874480,5.86251
channel-750,682304,30280710,30280720,10,2025-02-24 20:16:33.648700,2025-02-24 20:16:45.927752,12.279052
channel-750,682305,30280741,30280746,5,2025-02-24 20:17:16.684944,2025-02-24 20:17:23.657351,6.972407
channel-750,682306,30280747,30280761,14,2025-02-24 20:17:24.719248,2025-02-24 20:17:42.802970,18.083722
channel-750,682307,30280856,30280860,4,2025-02-24 20:19:47.134677,2025-02-24 20:19:52.438576,5.303899
channel-750,682308,30280891,30280896,5,2025-02-24 20:20:32.442245,2025-02-24 20:20:38.292960,5.850715
channel-750,682309,30280903,30280916,13,2025-02-24 20:20:46.791737,2025-02-24 20:21:03.516212,16.724475
channel-750,682310,30281039,30281056,17,2025-02-24 20:23:43.909239,2025-02-24 20:24:05.467728,21.558489
channel-750,682311,30281174,30281182,8,2025-02-24 20:26:40.885987,2025-02-24 20:26:52.061589,11.175602
channel-750,682312,30281195,30281203,8,2025-02-24 20:27:08.557501,2025-02-24 20:27:17.767116,9.209615
channel-750,682313,30281197,30281201,4,2025-02-24 20:27:10.783080,2025-02-24 20:27:15.472623,4.689543
channel-750,682314,30281448,30281453,5,2025-02-24 20:32:41.184869,2025-02-24 20:32:46.974806,5.789937
channel-750,682315,30281603,30281608,5,2025-02-24 20:36:04.761797,2025-02-24 20:36:10.489373,5.727576
channel-750,682316,30281631,30281637,6,2025-02-24 20:36:39.372821,2025-02-24 20:36:46.889021,7.5162
channel-750,682317,30281642,30281655,13,2025-02-24 20:36:55.187230,2025-02-24 20:37:11.166234,15.979004
channel-750,682318,30281666,30281676,10,2025-02-24 20:37:25.137213,2025-02-24 20:37:38.002260,12.865047
channel-750,682319,30281806,30281822,16,2025-02-24 20:40:30.057410,2025-02-24 20:40:54.349388,24.291978
channel-750,682320,30281856,30281860,4,2025-02-24 20:41:36.982156,2025-02-24 20:41:42.448175,5.466019
channel-750,682321,30281914,30281937,23,2025-02-24 20:42:53.207884,2025-02-24 20:43:25.646913,32.439029
channel-750,682322,30281933,30281942,9,2025-02-24 20:43:18.657073,2025-02-24 20:43:32.051818,13.394745
channel-750,682323,30281936,30281950,14,2025-02-24 20:43:24.368585,2025-02-24 20:43:41.305563,16.936978
channel-750,682324,30282035,30282039,4,2025-02-24 20:45:33.048226,2025-02-24 20:45:38.140739,5.092513
channel-750,682325,30282064,30282084,20,2025-02-24 20:46:12.765831,2025-02-24 20:46:39.772329,27.006498
channel-750,682326,30282065,30282071,6,2025-02-24 20:46:15.428647,2025-02-24 20:46:23.718151,8.289504
channel-750,682327,30282079,30282084,5,2025-02-24 20:46:34.140957,2025-02-24 20:46:39.772329,5.631372
channel-750,682328,30282101,30282106,5,2025-02-24 20:46:59.830870,2025-02-24 20:47:06.353949,6.523079
channel-750,682329,30282126,30282145,19,2025-02-24 20:47:31.723009,2025-02-24 20:47:55.354367,23.631358
channel-750,682330,30282129,30282145,16,2025-02-24 20:47:35.066221,2025-02-24 20:47:55.354367,20.288146
channel-750,682331,30282129,30282145,16,2025-02-24 20:47:35.066221,2025-02-24 20:47:55.354367,20.288146
channel-750,682332,30282137,30282152,15,2025-02-24 20:47:45.905719,2025-02-24 20:48:03.806072,17.900353
channel-750,682333,30282150,30282160,10,2025-02-24 20:48:01.314317,2025-02-24 20:48:15.899926,14.585609
channel-750,682334,30282175,30282182,7,2025-02-24 20:48:40.543963,2025-02-24 20:48:48.901005,8.357042
channel-750,682335,30282196,30282206,10,2025-02-24 20:49:08.816875,2025-02-24 20:49:20.595808,11.778933
channel-750,682336,30282344,30282357,13,2025-02-24 20:52:22.080478,2025-02-24 20:52:38.301588,16.22111
channel-750,682337,30282380,30282389,9,2025-02-24 20:53:10.195342,2025-02-24 20:53:20.939883,10.744541
channel-750,682338,30282422,30282427,5,2025-02-24 20:54:09.989985,2025-02-24 20:54:17.095110,7.105125
channel-750,682339,30282429,30282434,5,2025-02-24 20:54:19.519230,2025-02-24 20:54:26.379883,6.860653
channel-750,682340,30282482,30282491,9,2025-02-24 20:55:28.569279,2025-02-24 20:55:41.255576,12.686297
channel-750,682341,30282484,30282488,4,2025-02-24 20:55:30.956426,2025-02-24 20:55:37.628663,6.672237
channel-750,682342,30282485,30282497,12,2025-02-24 20:55:33.083203,2025-02-24 20:55:48.169480,15.086277
channel-750,682343,30282585,30282610,25,2025-02-24 20:57:42.763062,2025-02-24 20:58:17.096703,34.333641
channel-750,682344,30282586,30282599,13,2025-02-24 20:57:44.095915,2025-02-24 20:58:02.869119,18.773204
channel-750,682345,30282612,30282622,10,2025-02-24 20:58:22.865412,2025-02-24 20:58:35.353947,12.488535
channel-750,682346,30282659,30282663,4,2025-02-24 20:59:19.964319,2025-02-24 20:59:25.396673,5.432354
channel-750,682347,30282661,30282675,14,2025-02-24 20:59:22.594156,2025-02-24 20:59:42.006628,19.412472
channel-750,682348,30282698,30282702,4,2025-02-24 21:00:14.176485,2025-02-24 21:00:18.715027,4.538542
channel-750,682349,30282703,30282708,5,2025-02-24 21:00:20.038558,2025-02-24 21:00:27.153610,7.115052
channel-750,682350,30282704,30282709,5,2025-02-24 21:00:21.295310,2025-02-24 21:00:28.629616,7.334306
channel-750,682351,30282757,30282763,6,2025-02-24 21:01:30.276826,2025-02-24 21:01:37.276323,6.999497
channel-750,682352,30282815,30282821,6,2025-02-24 21:02:51.626232,2025-02-24 21:02:58.504988,6.878756
channel-750,682353,30282882,30282897,15,2025-02-24 21:04:17.205116,2025-02-24 21:04:36.997154,19.792038
channel-750,682354,30282958,30282965,7,2025-02-24 21:06:00.042674,2025-02-24 21:06:08.576066,8.533392
channel-750,682355,30283105,30283111,6,2025-02-24 21:09:12.001239,2025-02-24 21:09:19.587046,7.585807
channel-750,682356,30283118,30283135,17,2025-02-24 21:09:30.524520,2025-02-24 21:09:51.795660,21.27114
channel-750,682357,30283140,30283149,9,2025-02-24 21:09:58.836463,2025-02-24 21:10:11.771598,12.935135
channel-750,682358,30283156,30283161,5,2025-02-24 21:10:20.329297,2025-02-24 21:10:26.585699,6.256402
channel-750,682359,30283192,30283196,4,2025-02-24 21:11:06.888866,2025-02-24 21:11:13.432566,6.5437
channel-750,682360,30283245,30283250,5,2025-02-24 21:12:18.723532,2025-02-24 21:12:24.420015,5.696483
channel-750,682361,30283287,30283302,15,2025-02-24 21:13:12.609818,2025-02-24 21:13:32.699740,20.089922
channel-750,682362,30283354,30283369,15,2025-02-24 21:14:37.829714,2025-02-24 21:14:56.475348,18.645634
channel-750,682363,30283364,30283369,5,2025-02-24 21:14:50.909158,2025-02-24 21:14:56.475348,5.56619
channel-750,682364,30283403,30283417,14,2025-02-24 21:15:44.558790,2025-02-24 21:16:01.545823,16.987033
channel-750,682365,30283412,30283417,5,2025-02-24 21:15:55.867639,2025-02-24 21:16:01.545823,5.678184
channel-750,682366,30283526,30283537,11,2025-02-24 21:18:25.767868,2025-02-24 21:18:41.420279,15.652411
channel-750,682367,30283579,30283586,7,2025-02-24 21:19:36.898314,2025-02-24 21:19:46.109464,9.21115
channel-750,682368,30283585,30283598,13,2025-02-24 21:19:44.973700,2025-02-24 21:20:00.069874,15.096174
channel-750,682369,30283617,30283621,4,2025-02-24 21:20:25.406893,2025-02-24 21:20:30.299346,4.892453
channel-750,682370,30283624,30283630,6,2025-02-24 21:20:35.345135,2025-02-24 21:20:42.275115,6.92998
channel-750,682371,30283755,30283760,5,2025-02-24 21:23:25.770146,2025-02-24 21:23:31.564446,5.7943
channel-750,682372,30283873,30283876,3,2025-02-24 21:26:01.553411,2025-02-24 21:26:05.999129,4.445718
channel-750,682373,30283942,30283951,9,2025-02-24 21:27:32.706802,2025-02-24 21:27:43.716110,11.009308
channel-750,682374,30283996,30284000,4,2025-02-24 21:28:42.555643,2025-02-24 21:28:47.481393,4.92575
channel-750,682375,30284057,30284070,13,2025-02-24 21:30:05.236035,2025-02-24 21:30:26.965985,21.72995
channel-750,682376,30284088,30284097,9,2025-02-24 21:30:48.678269,2025-02-24 21:31:00.380209,11.70194
channel-750,682377,30284155,30284162,7,2025-02-24 21:32:14.103438,2025-02-24 21:32:23.924843,9.821405
channel-750,682378,30284346,30284351,5,2025-02-24 21:36:29.619545,2025-02-24 21:36:36.753440,7.133895
channel-750,682379,30284381,30284387,6,2025-02-24 21:37:15.079922,2025-02-24 21:37:21.927596,6.847674
channel-750,682380,30284405,30284410,5,2025-02-24 21:37:45.119431,2025-02-24 21:37:50.811380,5.691949
channel-750,682381,30284497,30284501,4,2025-02-24 21:39:52.033458,2025-02-24 21:39:56.430693,4.397235
channel-750,682382,30284582,30284586,4,2025-02-24 21:41:36.924434,2025-02-24 21:41:41.458630,4.534196
channel-750,682383,30284649,30284661,12,2025-02-24 21:43:03.774215,2025-02-24 21:43:18.782834,15.008619
channel-750,682384,30284811,30284833,22,2025-02-24 21:46:37.377493,2025-02-24 21:47:05.567367,28.189874
channel-750,682385,30284963,30284983,20,2025-02-24 21:49:57.859955,2025-02-24 21:50:25.286829,27.426874
channel-750,682386,30285024,30285034,10,2025-02-24 21:51:19.324288,2025-02-24 21:51:30.875433,11.551145
channel-750,682387,30285072,30285083,11,2025-02-24 21:52:19.999045,2025-02-24 21:52:32.826339,12.827294
channel-750,682388,30285098,30285108,10,2025-02-24 21:52:53.268550,2025-02-24 21:53:10.012857,16.744307
channel-750,682389,30285151,30285170,19,2025-02-24 21:54:07.981336,2025-02-24 21:54:32.681751,24.700415
channel-750,682390,30285239,30285267,28,2025-02-24 21:55:59.865993,2025-02-24 21:56:36.260476,36.394483
channel-750,682391,30285318,30285336,18,2025-02-24 21:57:49.590551,2025-02-24 21:58:11.802635,22.212084
channel-750,682392,30285324,30285335,11,2025-02-24 21:57:56.640765,2025-02-24 21:58:10.574156,13.933391
channel-750,682393,30285343,30285348,5,2025-02-24 21:58:19.746027,2025-02-24 21:58:25.625855,5.879828
channel-750,682394,30285415,30285446,31,2025-02-24 21:59:53.118666,2025-02-24 22:00:32.335435,39.216769
channel-750,682395,30285462,30285480,18,2025-02-24 22:00:58.857105,2025-02-24 22:01:21.230108,22.373003
channel-750,682396,30285477,30285486,9,2025-02-24 22:01:17.687749,2025-02-24 22:01:28.382176,10.694427
channel-750,682397,30285491,30285496,5,2025-02-24 22:01:35.121054,2025-02-24 22:01:42.622704,7.50165
channel-750,682398,30285496,30285500,4,2025-02-24 22:01:42.622704,2025-02-24 22:01:48.394896,5.772192
channel-750,682399,30285506,30285522,16,2025-02-24 22:01:57.922847,2025-02-24 22:02:22.358509,24.435662
channel-750,682400,30285529,30285534,5,2025-02-24 22:02:30.886929,2025-02-24 22:02:40.326849,9.43992
channel-750,682401,30285543,30285553,10,2025-02-24 22:02:56.095045,2025-02-24 22:03:15.879935,19.78489
channel-750,682402,30285569,30285573,4,2025-02-24 22:03:38.331018,2025-02-24 22:03:44.050700,5.719682
channel-750,682403,30285575,30285646,71,2025-02-24 22:03:46.904584,2025-02-24 22:05:30.653165,103.748581
channel-750,682404,30285598,30285794,196,2025-02-24 22:04:15.588889,2025-02-24 22:08:47.968735,272.379846
channel-750,682405,30285608,30285794,186,2025-02-24 22:04:33.834558,2025-02-24 22:08:47.968735,254.134177
channel-750,682406,30285640,30285656,16,2025-02-24 22:05:22.771822,2025-02-24 22:05:43.791482,21.01966
channel-750,682407,30285668,30285702,34,2025-02-24 22:05:58.431204,2025-02-24 22:06:43.949387,45.518183
channel-750,682408,30285694,30285709,15,2025-02-24 22:06:32.393289,2025-02-24 22:06:53.515515,21.122226
channel-750,682409,30285727,30285731,4,2025-02-24 22:07:19.233801,2025-02-24 22:07:26.198850,6.965049
channel-750,682410,30285730,30285745,15,2025-02-24 22:07:24.968010,2025-02-24 22:07:43.812506,18.844496
channel-750,682411,30285745,30285770,25,2025-02-24 22:07:43.812506,2025-02-24 22:08:14.682568,30.870062
channel-750,682412,30285754,30285783,29,2025-02-24 22:07:55.203461,2025-02-24 22:08:31.007376,35.803915
channel-750,682413,30285771,30285776,5,2025-02-24 22:08:16.131417,2025-02-24 22:08:21.885326,5.753909
channel-750,682414,30285772,30285788,16,2025-02-24 22:08:17.276865,2025-02-24 22:08:37.034791,19.757926
channel-750,682415,30285790,30285803,13,2025-02-24 22:08:42.527380,2025-02-24 22:09:02.099770,19.57239
channel-750,682416,30285809,30285819,10,2025-02-24 22:09:10.990910,2025-02-24 22:09:22.835655,11.844745
channel-750,682417,30285816,30285833,17,2025-02-24 22:09:19.354026,2025-02-24 22:09:40.933780,21.579754
channel-750,682418,30285821,30285831,10,2025-02-24 22:09:26.056555,2025-02-24 22:09:38.575257,12.518702
channel-750,682419,30285853,30285862,9,2025-02-24 22:10:07.121331,2025-02-24 22:10:22.230697,15.109366
channel-750,682420,30285911,30285928,17,2025-02-24 22:11:31.709254,2025-02-24 22:11:54.138622,22.429368
channel-750,682421,30285938,30285957,19,2025-02-24 22:12:11.176988,2025-02-24 22:12:35.118210,23.941222
channel-750,682422,30285981,30285996,15,2025-02-24 22:13:07.296481,2025-02-24 22:13:29.173750,21.877269
channel-750,682423,30285988,30285998,10,2025-02-24 22:13:15.673435,2025-02-24 22:13:31.628250,15.954815
channel-750,682424,30286011,30286030,19,2025-02-24 22:13:49.114066,2025-02-24 22:14:13.285116,24.17105
channel-750,682425,30286024,30286037,13,2025-02-24 22:14:05.496131,2025-02-24 22:14:23.814755,18.318624
channel-750,682426,30286026,30286036,10,2025-02-24 22:14:07.853691,2025-02-24 22:14:22.622617,14.768926
channel-750,682427,30286060,30286073,13,2025-02-24 22:14:54.067874,2025-02-24 22:15:09.689785,15.621911
channel-750,682428,30286084,30286103,19,2025-02-24 22:15:23.177188,2025-02-24 22:15:49.422040,26.244852
channel-750,682429,30286103,30286111,8,2025-02-24 22:15:49.422040,2025-02-24 22:16:01.080251,11.658211
channel-750,682430,30286120,30286135,15,2025-02-24 22:16:13.836100,2025-02-24 22:16:31.283388,17.447288
channel-750,682431,30286131,30286144,13,2025-02-24 22:16:26.674001,2025-02-24 22:16:46.878496,20.204495
channel-750,682432,30286140,30286154,14,2025-02-24 22:16:38.748858,2025-02-24 22:17:03.711537,24.962679
channel-750,682433,30286169,30286183,14,2025-02-24 22:17:21.495457,2025-02-24 22:17:40.231454,18.735997
channel-750,682434,30286198,30286203,5,2025-02-24 22:17:58.504766,2025-02-24 22:18:04.185259,5.680493
channel-750,682435,30286206,30286222,16,2025-02-24 22:18:07.711542,2025-02-24 22:18:27.790331,20.078789
channel-750,682436,30286224,30286229,5,2025-02-24 22:18:30.654600,2025-02-24 22:18:36.780295,6.125695
channel-750,682437,30286231,30286245,14,2025-02-24 22:18:43.802674,2025-02-24 22:19:02.940005,19.137331
channel-750,682438,30286234,30286242,8,2025-02-24 22:18:47.489265,2025-02-24 22:18:59.515397,12.026132
channel-750,682439,30286252,30286262,10,2025-02-24 22:19:11.873254,2025-02-24 22:19:24.969903,13.096649
channel-750,682440,30286278,30286285,7,2025-02-24 22:19:46.555251,2025-02-24 22:19:54.551095,7.995844
channel-750,682441,30286293,30286305,12,2025-02-24 22:20:04.559658,2025-02-24 22:20:19.870573,15.310915
channel-750,682442,30286297,30286307,10,2025-02-24 22:20:09.417506,2025-02-24 22:20:22.727263,13.309757
channel-750,682443,30286330,30286342,12,2025-02-24 22:20:55.034752,2025-02-24 22:21:09.471499,14.436747
channel-750,682444,30286344,30286350,6,2025-02-24 22:21:11.955497,2025-02-24 22:21:21.921520,9.966023
channel-750,682445,30286376,30286382,6,2025-02-24 22:21:58.304502,2025-02-24 22:22:05.392543,7.088041
channel-750,682446,30286390,30286395,5,2025-02-24 22:22:15.230203,2025-02-24 22:22:21.410103,6.1799
channel-750,682447,30286401,30286409,8,2025-02-24 22:22:29.599223,2025-02-24 22:22:43.290529,13.691306
channel-750,682448,30286490,30286497,7,2025-02-24 22:24:29.806784,2025-02-24 22:24:38.000141,8.193357
channel-750,682449,30286528,30286533,5,2025-02-24 22:25:16.566077,2025-02-24 22:25:23.631867,7.06579
channel-750,682450,30286532,30286545,13,2025-02-24 22:25:22.449389,2025-02-24 22:25:39.900991,17.451602
channel-750,682451,30286548,30286557,9,2025-02-24 22:25:43.396285,2025-02-24 22:25:56.026586,12.630301
channel-750,682452,30286548,30286554,6,2025-02-24 22:25:43.396285,2025-02-24 22:25:51.133410,7.737125
channel-750,682453,30286563,30286570,7,2025-02-24 22:26:06.476289,2025-02-24 22:26:14.867809,8.39152
channel-750,682454,30286567,30286574,7,2025-02-24 22:26:11.137548,2025-02-24 22:26:21.171111,10.033563
channel-750,682455,30286597,30286609,12,2025-02-24 22:26:51.785011,2025-02-24 22:27:06.787672,15.002661
channel-750,682456,30286650,30286657,7,2025-02-24 22:27:58.782172,2025-02-24 22:28:07.437479,8.655307
channel-750,682457,30286655,30286661,6,2025-02-24 22:28:04.994800,2025-02-24 22:28:12.120608,7.125808
channel-750,682458,30286695,30286705,10,2025-02-24 22:28:57.480379,2025-02-24 22:29:10.610009,13.12963
channel-750,682459,30286737,30286743,6,2025-02-24 22:29:51.211262,2025-02-24 22:29:59.406059,8.194797
channel-750,682460,30286790,30286794,4,2025-02-24 22:31:03.173178,2025-02-24 22:31:09.582183,6.409005
channel-750,682461,30287011,30287020,9,2025-02-24 22:35:55.893054,2025-02-24 22:36:08.746873,12.853819
channel-750,682462,30287027,30287032,5,2025-02-24 22:36:16.740850,2025-02-24 22:36:23.042606,6.301756
channel-750,682463,30287050,30287073,23,2025-02-24 22:36:45.196280,2025-02-24 22:37:15.327493,30.131213
channel-750,682464,30287093,30287098,5,2025-02-24 22:37:40.100183,2025-02-24 22:37:48.549965,8.449782
channel-750,682465,30287119,30287130,11,2025-02-24 22:38:17.546283,2025-02-24 22:38:31.472660,13.926377
channel-750,682466,30287148,30287164,16,2025-02-24 22:38:52.746993,2025-02-24 22:39:13.457786,20.710793
channel-750,682467,30287170,30287176,6,2025-02-24 22:39:20.359579,2025-02-24 22:39:28.378629,8.01905
channel-750,682468,30287203,30287213,10,2025-02-24 22:40:11.806245,2025-02-24 22:40:24.008057,12.201812
channel-750,682469,30287235,30287248,13,2025-02-24 22:40:51.218818,2025-02-24 22:41:09.447685,18.228867
channel-750,682470,30287252,30287262,10,2025-02-24 22:41:14.136083,2025-02-24 22:41:25.822191,11.686108
channel-750,682471,30287304,30287309,5,2025-02-24 22:42:20.243330,2025-02-24 22:42:26.007540,5.76421
channel-750,682472,30287395,30287408,13,2025-02-24 22:44:18.730439,2025-02-24 22:44:38.194605,19.464166
channel-750,682473,30287417,30287438,21,2025-02-24 22:44:49.521511,2025-02-24 22:45:16.478284,26.956773
channel-750,682474,30287424,30287432,8,2025-02-24 22:44:57.704979,2025-02-24 22:45:09.446912,11.741933
channel-750,682475,30287434,30287438,4,2025-02-24 22:45:11.911486,2025-02-24 22:45:16.478284,4.566798
channel-750,682476,30287458,30287481,23,2025-02-24 22:45:49.156513,2025-02-24 22:46:17.668492,28.511979
channel-750,682477,30287486,30287502,16,2025-02-24 22:46:24.355107,2025-02-24 22:46:44.416831,20.061724
channel-750,682478,30287538,30287543,5,2025-02-24 22:47:31.108774,2025-02-24 22:47:36.669462,5.560688
channel-750,682479,30287566,30287572,6,2025-02-24 22:48:07.253658,2025-02-24 22:48:14.142114,6.888456
channel-750,682480,30287593,30287607,14,2025-02-24 22:48:40.542031,2025-02-24 22:49:01.100310,20.558279
channel-750,682481,30287608,30287620,12,2025-02-24 22:49:02.228176,2025-02-24 22:49:18.334499,16.106323
channel-750,682482,30287663,30287673,10,2025-02-24 22:50:17.467168,2025-02-24 22:50:30.199944,12.732776
channel-750,682483,30287681,30287687,6,2025-02-24 22:50:41.371356,2025-02-24 22:50:49.285704,7.914348
channel-750,682484,30287779,30287785,6,2025-02-24 22:52:48.044394,2025-02-24 22:52:54.934409,6.890015
channel-750,682485,30287817,30287821,4,2025-02-24 22:53:45.404632,2025-02-24 22:53:51.088196,5.683564
channel-750,682486,30287829,30287835,6,2025-02-24 22:54:02.046560,2025-02-24 22:54:09.790211,7.743651
channel-750,682487,30287876,30287885,9,2025-02-24 22:55:02.695699,2025-02-24 22:55:17.437547,14.741848
channel-750,682488,30287902,30287919,17,2025-02-24 22:55:38.672844,2025-02-24 22:56:00.737052,22.064208
channel-750,682489,30287907,30287923,16,2025-02-24 22:55:45.965663,2025-02-24 22:56:06.973858,21.008195
channel-750,682490,30287923,30287937,14,2025-02-24 22:56:06.973858,2025-02-24 22:56:26.374907,19.401049
channel-750,682491,30288004,30288009,5,2025-02-24 22:57:55.734330,2025-02-24 22:58:02.218048,6.483718
channel-750,682492,30288017,30288022,5,2025-02-24 22:58:14.675244,2025-02-24 22:58:22.415289,7.740045
channel-750,682493,30288037,30288041,4,2025-02-24 22:58:41.638538,2025-02-24 22:58:48.012022,6.373484
channel-750,682494,30288107,30288112,5,2025-02-24 23:00:18.231958,2025-02-24 23:00:24.568830,6.336872
channel-750,682495,30288116,30288127,11,2025-02-24 23:00:29.298022,2025-02-24 23:00:46.258687,16.960665
channel-750,682496,30288117,30288126,9,2025-02-24 23:00:32.051080,2025-02-24 23:00:45.025050,12.97397
channel-750,682497,30288120,30288135,15,2025-02-24 23:00:37.684342,2025-02-24 23:00:55.744424,18.060082
channel-750,682498,30288149,30288155,6,2025-02-24 23:01:18.404269,2025-02-24 23:01:26.344872,7.940603
channel-750,682499,30288171,30288183,12,2025-02-24 23:01:47.746085,2025-02-24 23:02:03.600422,15.854337
channel-750,682500,30288204,30288219,15,2025-02-24 23:02:29.491372,2025-02-24 23:02:48.872474,19.381102
channel-750,682501,30288213,30288224,11,2025-02-24 23:02:40.271808,2025-02-24 23:02:54.876095,14.604287
channel-750,682502,30288213,30288224,11,2025-02-24 23:02:40.271808,2025-02-24 23:02:54.876095,14.604287
channel-750,682503,30288224,30288229,5,2025-02-24 23:02:54.876095,2025-02-24 23:03:04.275321,9.399226
channel-750,682504,30288229,30288232,3,2025-02-24 23:03:04.275321,2025-02-24 23:03:15.133351,10.85803
channel-750,682505,30288229,30288244,15,2025-02-24 23:03:04.275321,2025-02-24 23:03:29.648049,25.372728
channel-750,682506,30288246,30288258,12,2025-02-24 23:03:33.146391,2025-02-24 23:03:48.126999,14.980608
channel-750,682507,30288249,30288260,11,2025-02-24 23:03:36.731167,2025-02-24 23:03:51.434160,14.702993
channel-750,682508,30288274,30288288,14,2025-02-24 23:04:09.603405,2025-02-24 23:04:26.608292,17.004887
channel-750,682509,30288290,30288296,6,2025-02-24 23:04:28.926049,2025-02-24 23:04:35.968958,7.042909
channel-750,682510,30288305,30288314,9,2025-02-24 23:04:47.738243,2025-02-24 23:05:01.511014,13.772771
channel-750,682511,30288314,30288340,26,2025-02-24 23:05:01.511014,2025-02-24 23:05:35.175126,33.664112
channel-750,682512,30288345,30288357,12,2025-02-24 23:05:40.859901,2025-02-24 23:05:56.212369,15.352468
channel-750,682513,30288373,30288394,21,2025-02-24 23:06:19.222919,2025-02-24 23:06:44.219349,24.99643
channel-750,682514,30288381,30288396,15,2025-02-24 23:06:28.850723,2025-02-24 23:06:46.598345,17.747622
channel-750,682515,30288389,30288400,11,2025-02-24 23:06:38.456141,2025-02-24 23:06:54.743123,16.286982
channel-750,682516,30288398,30288403,5,2025-02-24 23:06:52.203089,2025-02-24 23:06:58.613711,6.410622
channel-750,682517,30288406,30288420,14,2025-02-24 23:07:04.320168,2025-02-24 23:07:24.765470,20.445302
channel-750,682518,30288416,30288426,10,2025-02-24 23:07:16.781630,2025-02-24 23:07:31.762789,14.981159
channel-750,682519,30288432,30288451,19,2025-02-24 23:07:39.762981,2025-02-24 23:08:03.621845,23.858864
channel-750,682520,30288455,30288469,14,2025-02-24 23:08:09.303156,2025-02-24 23:08:25.886022,16.582866
channel-750,682521,30288489,30288503,14,2025-02-24 23:08:54.461347,2025-02-24 23:09:14.880666,20.419319
channel-750,682522,30288490,30288501,11,2025-02-24 23:08:55.868506,2025-02-24 23:09:11.005803,15.137297
channel-750,682523,30288495,30288507,12,2025-02-24 23:09:02.777946,2025-02-24 23:09:19.672209,16.894263
channel-750,682524,30288502,30288507,5,2025-02-24 23:09:12.398405,2025-02-24 23:09:19.672209,7.273804
channel-750,682525,30288531,30288545,14,2025-02-24 23:09:49.282684,2025-02-24 23:10:06.147628,16.864944
channel-750,682526,30288566,30288577,11,2025-02-24 23:10:35.224188,2025-02-24 23:10:51.136406,15.912218
channel-750,682527,30288620,30288632,12,2025-02-24 23:11:47.192399,2025-02-24 23:12:06.426488,19.234089
channel-750,682528,30288643,30288657,14,2025-02-24 23:12:19.449857,2025-02-24 23:12:36.656780,17.206923
channel-750,682529,30288694,30288705,11,2025-02-24 23:13:23.927224,2025-02-24 23:13:38.967758,15.040534
channel-750,682530,30288707,30288722,15,2025-02-24 23:13:41.764330,2025-02-24 23:13:59.400330,17.636
channel-750,682531,30288727,30288743,16,2025-02-24 23:14:07.444689,2025-02-24 23:14:27.326593,19.881904
channel-750,682532,30288734,30288745,11,2025-02-24 23:14:15.977517,2025-02-24 23:14:30.696489,14.718972
channel-750,682533,30288751,30288766,15,2025-02-24 23:14:40.435501,2025-02-24 23:14:58.326042,17.890541
channel-750,682534,30288778,30288792,14,2025-02-24 23:15:12.381644,2025-02-24 23:15:31.974318,19.592674
channel-750,682535,30288822,30288835,13,2025-02-24 23:16:09.334892,2025-02-24 23:16:27.098437,17.763545
channel-750,682536,30288943,30288967,24,2025-02-24 23:18:49.161466,2025-02-24 23:19:18.872316,29.71085
channel-750,682537,30288987,30288991,4,2025-02-24 23:19:44.823663,2025-02-24 23:19:51.181929,6.358266
channel-750,682538,30288994,30289005,11,2025-02-24 23:19:55.559209,2025-02-24 23:20:13.836956,18.277747
channel-750,682539,30289022,30289026,4,2025-02-24 23:20:35.980274,2025-02-24 23:20:41.018299,5.038025
channel-750,682540,30289039,30289055,16,2025-02-24 23:20:59.160794,2025-02-24 23:21:17.688720,18.527926
channel-750,682541,30289109,30289123,14,2025-02-24 23:22:29.982432,2025-02-24 23:22:47.445661,17.463229
channel-750,682542,30289157,30289169,12,2025-02-24 23:23:30.327329,2025-02-24 23:23:45.991322,15.663993
channel-750,682543,30289326,30289331,5,2025-02-24 23:27:21.816145,2025-02-24 23:27:27.343160,5.527015
channel-750,682544,30289342,30289349,7,2025-02-24 23:27:41.034075,2025-02-24 23:27:50.454136,9.420061
channel-750,682545,30289346,30289364,18,2025-02-24 23:27:46.742114,2025-02-24 23:28:12.432464,25.69035
channel-750,682546,30289352,30289357,5,2025-02-24 23:27:54.069412,2025-02-24 23:28:03.927302,9.85789
channel-750,682547,30289362,30289372,10,2025-02-24 23:28:10.197574,2025-02-24 23:28:23.215838,13.018264
channel-750,682548,30289370,30289374,4,2025-02-24 23:28:20.928188,2025-02-24 23:28:26.685714,5.757526
channel-750,682549,30289402,30289408,6,2025-02-24 23:29:02.413009,2025-02-24 23:29:09.351699,6.93869
channel-750,682550,30289464,30289469,5,2025-02-24 23:30:26.375996,2025-02-24 23:30:36.948688,10.572692
channel-750,682551,30289468,30289481,13,2025-02-24 23:30:34.512301,2025-02-24 23:30:52.740638,18.228337
channel-750,682552,30289573,30289579,6,2025-02-24 23:32:52.906803,2025-02-24 23:32:59.829046,6.922243
channel-750,682553,30289579,30289590,11,2025-02-24 23:32:59.829046,2025-02-24 23:33:13.364450,13.535404
channel-750,682554,30289682,30289711,29,2025-02-24 23:35:18.700611,2025-02-24 23:35:57.595988,38.895377
channel-750,682555,30289806,30289821,15,2025-02-24 23:38:04.196019,2025-02-24 23:38:25.018211,20.822192
channel-750,682556,30289821,30289832,11,2025-02-24 23:38:25.018211,2025-02-24 23:38:39.744533,14.726322
channel-750,682557,30289889,30289900,11,2025-02-24 23:40:02.111727,2025-02-24 23:40:16.257781,14.146054
channel-750,682558,30289937,30289942,5,2025-02-24 23:41:04.048714,2025-02-24 23:41:10.658063,6.609349
channel-750,682559,30289960,30289972,12,2025-02-24 23:41:36.640755,2025-02-24 23:41:54.049887,17.409132
channel-750,682560,30289966,30289971,5,2025-02-24 23:41:44.919362,2025-02-24 23:41:52.222819,7.303457
channel-750,682561,30289989,30290008,19,2025-02-24 23:42:14.975956,2025-02-24 23:42:39.676013,24.700057
channel-750,682562,30290001,30290014,13,2025-02-24 23:42:31.180782,2025-02-24 23:42:46.588256,15.407474
channel-750,682563,30290033,30290044,11,2025-02-24 23:43:11.297184,2025-02-24 23:43:26.312454,15.01527
channel-750,682564,30290103,30290109,6,2025-02-24 23:44:45.795316,2025-02-24 23:44:54.061784,8.266468
channel-750,682565,30290185,30290196,11,2025-02-24 23:46:34.902285,2025-02-24 23:46:49.852703,14.950418
channel-750,682566,30290304,30290309,5,2025-02-24 23:49:11.764354,2025-02-24 23:49:17.582950,5.818596
channel-750,682567,30290307,30290323,16,2025-02-24 23:49:15.250573,2025-02-24 23:49:40.617632,25.367059
channel-750,682568,30290341,30290354,13,2025-02-24 23:50:04.005210,2025-02-24 23:50:21.067421,17.062211
channel-750,682569,30290385,30290388,3,2025-02-24 23:51:00.444336,2025-02-24 23:51:05.090345,4.646009
channel-750,682570,30290418,30290430,12,2025-02-24 23:51:45.621566,2025-02-24 23:52:01.887851,16.266285
channel-750,682571,30290421,30290432,11,2025-02-24 23:51:49.237657,2025-02-24 23:52:04.109733,14.872076
channel-750,682572,30290460,30290472,12,2025-02-24 23:52:40.429347,2025-02-24 23:52:55.533207,15.10386
channel-750,682573,30290478,30290483,5,2025-02-24 23:53:04.459343,2025-02-24 23:53:11.764598,7.305255
channel-750,682574,30290511,30290526,15,2025-02-24 23:53:48.975313,2025-02-24 23:54:08.963060,19.987747
channel-750,682575,30290514,30290526,12,2025-02-24 23:53:53.079761,2025-02-24 23:54:08.963060,15.883299
channel-750,682576,30290524,30290536,12,2025-02-24 23:54:06.553017,2025-02-24 23:54:22.033254,15.480237
channel-750,682577,30290542,30290555,13,2025-02-24 23:54:29.028346,2025-02-24 23:54:45.021395,15.993049
channel-750,682578,30290580,30290595,15,2025-02-24 23:55:18.561880,2025-02-24 23:55:37.931210,19.36933
channel-750,682579,30290666,30290676,10,2025-02-24 23:57:09.579082,2025-02-24 23:57:21.670262,12.09118
channel-750,682580,30290709,30290720,11,2025-02-24 23:58:04.684767,2025-02-24 23:58:20.826931,16.142164
channel-750,682581,30290805,30290809,4,2025-02-25 00:00:12.738395,2025-02-25 00:00:19.262500,6.524105
channel-750,682582,30290817,30290826,9,2025-02-25 00:00:28.347443,2025-02-25 00:00:41.511426,13.163983
channel-750,682583,30290820,30290825,5,2025-02-25 00:00:33.302819,2025-02-25 00:00:40.290350,6.987531
channel-750,682584,30290834,30290840,6,2025-02-25 00:00:51.602082,2025-02-25 00:00:58.505383,6.903301
channel-750,682585,30290849,30290867,18,2025-02-25 00:01:11.377595,2025-02-25 00:01:33.837425,22.45983
channel-750,682586,30290867,30290872,5,2025-02-25 00:01:33.837425,2025-02-25 00:01:40.944059,7.106634
channel-750,682587,30290867,30290872,5,2025-02-25 00:01:33.837425,2025-02-25 00:01:40.944059,7.106634
channel-750,682588,30290882,30290886,4,2025-02-25 00:01:53.186512,2025-02-25 00:01:58.920637,5.734125
channel-750,682589,30290898,30290903,5,2025-02-25 00:02:15.031121,2025-02-25 00:02:21.611150,6.580029
channel-750,682590,30290904,30290909,5,2025-02-25 00:02:22.831034,2025-02-25 00:02:29.231404,6.40037
channel-750,682591,30290911,30290915,4,2025-02-25 00:02:31.592744,2025-02-25 00:02:37.735489,6.142745
channel-750,682592,30290925,30290929,4,2025-02-25 00:02:50.777182,2025-02-25 00:02:58.805022,8.02784
channel-750,682593,30290939,30290943,4,2025-02-25 00:03:12.449185,2025-02-25 00:03:19.095124,6.645939
channel-750,682594,30290952,30290965,13,2025-02-25 00:03:34.928494,2025-02-25 00:03:49.636555,14.708061
channel-750,682595,30290952,30290959,7,2025-02-25 00:03:34.928494,2025-02-25 00:03:42.614565,7.686071
channel-750,682596,30290964,30290975,11,2025-02-25 00:03:48.531503,2025-02-25 00:04:03.313878,14.782375
channel-750,682597,30290966,30290981,15,2025-02-25 00:03:51.080447,2025-02-25 00:04:10.332016,19.251569
channel-750,682598,30290967,30290975,8,2025-02-25 00:03:52.222732,2025-02-25 00:04:03.313878,11.091146
channel-750,682599,30290995,30290999,4,2025-02-25 00:04:30.048194,2025-02-25 00:04:37.353496,7.305302
channel-750,682600,30291120,30291124,4,2025-02-25 00:07:13.673862,2025-02-25 00:07:18.314171,4.640309
channel-750,682601,30291130,30291135,5,2025-02-25 00:07:28.880964,2025-02-25 00:07:35.082101,6.201137
channel-750,682602,30291208,30291227,19,2025-02-25 00:09:13.189780,2025-02-25 00:09:37.559861,24.370081
channel-750,682603,30291228,30291239,11,2025-02-25 00:09:38.686657,2025-02-25 00:09:51.357480,12.670823
channel-750,682604,30291233,30291249,16,2025-02-25 00:09:43.973902,2025-02-25 00:10:04.083869,20.109967
channel-750,682605,30291251,30291256,5,2025-02-25 00:10:06.547137,2025-02-25 00:10:16.637093,10.089956
channel-750,682606,30291252,30291265,13,2025-02-25 00:10:07.707447,2025-02-25 00:10:28.298100,20.590653
channel-750,682607,30291263,30291280,17,2025-02-25 00:10:25.730113,2025-02-25 00:10:47.550011,21.819898
channel-750,682608,30291325,30291330,5,2025-02-25 00:11:45.987530,2025-02-25 00:11:52.800188,6.812658
channel-750,682609,30291333,30291338,5,2025-02-25 00:11:56.592124,2025-02-25 00:12:03.087141,6.495017
channel-750,682610,30291337,30291342,5,2025-02-25 00:12:01.270773,2025-02-25 00:12:07.689748,6.418975
channel-750,682611,30291363,30291373,10,2025-02-25 00:12:42.482839,2025-02-25 00:12:59.248336,16.765497
channel-750,682612,30291441,30291445,4,2025-02-25 00:14:27.536260,2025-02-25 00:14:32.146402,4.610142
channel-750,682613,30291442,30291455,13,2025-02-25 00:14:28.708883,2025-02-25 00:14:47.025662,18.316779
channel-750,682614,30291466,30291482,16,2025-02-25 00:15:03.621710,2025-02-25 00:15:24.363041,20.741331
channel-750,682615,30291493,30291508,15,2025-02-25 00:15:37.044827,2025-02-25 00:15:59.314886,22.270059
channel-750,682616,30291536,30291553,17,2025-02-25 00:16:42.940851,2025-02-25 00:17:08.551420,25.610569
channel-750,682617,30291555,30291566,11,2025-02-25 00:17:10.988965,2025-02-25 00:17:24.932434,13.943469
channel-750,682618,30291594,30291605,11,2025-02-25 00:17:59.200958,2025-02-25 00:18:14.427581,15.226623
channel-750,682619,30291623,30291633,10,2025-02-25 00:18:38.085577,2025-02-25 00:18:49.781228,11.695651
channel-750,682620,30291672,30291677,5,2025-02-25 00:19:40.833805,2025-02-25 00:19:46.943094,6.109289
channel-750,682621,30291673,30291687,14,2025-02-25 00:19:41.933606,2025-02-25 00:20:04.350713,22.417107
channel-750,682622,30291673,30291685,12,2025-02-25 00:19:41.933606,2025-02-25 00:19:57.764146,15.83054
channel-750,682623,30291685,30291698,13,2025-02-25 00:19:57.764146,2025-02-25 00:20:19.143993,21.379847
channel-750,682624,30291691,30291704,13,2025-02-25 00:20:09.025160,2025-02-25 00:20:27.926403,18.901243
channel-750,682625,30291710,30291722,12,2025-02-25 00:20:36.130185,2025-02-25 00:20:50.100694,13.970509
channel-750,682626,30291710,30291715,5,2025-02-25 00:20:36.130185,2025-02-25 00:20:42.113255,5.98307
channel-750,682627,30291725,30291733,8,2025-02-25 00:20:53.475291,2025-02-25 00:21:03.578250,10.102959
channel-750,682628,30291727,30291739,12,2025-02-25 00:20:55.836669,2025-02-25 00:21:10.934446,15.097777
channel-750,682629,30291736,30291739,3,2025-02-25 00:21:07.325525,2025-02-25 00:21:10.934446,3.608921
channel-750,682630,30291744,30291749,5,2025-02-25 00:21:18.094824,2025-02-25 00:21:25.941834,7.84701
channel-750,682631,30291748,30291761,13,2025-02-25 00:21:23.726350,2025-02-25 00:21:44.194066,20.467716
channel-750,682632,30291748,30291753,5,2025-02-25 00:21:23.726350,2025-02-25 00:21:30.645256,6.918906
channel-750,682633,30291768,30291781,13,2025-02-25 00:21:52.687824,2025-02-25 00:22:09.283960,16.596136
channel-750,682634,30291774,30291779,5,2025-02-25 00:21:59.640656,2025-02-25 00:22:07.095431,7.454775
channel-750,682635,30291789,30291802,13,2025-02-25 00:22:18.413730,2025-02-25 00:22:35.457159,17.043429
channel-750,682636,30291793,30291811,18,2025-02-25 00:22:24.328206,2025-02-25 00:22:47.347365,23.019159
channel-750,682637,30291817,30291834,17,2025-02-25 00:22:55.558639,2025-02-25 00:23:16.712319,21.15368
channel-750,682638,30291827,30291837,10,2025-02-25 00:23:08.341244,2025-02-25 00:23:21.389049,13.047805
channel-750,682639,30291865,30291881,16,2025-02-25 00:24:01.139963,2025-02-25 00:24:21.000311,19.860348
channel-750,682640,30291890,30291895,5,2025-02-25 00:24:32.533228,2025-02-25 00:24:38.775064,6.241836
channel-750,682641,30291906,30291919,13,2025-02-25 00:24:52.287199,2025-02-25 00:25:08.549132,16.261933
channel-750,682642,30291906,30291916,10,2025-02-25 00:24:52.287199,2025-02-25 00:25:05.102738,12.815539
channel-750,682643,30291907,30291920,13,2025-02-25 00:24:53.418903,2025-02-25 00:25:09.651807,16.232904
channel-750,682644,30291924,30291928,4,2025-02-25 00:25:14.208046,2025-02-25 00:25:18.937126,4.72908
channel-750,682645,30291941,30291949,8,2025-02-25 00:25:37.040547,2025-02-25 00:25:47.746641,10.706094
channel-750,682646,30291942,30291954,12,2025-02-25 00:25:39.687202,2025-02-25 00:25:57.811148,18.123946
channel-750,682647,30291967,30291976,9,2025-02-25 00:26:17.412868,2025-02-25 00:26:30.939718,13.52685
channel-750,682648,30292001,30292015,14,2025-02-25 00:27:02.943667,2025-02-25 00:27:22.087525,19.143858
channel-750,682649,30292005,30292015,10,2025-02-25 00:27:09.531256,2025-02-25 00:27:22.087525,12.556269
channel-750,682650,30292042,30292051,9,2025-02-25 00:27:59.790280,2025-02-25 00:28:10.279982,10.489702
channel-750,682651,30292085,30292090,5,2025-02-25 00:28:54.714760,2025-02-25 00:29:00.482723,5.767963
channel-750,682652,30292194,30292209,15,2025-02-25 00:31:16.891372,2025-02-25 00:31:36.214952,19.32358
channel-750,682653,30292374,30292387,13,2025-02-25 00:35:16.822172,2025-02-25 00:35:33.122282,16.30011
channel-750,682654,30292388,30292393,5,2025-02-25 00:35:34.228949,2025-02-25 00:35:40.512130,6.283181
channel-750,682655,30292448,30292459,11,2025-02-25 00:36:52.216093,2025-02-25 00:37:06.385010,14.168917
channel-750,682656,30292471,30292474,3,2025-02-25 00:37:21.799354,2025-02-25 00:37:26.831262,5.031908
channel-750,682657,30292495,30292499,4,2025-02-25 00:37:52.698857,2025-02-25 00:37:57.165655,4.466798
channel-750,682658,30292511,30292516,5,2025-02-25 00:38:13.509612,2025-02-25 00:38:21.315885,7.806273
channel-750,682659,30292531,30292535,4,2025-02-25 00:38:40.436790,2025-02-25 00:38:45.130320,4.69353
channel-750,682660,30292557,30292561,4,2025-02-25 00:39:13.684312,2025-02-25 00:39:18.555530,4.871218
channel-750,682661,30292588,30292609,21,2025-02-25 00:39:54.850916,2025-02-25 00:40:21.485842,26.634926
channel-750,682662,30292607,30292617,10,2025-02-25 00:40:19.132587,2025-02-25 00:40:31.962864,12.830277
channel-750,682663,30292879,30292893,14,2025-02-25 00:46:17.971714,2025-02-25 00:46:35.110803,17.139089
channel-750,682664,30292898,30292904,6,2025-02-25 00:46:40.877368,2025-02-25 00:46:50.420813,9.543445
channel-750,682665,30293066,30293077,11,2025-02-25 00:50:25.151427,2025-02-25 00:50:37.703585,12.552158
channel-750,682666,30293087,30293097,10,2025-02-25 00:50:54.963642,2025-02-25 00:51:09.197760,14.234118
channel-750,682667,30293088,30293102,14,2025-02-25 00:50:56.262354,2025-02-25 00:51:15.243525,18.981171
channel-750,682668,30293191,30293206,15,2025-02-25 00:53:10.618822,2025-02-25 00:53:29.372279,18.753457
channel-750,682669,30293200,30293210,10,2025-02-25 00:53:21.113660,2025-02-25 00:53:34.184230,13.07057
channel-750,682670,30293204,30293216,12,2025-02-25 00:53:26.766704,2025-02-25 00:53:45.175407,18.408703
channel-750,682671,30293264,30293274,10,2025-02-25 00:54:49.319601,2025-02-25 00:55:01.831803,12.512202
channel-750,682672,30293269,30293274,5,2025-02-25 00:54:55.121997,2025-02-25 00:55:01.831803,6.709806
channel-750,682673,30293335,30293348,13,2025-02-25 00:56:20.988119,2025-02-25 00:56:38.500607,17.512488
channel-750,682674,30293361,30293375,14,2025-02-25 00:56:53.913596,2025-02-25 00:57:12.173192,18.259596
channel-750,682675,30293361,30293366,5,2025-02-25 00:56:53.913596,2025-02-25 00:56:59.481415,5.567819
channel-750,682676,30293373,30293387,14,2025-02-25 00:57:08.810965,2025-02-25 00:57:28.878319,20.067354
channel-750,682677,30293374,30293384,10,2025-02-25 00:57:10.913265,2025-02-25 00:57:25.389251,14.475986
channel-750,682678,30293421,30293425,4,2025-02-25 00:58:15.858440,2025-02-25 00:58:22.709587,6.851147
channel-750,682679,30293438,30293449,11,2025-02-25 00:58:44.218556,2025-02-25 00:58:57.231442,13.012886
channel-750,682680,30293511,30293516,5,2025-02-25 01:00:18.188530,2025-02-25 01:00:24.081936,5.893406
channel-750,682681,30293602,30293609,7,2025-02-25 01:02:17.897310,2025-02-25 01:02:25.888748,7.991438
channel-750,682682,30293650,30293655,5,2025-02-25 01:03:22.246379,2025-02-25 01:03:28.147222,5.900843
channel-750,682683,30293665,30293681,16,2025-02-25 01:03:39.855930,2025-02-25 01:04:01.586242,21.730312
channel-750,682684,30293723,30293727,4,2025-02-25 01:04:56.207458,2025-02-25 01:05:00.832197,4.624739
channel-750,682685,30293726,30293742,16,2025-02-25 01:04:59.697154,2025-02-25 01:05:19.887044,20.18989
channel-750,682686,30293739,30293754,15,2025-02-25 01:05:16.304374,2025-02-25 01:05:36.177019,19.872645
channel-750,682687,30293769,30293774,5,2025-02-25 01:05:58.196619,2025-02-25 01:06:05.199528,7.002909
channel-750,682688,30293770,30293775,5,2025-02-25 01:06:00.484142,2025-02-25 01:06:06.445505,5.961363
channel-750,682689,30293782,30293795,13,2025-02-25 01:06:14.985351,2025-02-25 01:06:31.106283,16.120932
channel-750,682690,30293783,30293825,42,2025-02-25 01:06:16.256651,2025-02-25 01:07:10.554400,54.297749
channel-750,682691,30293818,30293842,24,2025-02-25 01:07:00.525892,2025-02-25 01:07:34.430344,33.904452
channel-750,682692,30293900,30293906,6,2025-02-25 01:08:52.447584,2025-02-25 01:09:00.044948,7.597364
channel-750,682693,30293963,30293982,19,2025-02-25 01:10:18.117183,2025-02-25 01:10:42.532545,24.415362
channel-750,682694,30293971,30293975,4,2025-02-25 01:10:28.808535,2025-02-25 01:10:34.342746,5.534211
channel-750,682695,30294030,30294035,5,2025-02-25 01:11:50.557265,2025-02-25 01:11:56.333921,5.776656
channel-750,682696,30294033,30294047,14,2025-02-25 01:11:53.994360,2025-02-25 01:12:10.962807,16.968447
channel-750,682697,30294083,30294087,4,2025-02-25 01:12:56.637811,2025-02-25 01:13:01.907054,5.269243
channel-750,682698,30294118,30294123,5,2025-02-25 01:13:44.883713,2025-02-25 01:13:50.752179,5.868466
channel-750,682699,30294141,30294146,5,2025-02-25 01:14:15.532144,2025-02-25 01:14:21.222410,5.690266
channel-750,682700,30294192,30294204,12,2025-02-25 01:15:20.101852,2025-02-25 01:15:36.342315,16.240463
channel-750,682701,30294198,30294209,11,2025-02-25 01:15:27.263965,2025-02-25 01:15:44.032939,16.768974
channel-750,682702,30294207,30294221,14,2025-02-25 01:15:40.387513,2025-02-25 01:15:58.760975,18.373462
channel-750,682703,30294243,30294248,5,2025-02-25 01:16:26.359098,2025-02-25 01:16:32.191880,5.832782
channel-750,682704,30294278,30294289,11,2025-02-25 01:17:14.327032,2025-02-25 01:17:28.343024,14.015992
channel-750,682705,30294290,30294301,11,2025-02-25 01:17:29.507272,2025-02-25 01:17:43.440974,13.933702
channel-750,682706,30294317,30294328,11,2025-02-25 01:18:05.075063,2025-02-25 01:18:18.341349,13.266286
channel-750,682707,30294540,30294548,8,2025-02-25 01:22:58.405885,2025-02-25 01:23:09.173079,10.767194
channel-750,682708,30294566,30294570,4,2025-02-25 01:23:36.267222,2025-02-25 01:23:42.492211,6.224989
channel-750,682709,30294569,30294580,11,2025-02-25 01:23:40.312276,2025-02-25 01:23:53.852494,13.540218
channel-750,682710,30294608,30294613,5,2025-02-25 01:24:29.488055,2025-02-25 01:24:35.418576,5.930521
channel-750,682711,30294618,30294624,6,2025-02-25 01:24:42.078910,2025-02-25 01:24:49.041542,6.962632
channel-750,682712,30294621,30294633,12,2025-02-25 01:24:45.644089,2025-02-25 01:25:01.282987,15.638898
channel-750,682713,30294686,30294695,9,2025-02-25 01:26:13.107053,2025-02-25 01:26:26.966646,13.859593
channel-750,682714,30294710,30294721,11,2025-02-25 01:26:47.144150,2025-02-25 01:26:59.695402,12.551252
channel-750,682715,30294780,30294795,15,2025-02-25 01:28:15.887873,2025-02-25 01:28:34.616730,18.728857
channel-750,682716,30294795,30294800,5,2025-02-25 01:28:34.616730,2025-02-25 01:28:40.111748,5.495018
channel-750,682717,30294801,30294806,5,2025-02-25 01:28:41.915763,2025-02-25 01:28:48.114408,6.198645
channel-750,682718,30294869,30294875,6,2025-02-25 01:30:12.672192,2025-02-25 01:30:20.830333,8.158141
channel-750,682719,30294883,30294887,4,2025-02-25 01:30:31.985794,2025-02-25 01:30:37.480669,5.494875
channel-750,682720,30294916,30294931,15,2025-02-25 01:31:17.119954,2025-02-25 01:31:37.664835,20.544881
channel-750,682721,30294972,30294981,9,2025-02-25 01:32:28.149537,2025-02-25 01:32:43.846010,15.696473
channel-750,682722,30294977,30294988,11,2025-02-25 01:32:35.175279,2025-02-25 01:32:52.942636,17.767357
channel-750,682723,30295000,30295013,13,2025-02-25 01:33:09.726502,2025-02-25 01:33:26.315698,16.589196
channel-750,682724,30295001,30295014,13,2025-02-25 01:33:11.858318,2025-02-25 01:33:27.576478,15.71816
channel-750,682725,30295008,30295013,5,2025-02-25 01:33:20.465066,2025-02-25 01:33:26.315698,5.850632
channel-750,682726,30295027,30295043,16,2025-02-25 01:33:42.734179,2025-02-25 01:34:04.091714,21.357535
channel-750,682727,30295053,30295059,6,2025-02-25 01:34:15.774689,2025-02-25 01:34:22.993852,7.219163
channel-750,682728,30295109,30295123,14,2025-02-25 01:35:31.831389,2025-02-25 01:35:49.300466,17.469077
channel-750,682729,30295119,30295122,3,2025-02-25 01:35:43.576279,2025-02-25 01:35:48.138736,4.562457
channel-750,682730,30295129,30295146,17,2025-02-25 01:35:58.224960,2025-02-25 01:36:18.799266,20.574306
channel-750,682731,30295397,30295407,10,2025-02-25 01:41:55.706288,2025-02-25 01:42:07.327322,11.621034
channel-750,682732,30295435,30295449,14,2025-02-25 01:42:43.869558,2025-02-25 01:43:02.464220,18.594662
channel-750,682733,30295475,30295489,14,2025-02-25 01:43:35.870655,2025-02-25 01:43:52.622258,16.751603
channel-750,682734,30295699,30295704,5,2025-02-25 01:48:27.221948,2025-02-25 01:48:32.981080,5.759132
channel-750,682735,30295802,30295813,11,2025-02-25 01:50:43.598793,2025-02-25 01:50:56.610994,13.012201
channel-750,682736,30295825,30295830,5,2025-02-25 01:51:11.978239,2025-02-25 01:51:19.207217,7.228978
channel-750,682737,30295909,30295925,16,2025-02-25 01:53:08.036797,2025-02-25 01:53:30.336839,22.300042
channel-750,682738,30295991,30296004,13,2025-02-25 01:54:57.659088,2025-02-25 01:55:16.268496,18.609408
channel-750,682739,30296024,30296038,14,2025-02-25 01:55:43.223499,2025-02-25 01:55:59.443229,16.21973
channel-750,682740,30296123,30296128,5,2025-02-25 01:57:53.291100,2025-02-25 01:57:59.459917,6.168817
channel-750,682741,30296145,30296159,14,2025-02-25 01:58:21.469552,2025-02-25 01:58:38.244244,16.774692
channel-750,682742,30296193,30296205,12,2025-02-25 01:59:22.033220,2025-02-25 01:59:37.633628,15.600408
channel-750,682743,30296201,30296214,13,2025-02-25 01:59:32.881274,2025-02-25 01:59:49.203187,16.321913
channel-750,682744,30296233,30296238,5,2025-02-25 02:00:13.950356,2025-02-25 02:00:20.976978,7.026622
channel-750,682745,30296250,30296263,13,2025-02-25 02:00:36.756329,2025-02-25 02:00:52.224548,15.468219
channel-750,682746,30296384,30296397,13,2025-02-25 02:03:37.436164,2025-02-25 02:03:52.934357,15.498193
channel-750,682747,30296527,30296540,13,2025-02-25 02:06:39.766584,2025-02-25 02:07:02.485918,22.719334
channel-750,682748,30296837,30296842,5,2025-02-25 02:13:35.888326,2025-02-25 02:13:45.149489,9.261163
channel-750,682749,30296893,30296905,12,2025-02-25 02:14:56.316589,2025-02-25 02:15:10.680784,14.364195
channel-750,682750,30296916,30296924,8,2025-02-25 02:15:25.497441,2025-02-25 02:15:35.047208,9.549767
channel-750,682751,30296923,30296940,17,2025-02-25 02:15:33.901058,2025-02-25 02:15:54.831696,20.930638
channel-750,682752,30296936,30296942,6,2025-02-25 02:15:50.234695,2025-02-25 02:15:59.182464,8.947769
channel-750,682753,30297022,30297031,9,2025-02-25 02:17:47.132633,2025-02-25 02:17:57.733889,10.601256
channel-750,682754,30297044,30297048,4,2025-02-25 02:18:13.326491,2025-02-25 02:18:19.036713,5.710222
channel-750,682755,30297058,30297063,5,2025-02-25 02:18:31.707164,2025-02-25 02:18:42.366821,10.659657
channel-750,682756,30297072,30297077,5,2025-02-25 02:18:54.463418,2025-02-25 02:19:00.884860,6.421442
channel-750,682757,30297073,30297077,4,2025-02-25 02:18:55.560335,2025-02-25 02:19:00.884860,5.324525
channel-750,682758,30297096,30297106,10,2025-02-25 02:19:23.509339,2025-02-25 02:19:36.152501,12.643162
channel-750,682759,30297127,30297135,8,2025-02-25 02:20:03.616423,2025-02-25 02:20:13.797861,10.181438
channel-750,682760,30297153,30297164,11,2025-02-25 02:20:39.701122,2025-02-25 02:20:57.950193,18.249071
channel-750,682761,30297155,30297160,5,2025-02-25 02:20:43.278636,2025-02-25 02:20:53.140245,9.861609
channel-750,682762,30297175,30297181,6,2025-02-25 02:21:13.543368,2025-02-25 02:21:20.753496,7.210128
channel-750,682763,30297202,30297211,9,2025-02-25 02:21:47.621421,2025-02-25 02:21:59.859419,12.237998
channel-750,682764,30297210,30297226,16,2025-02-25 02:21:58.746808,2025-02-25 02:22:17.429602,18.682794
channel-750,682765,30297236,30297241,5,2025-02-25 02:22:33.371477,2025-02-25 02:22:39.782042,6.410565
channel-750,682766,30297348,30297353,5,2025-02-25 02:25:00.836776,2025-02-25 02:25:06.844444,6.007668
channel-750,682767,30297366,30297370,4,2025-02-25 02:25:26.781237,2025-02-25 02:25:33.025508,6.244271
channel-750,682768,30297445,30297456,11,2025-02-25 02:27:10.312131,2025-02-25 02:27:23.083920,12.771789
channel-750,682769,30297630,30297635,5,2025-02-25 02:31:07.299495,2025-02-25 02:31:13.411658,6.112163
channel-750,682770,30297638,30297647,9,2025-02-25 02:31:19.175073,2025-02-25 02:31:29.663043,10.48797
channel-750,682771,30297651,30297661,10,2025-02-25 02:31:34.316988,2025-02-25 02:31:46.181452,11.864464
channel-750,682772,30297735,30297740,5,2025-02-25 02:33:25.280573,2025-02-25 02:33:31.098950,5.818377
channel-750,682773,30297765,30297772,7,2025-02-25 02:34:05.462426,2025-02-25 02:34:14.087096,8.62467
channel-750,682774,30297797,30297802,5,2025-02-25 02:34:47.562444,2025-02-25 02:34:54.047991,6.485547
channel-750,682775,30297828,30297842,14,2025-02-25 02:35:28.110713,2025-02-25 02:35:48.406615,20.295902
channel-750,682776,30298015,30298028,13,2025-02-25 02:39:35.789707,2025-02-25 02:39:54.023116,18.233409
channel-750,682777,30298088,30298100,12,2025-02-25 02:41:09.875555,2025-02-25 02:41:24.362593,14.487038
channel-750,682778,30298126,30298135,9,2025-02-25 02:42:00.661882,2025-02-25 02:42:13.682105,13.020223
channel-750,682779,30298144,30298149,5,2025-02-25 02:42:25.804625,2025-02-25 02:42:31.897745,6.09312
channel-750,682780,30298167,30298173,6,2025-02-25 02:42:56.270978,2025-02-25 02:43:03.249276,6.978298
channel-750,682781,30298187,30298195,8,2025-02-25 02:43:22.436897,2025-02-25 02:43:37.547146,15.110249
channel-750,682782,30298190,30298212,22,2025-02-25 02:43:27.005746,2025-02-25 02:43:58.439932,31.434186
channel-750,682783,30298191,30298200,9,2025-02-25 02:43:28.378783,2025-02-25 02:43:43.369006,14.990223
channel-750,682784,30298192,30298211,19,2025-02-25 02:43:29.483367,2025-02-25 02:43:57.097882,27.614515
channel-750,682785,30298228,30298241,13,2025-02-25 02:44:18.651107,2025-02-25 02:44:34.723985,16.072878
channel-750,682786,30298240,30298251,11,2025-02-25 02:44:33.697293,2025-02-25 02:44:48.174483,14.47719
channel-750,682787,30298260,30298265,5,2025-02-25 02:44:59.686032,2025-02-25 02:45:07.149263,7.463231
channel-750,682788,30298264,30298276,12,2025-02-25 02:45:04.725112,2025-02-25 02:45:21.963789,17.238677
channel-750,682789,30298278,30298289,11,2025-02-25 02:45:24.280523,2025-02-25 02:45:37.108308,12.827785
channel-750,682790,30298338,30298355,17,2025-02-25 02:46:40.435876,2025-02-25 02:47:04.614024,24.178148
channel-750,682791,30298350,30298360,10,2025-02-25 02:46:57.700113,2025-02-25 02:47:13.895548,16.195435
channel-750,682792,30298361,30298376,15,2025-02-25 02:47:15.598380,2025-02-25 02:47:34.957827,19.359447
channel-750,682793,30298361,30298373,12,2025-02-25 02:47:15.598380,2025-02-25 02:47:31.580820,15.98244
channel-750,682794,30298368,30298374,6,2025-02-25 02:47:25.629383,2025-02-25 02:47:32.749954,7.120571
channel-750,682795,30298383,30298396,13,2025-02-25 02:47:43.860591,2025-02-25 02:47:59.781437,15.920846
channel-750,682796,30298399,30298413,14,2025-02-25 02:48:03.375230,2025-02-25 02:48:24.003911,20.628681
channel-750,682797,30298408,30298419,11,2025-02-25 02:48:16.844048,2025-02-25 02:48:31.095728,14.25168
channel-750,682798,30298436,30298445,9,2025-02-25 02:48:51.990311,2025-02-25 02:49:03.412007,11.421696
channel-750,682799,30298459,30298470,11,2025-02-25 02:49:22.117443,2025-02-25 02:49:37.735602,15.618159
channel-750,682800,30298484,30298488,4,2025-02-25 02:49:57.387510,2025-02-25 02:50:03.385632,5.998122
channel-750,682801,30298521,30298526,5,2025-02-25 02:50:46.465442,2025-02-25 02:50:53.052879,6.587437
channel-750,682802,30298522,30298537,15,2025-02-25 02:50:47.665099,2025-02-25 02:51:08.803209,21.13811
channel-750,682803,30298524,30298537,13,2025-02-25 02:50:50.054505,2025-02-25 02:51:08.803209,18.748704
channel-750,682804,30298535,30298554,19,2025-02-25 02:51:05.155733,2025-02-25 02:51:28.679769,23.524036
channel-750,682805,30298542,30298553,11,2025-02-25 02:51:14.382029,2025-02-25 02:51:27.546236,13.164207
channel-750,682806,30298619,30298636,17,2025-02-25 02:53:02.603461,2025-02-25 02:53:25.463222,22.859761
channel-750,682807,30298630,30298642,12,2025-02-25 02:53:17.312736,2025-02-25 02:53:32.640846,15.32811
channel-750,682808,30298635,30298646,11,2025-02-25 02:53:23.212899,2025-02-25 02:53:38.366961,15.154062
channel-750,682809,30298637,30298650,13,2025-02-25 02:53:26.573817,2025-02-25 02:53:44.249405,17.675588
channel-750,682810,30298637,30298642,5,2025-02-25 02:53:26.573817,2025-02-25 02:53:32.640846,6.067029
channel-750,682811,30298641,30298651,10,2025-02-25 02:53:31.552537,2025-02-25 02:53:45.399241,13.846704
channel-750,682812,30298642,30298655,13,2025-02-25 02:53:32.640846,2025-02-25 02:53:50.085573,17.444727
channel-750,682813,30298660,30298667,7,2025-02-25 02:53:56.667760,2025-02-25 02:54:09.223923,12.556163
channel-750,682814,30298662,30298675,13,2025-02-25 02:53:58.907748,2025-02-25 02:54:18.949107,20.041359
channel-750,682815,30298665,30298678,13,2025-02-25 02:54:05.925118,2025-02-25 02:54:23.673649,17.748531
channel-750,682816,30298665,30298677,12,2025-02-25 02:54:05.925118,2025-02-25 02:54:22.444578,16.51946
channel-750,682817,30298666,30298671,5,2025-02-25 02:54:07.045788,2025-02-25 02:54:13.787241,6.741453
channel-750,682818,30298667,30298680,13,2025-02-25 02:54:09.223923,2025-02-25 02:54:26.012289,16.788366
channel-750,682819,30298683,30298693,10,2025-02-25 02:54:29.632370,2025-02-25 02:54:44.108348,14.475978
channel-750,682820,30298687,30298699,12,2025-02-25 02:54:35.395066,2025-02-25 02:54:51.000763,15.605697
channel-750,682821,30298706,30298715,9,2025-02-25 02:55:01.062212,2025-02-25 02:55:16.399688,15.337476
channel-750,682822,30298706,30298716,10,2025-02-25 02:55:01.062212,2025-02-25 02:55:17.577503,16.515291
channel-750,682823,30298717,30298735,18,2025-02-25 02:55:18.675966,2025-02-25 02:55:40.293464,21.617498
channel-750,682824,30298726,30298738,12,2025-02-25 02:55:29.928235,2025-02-25 02:55:44.107441,14.179206
channel-750,682825,30298733,30298742,9,2025-02-25 02:55:38.091108,2025-02-25 02:55:49.844687,11.753579
channel-750,682826,30298746,30298749,3,2025-02-25 02:55:54.710457,2025-02-25 02:55:59.400050,4.689593
channel-750,682827,30298760,30298769,9,2025-02-25 02:56:19.555394,2025-02-25 02:56:35.798229,16.242835
channel-750,682828,30298767,30298776,9,2025-02-25 02:56:32.542243,2025-02-25 02:56:46.267960,13.725717
channel-750,682829,30298768,30298784,16,2025-02-25 02:56:34.341936,2025-02-25 02:56:56.391806,22.04987
channel-750,682830,30298770,30298784,14,2025-02-25 02:56:37.200756,2025-02-25 02:56:56.391806,19.19105
channel-750,682831,30298773,30298788,15,2025-02-25 02:56:41.382828,2025-02-25 02:57:02.491655,21.108827
channel-750,682832,30298778,30298784,6,2025-02-25 02:56:48.750107,2025-02-25 02:56:56.391806,7.641699
channel-750,682833,30298779,30298784,5,2025-02-25 02:56:49.927821,2025-02-25 02:56:56.391806,6.463985
channel-750,682834,30298784,30298790,6,2025-02-25 02:56:56.391806,2025-02-25 02:57:05.337679,8.945873
channel-750,682835,30298802,30298813,11,2025-02-25 02:57:23.516075,2025-02-25 02:57:36.568171,13.052096
channel-750,682836,30298806,30298826,20,2025-02-25 02:57:28.074779,2025-02-25 02:57:59.653047,31.578268
channel-750,682837,30298815,30298819,4,2025-02-25 02:57:42.267775,2025-02-25 02:57:47.638290,5.370515
channel-750,682838,30298819,30298823,4,2025-02-25 02:57:47.638290,2025-02-25 02:57:56.024840,8.38655
channel-750,682839,30298829,30298843,14,2025-02-25 02:58:03.156256,2025-02-25 02:58:26.097949,22.941693
channel-750,682840,30298847,30298856,9,2025-02-25 02:58:30.902600,2025-02-25 02:58:42.353202,11.450602
channel-750,682841,30298853,30298857,4,2025-02-25 02:58:38.172561,2025-02-25 02:58:43.475661,5.3031
channel-750,682842,30298871,30298875,4,2025-02-25 02:58:59.409094,2025-02-25 02:59:04.032031,4.622937
channel-750,682843,30298872,30298882,10,2025-02-25 02:59:00.551622,2025-02-25 02:59:14.898576,14.346954
channel-750,682844,30298908,30298912,4,2025-02-25 02:59:52.871826,2025-02-25 02:59:57.849266,4.97744
channel-750,682845,30298924,30298929,5,2025-02-25 03:00:16.646553,2025-02-25 03:00:26.225938,9.579385
channel-750,682846,30299006,30299019,13,2025-02-25 03:02:13.689889,2025-02-25 03:02:30.042944,16.353055
channel-750,682847,30299086,30299101,15,2025-02-25 03:04:00.314657,2025-02-25 03:04:19.308311,18.993654
channel-750,682848,30299183,30299207,24,2025-02-25 03:06:07.974492,2025-02-25 03:06:37.195747,29.221255
channel-750,682849,30299191,30299195,4,2025-02-25 03:06:17.842399,2025-02-25 03:06:23.486435,5.644036
channel-750,682850,30299258,30299276,18,2025-02-25 03:07:48.801858,2025-02-25 03:08:14.896511,26.094653
channel-750,682851,30299291,30299316,25,2025-02-25 03:08:34.493130,2025-02-25 03:09:06.072289,31.579159
channel-750,682852,30299346,30299368,22,2025-02-25 03:09:44.637100,2025-02-25 03:10:11.981659,27.344559
channel-750,682853,30299372,30299379,7,2025-02-25 03:10:20.652505,2025-02-25 03:10:30.801166,10.148661
channel-750,682854,30299389,30299399,10,2025-02-25 03:10:47.917553,2025-02-25 03:11:07.951230,20.033677
channel-750,682855,30299446,30299459,13,2025-02-25 03:12:14.990409,2025-02-25 03:12:31.010519,16.02011
channel-750,682856,30299448,30299453,5,2025-02-25 03:12:17.881868,2025-02-25 03:12:23.878371,5.996503
channel-750,682857,30299490,30299502,12,2025-02-25 03:13:16.339436,2025-02-25 03:13:49.508797,33.169361
channel-750,682858,30299499,30299504,5,2025-02-25 03:13:45.293747,2025-02-25 03:13:51.984836,6.691089
channel-750,682859,30299534,30299539,5,2025-02-25 03:14:32.797133,2025-02-25 03:14:38.636552,5.839419
channel-750,682860,30299620,30299626,6,2025-02-25 03:16:40.472002,2025-02-25 03:16:47.732382,7.26038
channel-750,682861,30299628,30299633,5,2025-02-25 03:16:51.167750,2025-02-25 03:16:57.208436,6.040686
channel-750,682862,30299655,30299664,9,2025-02-25 03:17:28.844466,2025-02-25 03:17:48.100600,19.256134
channel-750,682863,30299660,30299667,7,2025-02-25 03:17:43.425034,2025-02-25 03:17:52.759206,9.334172
channel-750,682864,30299703,30299713,10,2025-02-25 03:18:50.389738,2025-02-25 03:19:09.240187,18.850449
channel-750,682865,30300328,30300351,23,2025-02-25 03:32:49.782119,2025-02-25 03:33:20.311787,30.529668
channel-750,682866,30300480,30300780,300,2025-02-25 03:36:07.845419,2025-02-25 03:42:44.212208,396.366789
channel-750,682867,30300654,30300659,5,2025-02-25 03:40:00.014130,2025-02-25 03:40:05.673602,5.659472
channel-750,682868,30300756,30300771,15,2025-02-25 03:42:14.184482,2025-02-25 03:42:32.193867,18.009385
channel-750,682869,30300822,30300826,4,2025-02-25 03:43:38.988614,2025-02-25 03:43:44.710678,5.722064
channel-750,682870,30300856,30300862,6,2025-02-25 03:44:26.890268,2025-02-25 03:44:33.509805,6.619537
channel-750,682871,30300954,30300958,4,2025-02-25 03:46:36.468077,2025-02-25 03:46:41.173901,4.705824
channel-750,682872,30300970,30300975,5,2025-02-25 03:46:59.843205,2025-02-25 03:47:06.863953,7.020748
channel-750,682873,30301223,30301233,10,2025-02-25 03:52:29.253561,2025-02-25 03:52:41.350141,12.09658
channel-750,682874,30301239,30301252,13,2025-02-25 03:52:48.540465,2025-02-25 03:53:03.709892,15.169427
channel-750,682875,30301345,30301362,17,2025-02-25 03:55:07.563107,2025-02-25 03:55:28.834586,21.271479
channel-750,682876,30301387,30301392,5,2025-02-25 03:56:00.765714,2025-02-25 03:56:07.921159,7.155445
channel-750,682877,30301447,30301463,16,2025-02-25 03:57:16.470411,2025-02-25 03:57:37.336929,20.866518
channel-750,682878,30301527,30301532,5,2025-02-25 03:59:06.345094,2025-02-25 03:59:12.419500,6.074406
channel-750,682879,30301580,30301585,5,2025-02-25 04:00:14.455784,2025-02-25 04:00:20.131538,5.675754
channel-750,682880,30301595,30301606,11,2025-02-25 04:00:33.048102,2025-02-25 04:00:46.723560,13.675458
channel-750,682881,30301656,30301660,4,2025-02-25 04:01:49.096102,2025-02-25 04:01:54.331427,5.235325
channel-750,682882,30301679,30301683,4,2025-02-25 04:02:16.372986,2025-02-25 04:02:20.890686,4.5177
channel-750,682883,30301694,30301703,9,2025-02-25 04:02:36.651074,2025-02-25 04:02:48.936984,12.28591
channel-750,682884,30301695,30301710,15,2025-02-25 04:02:38.745424,2025-02-25 04:02:58.714191,19.968767
channel-750,682885,30301940,30301951,11,2025-02-25 04:07:55.722117,2025-02-25 04:08:12.561425,16.839308
channel-750,682886,30302039,30302044,5,2025-02-25 04:10:04.696776,2025-02-25 04:10:10.243545,5.546769
channel-750,682887,30302053,30302064,11,2025-02-25 04:10:20.307675,2025-02-25 04:10:34.529979,14.222304
channel-750,682888,30302075,30302087,12,2025-02-25 04:10:48.417824,2025-02-25 04:11:04.847837,16.430013
channel-750,682889,30302078,30302089,11,2025-02-25 04:10:51.764601,2025-02-25 04:11:07.650840,15.886239
channel-750,682890,30302115,30302128,13,2025-02-25 04:11:37.696255,2025-02-25 04:11:55.140004,17.443749
channel-750,682891,30302118,30302122,4,2025-02-25 04:11:42.085468,2025-02-25 04:11:48.341499,6.256031
channel-750,682892,30302155,30302168,13,2025-02-25 04:12:32.404131,2025-02-25 04:12:48.399545,15.995414
channel-750,682893,30302169,30302179,10,2025-02-25 04:12:49.629245,2025-02-25 04:13:02.732067,13.102822
channel-750,682894,30302180,30302192,12,2025-02-25 04:13:05.019744,2025-02-25 04:13:19.981332,14.961588
channel-750,682895,30302181,30302186,5,2025-02-25 04:13:06.230876,2025-02-25 04:13:12.046122,5.815246
channel-750,682896,30302196,30302201,5,2025-02-25 04:13:24.930591,2025-02-25 04:13:31.455109,6.524518
channel-750,682897,30302201,30302214,13,2025-02-25 04:13:31.455109,2025-02-25 04:13:48.256613,16.801504
channel-750,682898,30302212,30302218,6,2025-02-25 04:13:45.758931,2025-02-25 04:13:52.983625,7.224694
channel-750,682899,30302226,30302240,14,2025-02-25 04:14:04.515356,2025-02-25 04:14:21.853329,17.337973
channel-750,682900,30302231,30302243,12,2025-02-25 04:14:11.138930,2025-02-25 04:14:25.230012,14.091082
channel-750,682901,30302250,30302261,11,2025-02-25 04:14:33.172453,2025-02-25 04:14:48.807468,15.635015
channel-750,682902,30302273,30302285,12,2025-02-25 04:15:03.571557,2025-02-25 04:15:19.457980,15.886423
channel-750,682903,30302279,30302312,33,2025-02-25 04:15:11.617105,2025-02-25 04:15:50.772951,39.155846
channel-750,682904,30302283,30302289,6,2025-02-25 04:15:16.609730,2025-02-25 04:15:24.346793,7.737063
channel-750,682905,30302296,30302309,13,2025-02-25 04:15:32.487028,2025-02-25 04:15:47.527145,15.040117
channel-750,682906,30302335,30302356,21,2025-02-25 04:16:22.632510,2025-02-25 04:16:50.026899,27.394389
channel-750,682907,30302351,30302359,8,2025-02-25 04:16:44.316506,2025-02-25 04:16:56.460431,12.143925
channel-750,682908,30302351,30302363,12,2025-02-25 04:16:44.316506,2025-02-25 04:17:01.911263,17.594757
channel-750,682909,30302420,30302444,24,2025-02-25 04:18:13.053386,2025-02-25 04:18:44.089932,31.036546
channel-750,682910,30302443,30302454,11,2025-02-25 04:18:42.928414,2025-02-25 04:18:57.830437,14.902023
channel-750,682911,30302479,30302494,15,2025-02-25 04:19:27.557379,2025-02-25 04:19:46.311900,18.754521
channel-750,682912,30302491,30302496,5,2025-02-25 04:19:42.938960,2025-02-25 04:19:48.627512,5.688552
channel-750,682913,30302513,30302525,12,2025-02-25 04:20:09.652444,2025-02-25 04:20:27.738312,18.085868
channel-750,682914,30302624,30302629,5,2025-02-25 04:22:40.908199,2025-02-25 04:22:46.796388,5.888189
channel-750,682915,30302675,30302679,4,2025-02-25 04:23:45.180484,2025-02-25 04:23:49.834287,4.653803
channel-750,682916,30302676,30302692,16,2025-02-25 04:23:46.366610,2025-02-25 04:24:06.236672,19.870062
channel-750,682917,30302707,30302712,5,2025-02-25 04:24:26.116041,2025-02-25 04:24:33.222684,7.106643
channel-750,682918,30302832,30302851,19,2025-02-25 04:27:09.189720,2025-02-25 04:27:32.896236,23.706516
channel-750,682919,30302843,30302847,4,2025-02-25 04:27:23.143987,2025-02-25 04:27:28.224223,5.080236
channel-750,682920,30302917,30302934,17,2025-02-25 04:28:57.685725,2025-02-25 04:29:17.098717,19.412992
channel-750,682921,30303074,30303078,4,2025-02-25 04:32:21.280379,2025-02-25 04:32:26.598550,5.318171
channel-750,682922,30303177,30303188,11,2025-02-25 04:34:34.890460,2025-02-25 04:34:47.256831,12.366371
channel-750,682923,30303215,30303223,8,2025-02-25 04:35:24.816558,2025-02-25 04:35:33.969788,9.15323
channel-750,682924,30303378,30303385,7,2025-02-25 04:38:51.012307,2025-02-25 04:39:01.438661,10.426354
channel-750,682925,30303465,30303484,19,2025-02-25 04:40:44.756937,2025-02-25 04:41:10.445987,25.68905
channel-750,682926,30303513,30303526,13,2025-02-25 04:41:46.026245,2025-02-25 04:42:04.132066,18.105821
channel-750,682927,30303525,30303530,5,2025-02-25 04:42:02.932382,2025-02-25 04:42:08.778901,5.846519
channel-750,682928,30303538,30303543,5,2025-02-25 04:42:20.004114,2025-02-25 04:42:25.820263,5.816149
channel-750,682929,30303565,30303585,20,2025-02-25 04:42:52.665253,2025-02-25 04:43:18.628033,25.96278
channel-750,682930,30303592,30303598,6,2025-02-25 04:43:26.988052,2025-02-25 04:43:34.076488,7.088436
channel-750,682931,30303674,30303687,13,2025-02-25 04:45:14.717062,2025-02-25 04:45:30.988046,16.270984
channel-750,682932,30303696,30303714,18,2025-02-25 04:45:42.380307,2025-02-25 04:46:03.696578,21.316271
channel-750,682933,30303714,30303727,13,2025-02-25 04:46:03.696578,2025-02-25 04:46:19.744889,16.048311
channel-750,682934,30304010,30304030,20,2025-02-25 04:52:24.769022,2025-02-25 04:52:53.180272,28.41125
channel-750,682935,30304022,30304030,8,2025-02-25 04:52:44.031825,2025-02-25 04:52:53.180272,9.148447
channel-750,682936,30304081,30304099,18,2025-02-25 04:54:00.834503,2025-02-25 04:54:23.705658,22.871155
channel-750,682937,30304103,30304109,6,2025-02-25 04:54:28.667524,2025-02-25 04:54:35.848893,7.181369
channel-750,682938,30304374,30304378,4,2025-02-25 05:00:16.803635,2025-02-25 05:00:22.304779,5.501144
channel-750,682939,30304657,30304674,17,2025-02-25 05:06:24.430270,2025-02-25 05:06:44.966197,20.535927
channel-750,682940,30304745,30304750,5,2025-02-25 05:08:16.808239,2025-02-25 05:08:22.507496,5.699257
channel-750,682941,30305039,30305047,8,2025-02-25 05:14:40.349432,2025-02-25 05:14:49.889615,9.540183
channel-750,682942,30305064,30305079,15,2025-02-25 05:15:13.793435,2025-02-25 05:15:36.564275,22.77084
channel-750,682943,30305102,30305116,14,2025-02-25 05:16:06.315929,2025-02-25 05:16:23.460013,17.144084
channel-750,682944,30305142,30305159,17,2025-02-25 05:16:59.101303,2025-02-25 05:17:20.324929,21.223626
channel-750,682945,30305153,30305170,17,2025-02-25 05:17:13.323819,2025-02-25 05:17:32.686949,19.36313
channel-750,682946,30305158,30305173,15,2025-02-25 05:17:19.180663,2025-02-25 05:17:35.927098,16.746435
channel-750,682947,30305163,30305168,5,2025-02-25 05:17:24.785837,2025-02-25 05:17:30.313682,5.527845
channel-750,682948,30305176,30305189,13,2025-02-25 05:17:40.696739,2025-02-25 05:17:56.544606,15.847867
channel-750,682949,30305201,30305213,12,2025-02-25 05:18:11.686259,2025-02-25 05:18:27.326462,15.640203
channel-750,682950,30305309,30305319,10,2025-02-25 05:20:35.831108,2025-02-25 05:20:49.040783,13.209675
channel-750,682951,30305347,30305361,14,2025-02-25 05:21:25.965027,2025-02-25 05:21:43.998716,18.033689
channel-750,682952,30305350,30305354,4,2025-02-25 05:21:29.262772,2025-02-25 05:21:34.487893,5.225121
channel-750,682953,30305367,30305377,10,2025-02-25 05:21:50.866995,2025-02-25 05:22:06.837165,15.97017
channel-750,682954,30305379,30305385,6,2025-02-25 05:22:09.131123,2025-02-25 05:22:16.508808,7.377685
channel-750,682955,30305407,30305419,12,2025-02-25 05:22:43.491678,2025-02-25 05:22:59.060793,15.569115
channel-750,682956,30305456,30305461,5,2025-02-25 05:23:44.211541,2025-02-25 05:23:49.955846,5.744305
channel-750,682957,30305465,30305475,10,2025-02-25 05:23:57.226909,2025-02-25 05:24:10.950409,13.7235
channel-750,682958,30305474,30305486,12,2025-02-25 05:24:09.712652,2025-02-25 05:24:27.714388,18.001736
channel-750,682959,30305477,30305482,5,2025-02-25 05:24:13.175930,2025-02-25 05:24:22.449091,9.273161
channel-750,682960,30305478,30305492,14,2025-02-25 05:24:14.283434,2025-02-25 05:24:34.637861,20.354427
channel-750,682961,30305540,30305549,9,2025-02-25 05:25:34.990541,2025-02-25 05:25:45.841429,10.850888
channel-750,682962,30305572,30305581,9,2025-02-25 05:26:17.666927,2025-02-25 05:26:30.233528,12.566601
channel-750,682963,30305596,30305603,7,2025-02-25 05:26:48.313929,2025-02-25 05:26:56.500060,8.186131
channel-750,682964,30305600,30305614,14,2025-02-25 05:26:53.079364,2025-02-25 05:27:10.359966,17.280602
channel-750,682965,30305601,30305612,11,2025-02-25 05:26:54.267008,2025-02-25 05:27:08.111564,13.844556
channel-750,682966,30305603,30305609,6,2025-02-25 05:26:56.500060,2025-02-25 05:27:03.567759,7.067699
channel-750,682967,30305604,30305609,5,2025-02-25 05:26:57.666681,2025-02-25 05:27:03.567759,5.901078
channel-750,682968,30305636,30305654,18,2025-02-25 05:27:37.838482,2025-02-25 05:28:01.328770,23.490288
channel-750,682969,30305720,30305726,6,2025-02-25 05:29:27.189567,2025-02-25 05:29:35.802102,8.612535
channel-750,682970,30305748,30305761,13,2025-02-25 05:30:02.274551,2025-02-25 05:30:18.822497,16.547946
channel-750,682971,30305761,30305764,3,2025-02-25 05:30:18.822497,2025-02-25 05:30:24.876394,6.053897
channel-750,682972,30305834,30305846,12,2025-02-25 05:31:55.685635,2025-02-25 05:32:10.262455,14.57682
channel-750,682973,30305849,30305861,12,2025-02-25 05:32:14.219125,2025-02-25 05:32:29.585262,15.366137
channel-750,682974,30305881,30305894,13,2025-02-25 05:32:54.027661,2025-02-25 05:33:16.567761,22.5401
channel-750,682975,30305976,30305990,14,2025-02-25 05:34:56.777407,2025-02-25 05:35:16.124122,19.346715
channel-750,682976,30306097,30306111,14,2025-02-25 05:37:31.961911,2025-02-25 05:37:53.501402,21.539491
channel-750,682977,30306103,30306117,14,2025-02-25 05:37:40.944246,2025-02-25 05:38:01.825247,20.881001
channel-750,682978,30306136,30306152,16,2025-02-25 05:38:23.416099,2025-02-25 05:38:44.557627,21.141528
channel-750,682979,30306155,30306161,6,2025-02-25 05:38:48.132325,2025-02-25 05:38:56.524917,8.392592
channel-750,682980,30306164,30306168,4,2025-02-25 05:39:00.010128,2025-02-25 05:39:04.496395,4.486267
channel-750,682981,30306413,30306418,5,2025-02-25 05:44:20.494073,2025-02-25 05:44:27.812751,7.318678
channel-750,682982,30306422,30306428,6,2025-02-25 05:44:32.523997,2025-02-25 05:44:39.769270,7.245273
channel-750,682983,30306561,30306579,18,2025-02-25 05:47:33.894251,2025-02-25 05:47:54.890702,20.996451
channel-750,682984,30306654,30306678,24,2025-02-25 05:49:31.663174,2025-02-25 05:50:01.936153,30.272979
channel-750,682985,30306678,30306683,5,2025-02-25 05:50:01.936153,2025-02-25 05:50:09.037048,7.100895
channel-750,682986,30306703,30306728,25,2025-02-25 05:50:34.786677,2025-02-25 05:51:09.517185,34.730508
channel-750,682987,30306725,30306729,4,2025-02-25 05:51:06.010905,2025-02-25 05:51:10.662102,4.651197
channel-750,682988,30306743,30306758,15,2025-02-25 05:51:27.905751,2025-02-25 05:51:50.448671,22.54292
channel-750,682989,30306770,30306789,19,2025-02-25 05:52:06.002176,2025-02-25 05:52:29.823097,23.820921
channel-750,682990,30306782,30306789,7,2025-02-25 05:52:21.296922,2025-02-25 05:52:29.823097,8.526175
channel-750,682991,30306821,30306827,6,2025-02-25 05:53:09.149956,2025-02-25 05:53:16.985257,7.835301
channel-750,682992,30306826,30306834,8,2025-02-25 05:53:15.880316,2025-02-25 05:53:25.388606,9.50829
channel-750,682993,30306827,30306844,17,2025-02-25 05:53:16.985257,2025-02-25 05:53:37.610510,20.625253
channel-750,682994,30306861,30306870,9,2025-02-25 05:54:01.284313,2025-02-25 05:54:14.026188,12.741875
channel-750,682995,30306920,30306935,15,2025-02-25 05:55:15.803784,2025-02-25 05:55:38.522401,22.718617
channel-750,682996,30306923,30306933,10,2025-02-25 05:55:19.283225,2025-02-25 05:55:31.998162,12.714937
channel-750,682997,30306963,30306972,9,2025-02-25 05:56:14.158654,2025-02-25 05:56:26.380872,12.222218
channel-750,682998,30306967,30306980,13,2025-02-25 05:56:20.187545,2025-02-25 05:56:35.784090,15.596545
channel-750,682999,30307040,30307051,11,2025-02-25 05:57:56.808379,2025-02-25 05:58:09.660211,12.851832
channel-750,683000,30307063,30307066,3,2025-02-25 05:58:25.980713,2025-02-25 05:58:33.577887,7.597174
channel-750,683001,30307122,30307139,17,2025-02-25 05:59:44.392957,2025-02-25 06:00:05.340486,20.947529
channel-750,683002,30307135,30307144,9,2025-02-25 06:00:00.012873,2025-02-25 06:00:15.079022,15.066149
channel-750,683003,30307144,30307149,5,2025-02-25 06:00:15.079022,2025-02-25 06:00:23.026995,7.947973
channel-750,683004,30307269,30307278,9,2025-02-25 06:02:57.293326,2025-02-25 06:03:08.541540,11.248214
channel-750,683005,30307288,30307293,5,2025-02-25 06:03:21.597612,2025-02-25 06:03:27.406702,5.80909
channel-750,683006,30307310,30307326,16,2025-02-25 06:03:52.665248,2025-02-25 06:04:11.164457,18.499209
channel-750,683007,30307334,30307344,10,2025-02-25 06:04:22.726552,2025-02-25 06:04:38.005910,15.279358
channel-750,683008,30307343,30307347,4,2025-02-25 06:04:33.699499,2025-02-25 06:04:41.316852,7.617353
channel-750,683009,30307354,30307368,14,2025-02-25 06:04:51.234438,2025-02-25 06:05:08.664969,17.430531
channel-750,683010,30307378,30307383,5,2025-02-25 06:05:22.636723,2025-02-25 06:05:29.434300,6.797577
channel-750,683011,30307428,30307433,5,2025-02-25 06:06:26.702331,2025-02-25 06:06:32.119821,5.41749
channel-750,683012,30307428,30307433,5,2025-02-25 06:06:26.702331,2025-02-25 06:06:32.119821,5.41749
channel-750,683013,30307501,30307506,5,2025-02-25 06:07:59.946748,2025-02-25 06:08:05.807316,5.860568
channel-750,683014,30307560,30307575,15,2025-02-25 06:09:17.574626,2025-02-25 06:09:34.933000,17.358374
channel-750,683015,30307586,30307591,5,2025-02-25 06:09:49.150048,2025-02-25 06:09:55.224141,6.074093
channel-750,683016,30307683,30307699,16,2025-02-25 06:11:51.633100,2025-02-25 06:12:13.720072,22.086972
channel-750,683017,30307706,30307711,5,2025-02-25 06:12:23.801696,2025-02-25 06:12:29.588217,5.786521
channel-750,683018,30307723,30307739,16,2025-02-25 06:12:47.964787,2025-02-25 06:13:10.352216,22.387429
channel-750,683019,30307815,30307828,13,2025-02-25 06:14:50.280599,2025-02-25 06:15:05.521833,15.241234
channel-750,683020,30307851,30307856,5,2025-02-25 06:15:38.038480,2025-02-25 06:15:43.854916,5.816436
channel-750,683021,30307864,30307874,10,2025-02-25 06:15:53.669747,2025-02-25 06:16:06.009533,12.339786
channel-750,683022,30307869,30307891,22,2025-02-25 06:15:59.175836,2025-02-25 06:16:26.448777,27.272941
channel-750,683023,30307894,30307900,6,2025-02-25 06:16:31.329009,2025-02-25 06:16:39.772938,8.443929
channel-750,683024,30307940,30307957,17,2025-02-25 06:17:28.024456,2025-02-25 06:17:51.466630,23.442174
channel-750,683025,30307955,30307959,4,2025-02-25 06:17:48.467607,2025-02-25 06:17:54.753149,6.285542
channel-750,683026,30307970,30307972,2,2025-02-25 06:18:07.179236,2025-02-25 06:18:09.605564,2.426328
channel-750,683027,30308043,30308049,6,2025-02-25 06:19:42.207206,2025-02-25 06:19:48.972571,6.765365
channel-750,683028,30308139,30308149,10,2025-02-25 06:21:44.080078,2025-02-25 06:21:56.614381,12.534303
channel-750,683029,30308168,30308175,7,2025-02-25 06:22:21.008295,2025-02-25 06:22:30.009253,9.000958
channel-750,683030,30308172,30308182,10,2025-02-25 06:22:25.536792,2025-02-25 06:22:41.554957,16.018165
channel-750,683031,30308186,30308199,13,2025-02-25 06:22:47.096531,2025-02-25 06:23:02.799856,15.703325
channel-750,683032,30308203,30308210,7,2025-02-25 06:23:08.078126,2025-02-25 06:23:16.725565,8.647439
channel-750,683033,30308377,30308381,4,2025-02-25 06:26:49.608319,2025-02-25 06:26:55.173984,5.565665
channel-750,683034,30308397,30308411,14,2025-02-25 06:27:18.418611,2025-02-25 06:27:36.311254,17.892643
channel-750,683035,30308463,30308469,6,2025-02-25 06:28:41.814463,2025-02-25 06:28:50.206098,8.391635
channel-750,683036,30308481,30308495,14,2025-02-25 06:29:04.268732,2025-02-25 06:29:21.820948,17.552216
channel-750,683037,30308481,30308492,11,2025-02-25 06:29:04.268732,2025-02-25 06:29:17.435815,13.167083
channel-750,683038,30308577,30308588,11,2025-02-25 06:31:08.964902,2025-02-25 06:31:26.197827,17.232925
channel-750,683039,30308580,30308594,14,2025-02-25 06:31:13.174292,2025-02-25 06:31:36.702261,23.527969
channel-750,683040,30308610,30308625,15,2025-02-25 06:31:57.631580,2025-02-25 06:32:15.697431,18.065851
channel-750,683041,30308621,30308636,15,2025-02-25 06:32:11.025892,2025-02-25 06:32:28.523096,17.497204
channel-750,683042,30308622,30308636,14,2025-02-25 06:32:12.148589,2025-02-25 06:32:28.523096,16.374507
channel-750,683043,30308631,30308646,15,2025-02-25 06:32:22.773850,2025-02-25 06:32:41.162867,18.389017
channel-750,683044,30308652,30308663,11,2025-02-25 06:32:48.664869,2025-02-25 06:33:02.393430,13.728561
channel-750,683045,30308664,30308668,4,2025-02-25 06:33:03.511261,2025-02-25 06:33:09.508941,5.99768
channel-750,683046,30308674,30308688,14,2025-02-25 06:33:17.366526,2025-02-25 06:33:34.256474,16.889948
channel-750,683047,30308699,30308709,10,2025-02-25 06:33:47.000589,2025-02-25 06:34:00.778258,13.777669
channel-750,683048,30308701,30308712,11,2025-02-25 06:33:49.286227,2025-02-25 06:34:05.261405,15.975178
channel-750,683049,30308727,30308750,23,2025-02-25 06:34:24.496457,2025-02-25 06:34:52.195574,27.699117
channel-750,683050,30308731,30308760,29,2025-02-25 06:34:30.313326,2025-02-25 06:35:07.687641,37.374315
channel-750,683051,30308756,30308760,4,2025-02-25 06:35:01.581218,2025-02-25 06:35:07.687641,6.106423
channel-750,683052,30308805,30308821,16,2025-02-25 06:36:04.167493,2025-02-25 06:36:28.508789,24.341296
channel-750,683053,30308808,30308812,4,2025-02-25 06:36:11.025091,2025-02-25 06:36:16.294891,5.2698
channel-750,683054,30308824,30308846,22,2025-02-25 06:36:31.998034,2025-02-25 06:37:01.573822,29.575788
channel-750,683055,30308843,30308858,15,2025-02-25 06:36:57.677496,2025-02-25 06:37:17.032330,19.354834
channel-750,683056,30308857,30308869,12,2025-02-25 06:37:15.964800,2025-02-25 06:37:29.813416,13.848616
channel-750,683057,30308934,30308947,13,2025-02-25 06:38:53.675118,2025-02-25 06:39:11.930120,18.255002
channel-750,683058,30309011,30309021,10,2025-02-25 06:40:33.494587,2025-02-25 06:40:47.824007,14.32942
channel-750,683059,30309012,30309027,15,2025-02-25 06:40:34.635562,2025-02-25 06:40:54.293158,19.657596
channel-750,683060,30309040,30309053,13,2025-02-25 06:41:11.183685,2025-02-25 06:41:27.698283,16.514598
channel-750,683061,30309087,30309104,17,2025-02-25 06:42:10.150594,2025-02-25 06:42:36.330871,26.180277
channel-750,683062,30309097,30309102,5,2025-02-25 06:42:22.801531,2025-02-25 06:42:33.958878,11.157347
channel-750,683063,30309145,30309155,10,2025-02-25 06:43:27.064206,2025-02-25 06:43:39.086657,12.022451
channel-750,683064,30309166,30309177,11,2025-02-25 06:43:51.865139,2025-02-25 06:44:05.741696,13.876557
channel-750,683065,30309178,30309183,5,2025-02-25 06:44:07.345688,2025-02-25 06:44:13.328262,5.982574
channel-750,683066,30309187,30309197,10,2025-02-25 06:44:18.967685,2025-02-25 06:44:32.977996,14.010311
channel-750,683067,30309196,30309212,16,2025-02-25 06:44:31.878882,2025-02-25 06:44:52.556960,20.678078
channel-750,683068,30309196,30309210,14,2025-02-25 06:44:31.878882,2025-02-25 06:44:49.727937,17.849055
channel-750,683069,30309210,30309231,21,2025-02-25 06:44:49.727937,2025-02-25 06:45:17.416460,27.688523
channel-750,683070,30309227,30309235,8,2025-02-25 06:45:12.745657,2025-02-25 06:45:23.328413,10.582756
channel-750,683071,30309249,30309260,11,2025-02-25 06:45:44.650930,2025-02-25 06:45:57.788940,13.13801
channel-750,683072,30309272,30309284,12,2025-02-25 06:46:12.722306,2025-02-25 06:46:28.329999,15.607693
channel-750,683073,30309325,30309337,12,2025-02-25 06:47:19.784823,2025-02-25 06:47:37.142973,17.35815
channel-750,683074,30309330,30309341,11,2025-02-25 06:47:26.349089,2025-02-25 06:47:42.044383,15.695294
channel-750,683075,30309366,30309371,5,2025-02-25 06:48:13.875161,2025-02-25 06:48:19.589581,5.71442
channel-750,683076,30309372,30309378,6,2025-02-25 06:48:20.752392,2025-02-25 06:48:28.057946,7.305554
channel-750,683077,30309381,30309392,11,2025-02-25 06:48:31.327042,2025-02-25 06:48:48.180705,16.853663
channel-750,683078,30309383,30309392,9,2025-02-25 06:48:37.016650,2025-02-25 06:48:48.180705,11.164055
channel-750,683079,30309387,30309402,15,2025-02-25 06:48:41.555767,2025-02-25 06:48:59.742580,18.186813
channel-750,683080,30309397,30309406,9,2025-02-25 06:48:53.952937,2025-02-25 06:49:05.338301,11.385364
channel-750,683081,30309411,30309422,11,2025-02-25 06:49:11.367276,2025-02-25 06:49:24.094763,12.727487
channel-750,683082,30309416,30309427,11,2025-02-25 06:49:17.371870,2025-02-25 06:49:34.241230,16.86936
channel-750,683083,30309431,30309449,18,2025-02-25 06:49:39.963755,2025-02-25 06:50:00.816681,20.852926
channel-750,683084,30309435,30309446,11,2025-02-25 06:49:44.504129,2025-02-25 06:49:57.325333,12.821204
channel-750,683085,30309440,30309449,9,2025-02-25 06:49:50.011471,2025-02-25 06:50:00.816681,10.80521
channel-750,683086,30309476,30309488,12,2025-02-25 06:50:39.040864,2025-02-25 06:50:53.927926,14.887062
channel-750,683087,30309492,30309505,13,2025-02-25 06:50:59.173962,2025-02-25 06:51:15.171282,15.99732
channel-750,683088,30309508,30309524,16,2025-02-25 06:51:19.087474,2025-02-25 06:51:38.591958,19.504484
channel-750,683089,30309531,30309548,17,2025-02-25 06:51:47.566873,2025-02-25 06:52:10.399206,22.832333
channel-750,683090,30309539,30309554,15,2025-02-25 06:51:59.359196,2025-02-25 06:52:17.219003,17.859807
channel-750,683091,30309548,30309553,5,2025-02-25 06:52:10.399206,2025-02-25 06:52:16.111535,5.712329
channel-750,683092,30309560,30309572,12,2025-02-25 06:52:24.029150,2025-02-25 06:52:38.701906,14.672756
channel-750,683093,30309572,30309581,9,2025-02-25 06:52:38.701906,2025-02-25 06:52:53.206219,14.504313
channel-750,683094,30309584,30309595,11,2025-02-25 06:52:56.833918,2025-02-25 06:53:10.586194,13.752276
channel-750,683095,30309595,30309600,5,2025-02-25 06:53:10.586194,2025-02-25 06:53:16.221179,5.634985
channel-750,683096,30309601,30309616,15,2025-02-25 06:53:17.409762,2025-02-25 06:53:36.283152,18.87339
channel-750,683097,30309611,30309624,13,2025-02-25 06:53:29.342698,2025-02-25 06:53:46.452167,17.109469
channel-750,683098,30309614,30309627,13,2025-02-25 06:53:33.707111,2025-02-25 06:53:51.529896,17.822785
channel-750,683099,30309622,30309633,11,2025-02-25 06:53:43.109943,2025-02-25 06:53:58.157882,15.047939
channel-750,683100,30309627,30309639,12,2025-02-25 06:53:51.529896,2025-02-25 06:54:08.091822,16.561926
channel-750,683101,30309633,30309639,6,2025-02-25 06:53:58.157882,2025-02-25 06:54:08.091822,9.93394
channel-750,683102,30309638,30309652,14,2025-02-25 06:54:06.771099,2025-02-25 06:54:26.573403,19.802304
channel-750,683103,30309643,30309655,12,2025-02-25 06:54:15.224660,2025-02-25 06:54:31.218608,15.993948
channel-750,683104,30309644,30309657,13,2025-02-25 06:54:17.317474,2025-02-25 06:54:33.694251,16.376777
channel-750,683105,30309650,30309663,13,2025-02-25 06:54:24.174270,2025-02-25 06:54:40.494625,16.320355
channel-750,683106,30309660,30309677,17,2025-02-25 06:54:37.159883,2025-02-25 06:54:59.662366,22.502483
channel-750,683107,30309681,30309695,14,2025-02-25 06:55:04.064523,2025-02-25 06:55:20.410826,16.346303
channel-750,683108,30309694,30309699,5,2025-02-25 06:55:19.295649,2025-02-25 06:55:24.925850,5.630201
channel-750,683109,30309712,30309716,4,2025-02-25 06:55:41.403643,2025-02-25 06:55:47.557917,6.154274
channel-750,683110,30309721,30309735,14,2025-02-25 06:55:54.308568,2025-02-25 06:56:10.056141,15.747573
channel-750,683111,30309725,30309730,5,2025-02-25 06:55:58.674548,2025-02-25 06:56:04.362479,5.687931
channel-750,683112,30309742,30309751,9,2025-02-25 06:56:20.278325,2025-02-25 06:56:31.754670,11.476345
channel-750,683113,30309758,30309766,8,2025-02-25 06:56:39.822638,2025-02-25 06:56:49.312892,9.490254
channel-750,683114,30309784,30309796,12,2025-02-25 06:57:14.361820,2025-02-25 06:57:29.494261,15.132441
channel-750,683115,30309809,30309822,13,2025-02-25 06:57:46.802437,2025-02-25 06:58:03.409871,16.607434
channel-750,683116,30309861,30309868,7,2025-02-25 06:58:53.788800,2025-02-25 06:59:04.186025,10.397225
channel-750,683117,30309878,30309884,6,2025-02-25 06:59:17.967469,2025-02-25 06:59:24.593712,6.626243
channel-750,683118,30309894,30309913,19,2025-02-25 06:59:37.706972,2025-02-25 07:00:01.751797,24.044825
channel-750,683119,30309912,30309922,10,2025-02-25 07:00:00.558928,2025-02-25 07:00:13.476710,12.917782
channel-750,683120,30309918,30309927,9,2025-02-25 07:00:08.746119,2025-02-25 07:00:20.436848,11.690729
channel-750,683121,30309922,30309936,14,2025-02-25 07:00:13.476710,2025-02-25 07:00:32.458906,18.982196
channel-750,683122,30309922,30309936,14,2025-02-25 07:00:13.476710,2025-02-25 07:00:32.458906,18.982196
channel-750,683123,30309925,30309929,4,2025-02-25 07:00:16.896869,2025-02-25 07:00:23.700670,6.803801
channel-750,683124,30309927,30309939,12,2025-02-25 07:00:20.436848,2025-02-25 07:00:36.177891,15.741043
channel-750,683125,30309985,30309996,11,2025-02-25 07:01:36.565469,2025-02-25 07:01:50.400349,13.83488
channel-750,683126,30309989,30309999,10,2025-02-25 07:01:41.347268,2025-02-25 07:01:53.928788,12.58152
channel-750,683127,30309995,30310000,5,2025-02-25 07:01:49.269108,2025-02-25 07:01:55.095272,5.826164
channel-750,683128,30309999,30310012,13,2025-02-25 07:01:53.928788,2025-02-25 07:02:11.206964,17.278176
channel-750,683129,30310041,30310057,16,2025-02-25 07:02:46.790434,2025-02-25 07:03:08.423772,21.633338
channel-750,683130,30310048,30310055,7,2025-02-25 07:02:58.239057,2025-02-25 07:03:06.195023,7.955966
channel-750,683131,30310066,30310077,11,2025-02-25 07:03:24.386372,2025-02-25 07:03:38.538154,14.151782
channel-750,683132,30310098,30310108,10,2025-02-25 07:04:04.487317,2025-02-25 07:04:17.685264,13.197947
channel-750,683133,30310117,30310129,12,2025-02-25 07:04:29.012958,2025-02-25 07:04:44.567027,15.554069
channel-750,683134,30310121,30310128,7,2025-02-25 07:04:34.819810,2025-02-25 07:04:43.458384,8.638574
channel-750,683135,30310122,30310132,10,2025-02-25 07:04:36.442496,2025-02-25 07:04:49.308726,12.86623
channel-750,683136,30310131,30310137,6,2025-02-25 07:04:47.068695,2025-02-25 07:04:55.700857,8.632162
channel-750,683137,30310198,30310211,13,2025-02-25 07:06:12.039828,2025-02-25 07:06:30.450220,18.410392
channel-750,683138,30310206,30310215,9,2025-02-25 07:06:24.231836,2025-02-25 07:06:36.048539,11.816703
channel-750,683139,30310212,30310226,14,2025-02-25 07:06:31.573167,2025-02-25 07:06:48.791123,17.217956
channel-750,683140,30310218,30310228,10,2025-02-25 07:06:39.541389,2025-02-25 07:06:52.508082,12.966693
channel-750,683141,30310228,30310232,4,2025-02-25 07:06:52.508082,2025-02-25 07:07:00.230802,7.72272
channel-750,683142,30310238,30310245,7,2025-02-25 07:07:08.341674,2025-02-25 07:07:17.813378,9.471704
channel-750,683143,30310240,30310249,9,2025-02-25 07:07:11.550930,2025-02-25 07:07:22.675950,11.12502
channel-750,683144,30310279,30310295,16,2025-02-25 07:08:04.988576,2025-02-25 07:08:25.034944,20.046368
channel-750,683145,30310305,30310321,16,2025-02-25 07:08:39.426523,2025-02-25 07:09:00.616318,21.189795
channel-750,683146,30310310,30310317,7,2025-02-25 07:08:45.159873,2025-02-25 07:08:55.090292,9.930419
channel-750,683147,30310370,30310382,12,2025-02-25 07:10:01.568870,2025-02-25 07:10:15.912241,14.343371
channel-750,683148,30310374,30310378,4,2025-02-25 07:10:06.329902,2025-02-25 07:10:11.353478,5.023576
channel-750,683149,30310379,30310391,12,2025-02-25 07:10:12.521092,2025-02-25 07:10:26.317125,13.796033
channel-750,683150,30310409,30310424,15,2025-02-25 07:10:54.433503,2025-02-25 07:11:13.277419,18.843916
channel-750,683151,30310415,30310420,5,2025-02-25 07:11:02.796399,2025-02-25 07:11:08.347255,5.550856
channel-750,683152,30310424,30310438,14,2025-02-25 07:11:13.277419,2025-02-25 07:11:33.076569,19.79915
channel-750,683153,30310450,30310460,10,2025-02-25 07:11:48.157478,2025-02-25 07:12:00.863572,12.706094
channel-750,683154,30310484,30310494,10,2025-02-25 07:12:32.116149,2025-02-25 07:12:47.078145,14.961996
channel-750,683155,30310533,30310542,9,2025-02-25 07:13:34.912236,2025-02-25 07:13:47.318557,12.406321
channel-750,683156,30310560,30310572,12,2025-02-25 07:14:09.032277,2025-02-25 07:14:23.707265,14.674988
channel-750,683157,30310562,30310571,9,2025-02-25 07:14:11.909868,2025-02-25 07:14:22.492251,10.582383
channel-750,683158,30310579,30310584,5,2025-02-25 07:14:34.507442,2025-02-25 07:14:41.136520,6.629078
channel-750,683159,30310590,30310601,11,2025-02-25 07:14:49.332582,2025-02-25 07:15:03.971769,14.639187
channel-750,683160,30310617,30310630,13,2025-02-25 07:15:23.575896,2025-02-25 07:15:39.522649,15.946753
channel-750,683161,30310618,30310632,14,2025-02-25 07:15:24.703932,2025-02-25 07:15:41.711233,17.007301
channel-750,683162,30310656,30310669,13,2025-02-25 07:16:13.276595,2025-02-25 07:16:30.279549,17.002954
channel-750,683163,30310678,30310697,19,2025-02-25 07:16:45.008782,2025-02-25 07:17:10.208660,25.199878
channel-750,683164,30310689,30310701,12,2025-02-25 07:17:00.496122,2025-02-25 07:17:14.542663,14.046541
channel-750,683165,30310697,30310708,11,2025-02-25 07:17:10.208660,2025-02-25 07:17:23.653246,13.444586
channel-750,683166,30310718,30310735,17,2025-02-25 07:17:36.060557,2025-02-25 07:17:57.987064,21.926507
channel-750,683167,30310728,30310737,9,2025-02-25 07:17:47.751703,2025-02-25 07:18:01.533612,13.781909
channel-750,683168,30310752,30310756,4,2025-02-25 07:18:21.985252,2025-02-25 07:18:26.727152,4.7419
channel-750,683169,30310764,30310780,16,2025-02-25 07:18:37.759537,2025-02-25 07:18:58.625545,20.866008
channel-750,683170,30310775,30310779,4,2025-02-25 07:18:52.704794,2025-02-25 07:18:57.497755,4.792961
channel-750,683171,30310781,30310791,10,2025-02-25 07:18:59.734013,2025-02-25 07:19:12.404975,12.670962
channel-750,683172,30310812,30310824,12,2025-02-25 07:19:38.171819,2025-02-25 07:19:52.064163,13.892344
channel-750,683173,30310817,30310825,8,2025-02-25 07:19:44.087021,2025-02-25 07:19:54.216613,10.129592
channel-750,683174,30310873,30310882,9,2025-02-25 07:20:54.939355,2025-02-25 07:21:10.327007,15.387652
channel-750,683175,30310894,30310898,4,2025-02-25 07:21:26.910918,2025-02-25 07:21:31.433278,4.52236
channel-750,683176,30310924,30310933,9,2025-02-25 07:22:01.319945,2025-02-25 07:22:18.421804,17.101859
channel-750,683177,30310936,30310944,8,2025-02-25 07:22:22.692980,2025-02-25 07:22:33.364649,10.671669
channel-750,683178,30310985,30311007,22,2025-02-25 07:23:24.392351,2025-02-25 07:23:54.598820,30.206469
channel-750,683179,30310988,30310997,9,2025-02-25 07:23:27.643798,2025-02-25 07:23:41.465180,13.821382
channel-750,683180,30311005,30311020,15,2025-02-25 07:23:50.827239,2025-02-25 07:24:09.518411,18.691172
channel-750,683181,30311015,30311024,9,2025-02-25 07:24:03.887723,2025-02-25 07:24:14.951010,11.063287
channel-750,683182,30311020,30311024,4,2025-02-25 07:24:09.518411,2025-02-25 07:24:14.951010,5.432599
channel-750,683183,30311044,30311055,11,2025-02-25 07:24:40.083469,2025-02-25 07:24:52.771403,12.687934
channel-750,683184,30311045,30311052,7,2025-02-25 07:24:41.572157,2025-02-25 07:24:49.462156,7.889999
channel-750,683185,30311054,30311064,10,2025-02-25 07:24:51.751545,2025-02-25 07:25:08.531303,16.779758
channel-750,683186,30311069,30311081,12,2025-02-25 07:25:14.428331,2025-02-25 07:25:31.725129,17.296798
channel-750,683187,30311084,30311115,31,2025-02-25 07:25:39.437997,2025-02-25 07:26:21.005946,41.567949
channel-750,683188,30311091,30311096,5,2025-02-25 07:25:49.699421,2025-02-25 07:25:56.291971,6.59255
channel-750,683189,30311096,30311118,22,2025-02-25 07:25:56.291971,2025-02-25 07:26:24.493651,28.20168
channel-750,683190,30311096,30311118,22,2025-02-25 07:25:56.291971,2025-02-25 07:26:24.493651,28.20168
channel-750,683191,30311100,30311106,6,2025-02-25 07:26:02.726040,2025-02-25 07:26:10.090513,7.364473
channel-750,683192,30311104,30311126,22,2025-02-25 07:26:07.480711,2025-02-25 07:26:35.624668,28.143957
channel-750,683193,30311121,30311130,9,2025-02-25 07:26:27.939740,2025-02-25 07:26:40.875718,12.935978
channel-750,683194,30311159,30311165,6,2025-02-25 07:27:17.116997,2025-02-25 07:27:23.999257,6.88226
channel-750,683195,30311164,30311171,7,2025-02-25 07:27:22.869659,2025-02-25 07:27:32.083210,9.213551
channel-750,683196,30311176,30311190,14,2025-02-25 07:27:37.690342,2025-02-25 07:27:55.394190,17.703848
channel-750,683197,30311191,30311205,14,2025-02-25 07:27:57.119798,2025-02-25 07:28:15.294597,18.174799
channel-750,683198,30311191,30311201,10,2025-02-25 07:27:57.119798,2025-02-25 07:28:09.526378,12.40658
channel-750,683199,30311191,30311210,19,2025-02-25 07:27:57.119798,2025-02-25 07:28:22.842343,25.722545
channel-750,683200,30311201,30311215,14,2025-02-25 07:28:09.526378,2025-02-25 07:28:29.313399,19.787021
channel-750,683201,30311210,30311217,7,2025-02-25 07:28:22.842343,2025-02-25 07:28:33.070984,10.228641
channel-750,683202,30311220,30311225,5,2025-02-25 07:28:38.898430,2025-02-25 07:28:45.221028,6.322598
channel-750,683203,30311237,30311247,10,2025-02-25 07:28:59.991893,2025-02-25 07:29:11.746890,11.754997
channel-750,683204,30311238,30311247,9,2025-02-25 07:29:01.102562,2025-02-25 07:29:11.746890,10.644328
channel-750,683205,30311246,30311253,7,2025-02-25 07:29:10.453388,2025-02-25 07:29:19.525528,9.07214
channel-750,683206,30311254,30311365,111,2025-02-25 07:29:21.287634,2025-02-25 07:31:46.461892,145.174258
channel-750,683207,30311269,30311288,19,2025-02-25 07:29:40.790162,2025-02-25 07:30:04.204222,23.41406
channel-750,683208,30311283,30311288,5,2025-02-25 07:29:58.263146,2025-02-25 07:30:04.204222,5.941076
channel-750,683209,30311290,30311295,5,2025-02-25 07:30:07.038161,2025-02-25 07:30:16.192274,9.154113
channel-750,683210,30311291,30311295,4,2025-02-25 07:30:08.107290,2025-02-25 07:30:16.192274,8.084984
channel-750,683211,30311294,30311305,11,2025-02-25 07:30:11.726209,2025-02-25 07:30:28.600225,16.874016
channel-750,683212,30311308,30311321,13,2025-02-25 07:30:32.122560,2025-02-25 07:30:48.342531,16.219971
channel-750,683213,30311310,30311315,5,2025-02-25 07:30:34.401287,2025-02-25 07:30:40.097013,5.695726
channel-750,683214,30311318,30311323,5,2025-02-25 07:30:44.935344,2025-02-25 07:30:50.836904,5.90156
channel-750,683215,30311322,30311332,10,2025-02-25 07:30:49.635428,2025-02-25 07:31:01.656044,12.020616
channel-750,683216,30311360,30311366,6,2025-02-25 07:31:38.538135,2025-02-25 07:31:48.856409,10.318274
channel-750,683217,30311374,30311385,11,2025-02-25 07:31:58.438816,2025-02-25 07:32:12.533833,14.095017
channel-750,683218,30311389,30311399,10,2025-02-25 07:32:17.828157,2025-02-25 07:32:30.158023,12.329866
channel-750,683219,30311408,30311414,6,2025-02-25 07:32:42.116337,2025-02-25 07:32:49.899197,7.78286
channel-750,683220,30311424,30311444,20,2025-02-25 07:33:02.227062,2025-02-25 07:33:26.117296,23.890234
channel-750,683221,30311425,30311444,19,2025-02-25 07:33:03.284729,2025-02-25 07:33:26.117296,22.832567
channel-750,683222,30311463,30311467,4,2025-02-25 07:33:53.390453,2025-02-25 07:33:59.178065,5.787612
channel-750,683223,30311486,30311519,33,2025-02-25 07:34:20.473493,2025-02-25 07:35:07.381321,46.907828
channel-750,683224,30311498,30311503,5,2025-02-25 07:34:36.392353,2025-02-25 07:34:45.416290,9.023937
channel-750,683225,30311506,30311519,13,2025-02-25 07:34:48.961180,2025-02-25 07:35:07.381321,18.420141
channel-750,683226,30311513,30311527,14,2025-02-25 07:34:59.156329,2025-02-25 07:35:19.245646,20.089317
channel-750,683227,30311515,30311519,4,2025-02-25 07:35:01.677055,2025-02-25 07:35:07.381321,5.704266
channel-750,683228,30311529,30311534,5,2025-02-25 07:35:21.510612,2025-02-25 07:35:28.819628,7.309016
channel-750,683229,30311539,30311549,10,2025-02-25 07:35:34.446451,2025-02-25 07:35:45.444248,10.997797
channel-750,683230,30311552,30311561,9,2025-02-25 07:35:49.067336,2025-02-25 07:36:02.802119,13.734783
channel-750,683231,30311577,30311585,8,2025-02-25 07:36:22.083183,2025-02-25 07:36:33.304858,11.221675
channel-750,683232,30311616,30311621,5,2025-02-25 07:37:13.967811,2025-02-25 07:37:20.287198,6.319387
channel-750,683233,30311621,30311632,11,2025-02-25 07:37:20.287198,2025-02-25 07:37:34.305122,14.017924
channel-750,683234,30311678,30311683,5,2025-02-25 07:38:33.809764,2025-02-25 07:38:40.562456,6.752692
channel-750,683235,30311684,30311728,44,2025-02-25 07:38:41.778015,2025-02-25 07:39:42.515947,60.737932
channel-750,683236,30311715,30311720,5,2025-02-25 07:39:22.292482,2025-02-25 07:39:32.120890,9.828408
channel-750,683237,30311738,30311756,18,2025-02-25 07:39:55.183309,2025-02-25 07:40:20.680408,25.497099
channel-750,683238,30311753,30311769,16,2025-02-25 07:40:17.313574,2025-02-25 07:40:37.122393,19.808819
channel-750,683239,30311766,30311771,5,2025-02-25 07:40:32.530295,2025-02-25 07:40:39.413690,6.883395
channel-750,683240,30311767,30311779,12,2025-02-25 07:40:33.827242,2025-02-25 07:40:48.528039,14.700797
channel-750,683241,30311792,30311797,5,2025-02-25 07:41:09.052319,2025-02-25 07:41:14.822909,5.77059
channel-750,683242,30311812,30311822,10,2025-02-25 07:41:33.608864,2025-02-25 07:41:45.848312,12.239448
channel-750,683243,30311819,30311834,15,2025-02-25 07:41:42.302912,2025-02-25 07:42:03.353264,21.050352
channel-750,683244,30311820,30311824,4,2025-02-25 07:41:43.494558,2025-02-25 07:41:48.541689,5.047131
channel-750,683245,30311826,30311834,8,2025-02-25 07:41:51.780083,2025-02-25 07:42:03.353264,11.573181
channel-750,683246,30311833,30311838,5,2025-02-25 07:42:02.233267,2025-02-25 07:42:08.973298,6.740031
channel-750,683247,30311833,30311838,5,2025-02-25 07:42:02.233267,2025-02-25 07:42:08.973298,6.740031
channel-750,683248,30311849,30311863,14,2025-02-25 07:42:24.389813,2025-02-25 07:42:40.290221,15.900408
channel-750,683249,30311862,30311872,10,2025-02-25 07:42:38.959392,2025-02-25 07:42:50.825778,11.866386
channel-750,683250,30311872,30311877,5,2025-02-25 07:42:50.825778,2025-02-25 07:42:57.948258,7.12248
channel-750,683251,30311883,30311896,13,2025-02-25 07:43:06.143064,2025-02-25 07:43:24.795837,18.652773
channel-750,683252,30311894,30311909,15,2025-02-25 07:43:20.041078,2025-02-25 07:43:40.837484,20.796406
channel-750,683253,30311913,30311925,12,2025-02-25 07:43:45.129763,2025-02-25 07:44:02.579640,17.449877
channel-750,683254,30311923,30311928,5,2025-02-25 07:43:57.046168,2025-02-25 07:44:05.931666,8.885498
channel-750,683255,30311937,30311944,7,2025-02-25 07:44:16.387632,2025-02-25 07:44:30.465837,14.078205
channel-750,683256,30311955,30311966,11,2025-02-25 07:44:43.394593,2025-02-25 07:44:58.442456,15.047863
channel-750,683257,30311969,30311974,5,2025-02-25 07:45:01.765272,2025-02-25 07:45:07.445727,5.680455
channel-750,683258,30312021,30312035,14,2025-02-25 07:46:06.435019,2025-02-25 07:46:24.890436,18.455417
channel-750,683259,30312026,30312035,9,2025-02-25 07:46:13.345646,2025-02-25 07:46:24.890436,11.54479
channel-750,683260,30312036,30312042,6,2025-02-25 07:46:26.009158,2025-02-25 07:46:32.776456,6.767298
channel-750,683261,30312068,30312073,5,2025-02-25 07:47:11.037787,2025-02-25 07:47:17.001889,5.964102
channel-750,683262,30312069,30312074,5,2025-02-25 07:47:12.244974,2025-02-25 07:47:18.113644,5.86867
channel-750,683263,30312070,30312083,13,2025-02-25 07:47:13.334730,2025-02-25 07:47:29.811171,16.476441
channel-750,683264,30312096,30312112,16,2025-02-25 07:47:46.417846,2025-02-25 07:48:05.842820,19.424974
channel-750,683265,30312150,30312155,5,2025-02-25 07:48:59.913668,2025-02-25 07:49:05.691403,5.777735
channel-750,683266,30312189,30312206,17,2025-02-25 07:49:50.685727,2025-02-25 07:50:12.387666,21.701939
channel-750,683267,30312190,30312200,10,2025-02-25 07:49:52.025154,2025-02-25 07:50:03.992354,11.9672
channel-750,683268,30312190,30312213,23,2025-02-25 07:49:52.025154,2025-02-25 07:50:21.910311,29.885157
channel-750,683269,30312218,30312229,11,2025-02-25 07:50:27.828219,2025-02-25 07:50:45.498020,17.669801
channel-750,683270,30312226,30312234,8,2025-02-25 07:50:38.025043,2025-02-25 07:50:51.191764,13.166721
channel-750,683271,30312228,30313074,846,2025-02-25 07:50:40.145097,2025-02-25 08:09:08.975610,1108.830513
channel-750,683272,30312290,30312310,20,2025-02-25 07:52:02.520326,2025-02-25 07:52:28.090481,25.570155
channel-750,683273,30312317,30312331,14,2025-02-25 07:52:40.740329,2025-02-25 07:52:57.957552,17.217223
channel-750,683274,30312322,30312332,10,2025-02-25 07:52:46.442520,2025-02-25 07:53:00.363394,13.920874
channel-750,683275,30312322,30312332,10,2025-02-25 07:52:46.442520,2025-02-25 07:53:00.363394,13.920874
channel-750,683276,30312328,30312344,16,2025-02-25 07:52:53.622607,2025-02-25 07:53:19.165343,25.542736
channel-750,683277,30312332,30312336,4,2025-02-25 07:53:00.363394,2025-02-25 07:53:05.862229,5.498835
channel-750,683278,30312341,30312357,16,2025-02-25 07:53:14.995483,2025-02-25 07:53:34.093307,19.097824
channel-750,683279,30312341,30312355,14,2025-02-25 07:53:14.995483,2025-02-25 07:53:31.898664,16.903181
channel-750,683280,30312358,30312363,5,2025-02-25 07:53:35.204701,2025-02-25 07:53:42.068600,6.863899
channel-750,683281,30312385,30312396,11,2025-02-25 07:54:10.266097,2025-02-25 07:54:26.413136,16.147039
channel-750,683282,30312404,30312414,10,2025-02-25 07:54:35.461670,2025-02-25 07:54:47.737303,12.275633
channel-750,683283,30312405,30312413,8,2025-02-25 07:54:36.679395,2025-02-25 07:54:46.674118,9.994723
channel-750,683284,30312418,30312430,12,2025-02-25 07:54:53.241086,2025-02-25 07:55:08.425831,15.184745
channel-750,683285,30312422,30312436,14,2025-02-25 07:54:57.959600,2025-02-25 07:55:16.459878,18.500278
channel-750,683286,30312422,30312433,11,2025-02-25 07:54:57.959600,2025-02-25 07:55:12.922405,14.962805
channel-750,683287,30312458,30312468,10,2025-02-25 07:55:43.518209,2025-02-25 07:55:55.564184,12.045975
channel-750,683288,30312476,30312485,9,2025-02-25 07:56:05.216700,2025-02-25 07:56:22.154775,16.938075
channel-750,683289,30312559,30312573,14,2025-02-25 07:57:54.778101,2025-02-25 07:58:14.850054,20.071953
channel-750,683290,30312582,30312593,11,2025-02-25 07:58:26.943807,2025-02-25 07:58:41.956732,15.012925
channel-750,683291,30312589,30312594,5,2025-02-25 07:58:36.305436,2025-02-25 07:58:43.030629,6.725193
channel-750,683292,30312600,30312605,5,2025-02-25 07:58:51.267220,2025-02-25 07:58:56.918958,5.651738
channel-750,683293,30312629,30312647,18,2025-02-25 07:59:26.196332,2025-02-25 07:59:48.996536,22.800204
channel-750,683294,30312638,30312642,4,2025-02-25 07:59:36.644105,2025-02-25 07:59:42.365028,5.720923
channel-750,683295,30312667,30312672,5,2025-02-25 08:00:14.836802,2025-02-25 08:00:22.353854,7.517052
channel-750,683296,30312712,30312720,8,2025-02-25 08:01:11.575380,2025-02-25 08:01:22.673085,11.097705
channel-750,683297,30312715,30312718,3,2025-02-25 08:01:14.888497,2025-02-25 08:01:18.835998,3.947501
channel-750,683298,30312744,30312767,23,2025-02-25 08:01:57.340611,2025-02-25 08:02:31.413253,34.072642
channel-750,683299,30312751,30312756,5,2025-02-25 08:02:09.608459,2025-02-25 08:02:16.358463,6.750004
channel-750,683300,30312786,30312792,6,2025-02-25 08:02:54.948921,2025-02-25 08:03:02.008169,7.059248
channel-750,683301,30312815,30312825,10,2025-02-25 08:03:31.577662,2025-02-25 08:03:45.305410,13.727748
channel-750,683302,30312829,30312834,5,2025-02-25 08:03:49.846536,2025-02-25 08:03:59.811888,9.965352
channel-750,683303,30312835,30312865,30,2025-02-25 08:04:01.901798,2025-02-25 08:04:40.282479,38.380681
channel-750,683304,30312845,30312862,17,2025-02-25 08:04:13.857997,2025-02-25 08:04:37.030490,23.172493
channel-750,683305,30312848,30312863,15,2025-02-25 08:04:17.398902,2025-02-25 08:04:38.125851,20.726949
channel-750,683306,30312850,30312863,13,2025-02-25 08:04:19.730152,2025-02-25 08:04:38.125851,18.395699
channel-750,683307,30312853,30312863,10,2025-02-25 08:04:24.352952,2025-02-25 08:04:38.125851,13.772899
channel-750,683308,30312870,30312883,13,2025-02-25 08:04:46.770507,2025-02-25 08:05:03.305494,16.534987
channel-750,683309,30312893,30312908,15,2025-02-25 08:05:15.069204,2025-02-25 08:05:34.561229,19.492025
channel-750,683310,30312896,30312909,13,2025-02-25 08:05:19.334907,2025-02-25 08:05:35.678731,16.343824
channel-750,683311,30312908,30312919,11,2025-02-25 08:05:34.561229,2025-02-25 08:05:51.809024,17.247795
channel-750,683312,30312925,30312936,11,2025-02-25 08:05:58.692578,2025-02-25 08:06:11.312671,12.620093
channel-750,683313,30312950,30312958,8,2025-02-25 08:06:28.103841,2025-02-25 08:06:41.979540,13.875699
channel-750,683314,30312989,30313000,11,2025-02-25 08:07:20.559917,2025-02-25 08:07:33.715675,13.155758
channel-750,683315,30313060,30313078,18,2025-02-25 08:08:51.557938,2025-02-25 08:09:14.482538,22.9246
channel-750,683316,30313070,30313084,14,2025-02-25 08:09:04.434707,2025-02-25 08:09:21.114109,16.679402
channel-750,683317,30313100,30313111,11,2025-02-25 08:09:44.526487,2025-02-25 08:10:00.378575,15.852088
channel-750,683318,30313120,30313130,10,2025-02-25 08:10:11.713841,2025-02-25 08:10:23.200651,11.48681
channel-750,683319,30313120,30313135,15,2025-02-25 08:10:11.713841,2025-02-25 08:10:29.954943,18.241102
channel-750,683320,30313164,30313174,10,2025-02-25 08:11:07.351083,2025-02-25 08:11:19.391081,12.039998
channel-750,683321,30313258,30313270,12,2025-02-25 08:13:14.421706,2025-02-25 08:13:31.137816,16.71611
channel-750,683322,30313266,30313272,6,2025-02-25 08:13:26.200227,2025-02-25 08:13:33.338924,7.138697
channel-750,683323,30313279,30313293,14,2025-02-25 08:13:42.353896,2025-02-25 08:13:58.213952,15.860056
channel-750,683324,30313296,30313301,5,2025-02-25 08:14:02.670350,2025-02-25 08:14:10.344887,7.674537
channel-750,683325,30313304,30313311,7,2025-02-25 08:14:13.846101,2025-02-25 08:14:21.934101,8.088
channel-750,683326,30313324,30313341,17,2025-02-25 08:14:37.170212,2025-02-25 08:14:58.658629,21.488417
channel-750,683327,30313341,30313345,4,2025-02-25 08:14:58.658629,2025-02-25 08:15:05.546328,6.887699
channel-750,683328,30313383,30313395,12,2025-02-25 08:15:57.169290,2025-02-25 08:16:12.593155,15.423865
channel-750,683329,30313400,30313405,5,2025-02-25 08:16:20.128042,2025-02-25 08:16:27.401892,7.27385
channel-750,683330,30313425,30313437,12,2025-02-25 08:16:50.611714,2025-02-25 08:17:05.118574,14.50686
channel-750,683331,30313526,30313537,11,2025-02-25 08:19:02.490943,2025-02-25 08:19:17.003005,14.512062
channel-750,683332,30313537,30313541,4,2025-02-25 08:19:17.003005,2025-02-25 08:19:22.745656,5.742651
channel-750,683333,30313539,30313558,19,2025-02-25 08:19:19.315421,2025-02-25 08:19:41.971011,22.65559
channel-750,683334,30313543,30313553,10,2025-02-25 08:19:25.109106,2025-02-25 08:19:36.265821,11.156715
channel-750,683335,30313547,30313575,28,2025-02-25 08:19:29.584906,2025-02-25 08:20:02.948009,33.363103
channel-750,683336,30313568,30313584,16,2025-02-25 08:19:55.009936,2025-02-25 08:20:17.596677,22.586741
channel-750,683337,30313590,30313595,5,2025-02-25 08:20:26.111929,2025-02-25 08:20:31.832436,5.720507
channel-750,683338,30313599,30313604,5,2025-02-25 08:20:37.082211,2025-02-25 08:20:44.847608,7.765397
channel-750,683339,30313608,30313632,24,2025-02-25 08:20:49.510935,2025-02-25 08:21:20.533375,31.02244
channel-750,683340,30313613,30313632,19,2025-02-25 08:20:56.744728,2025-02-25 08:21:20.533375,23.788647
channel-750,683341,30313642,30313653,11,2025-02-25 08:21:34.140606,2025-02-25 08:21:47.912764,13.772158
channel-750,683342,30313647,30313668,21,2025-02-25 08:21:40.925017,2025-02-25 08:22:08.083908,27.158891
channel-750,683343,30313657,30313662,5,2025-02-25 08:21:54.555145,2025-02-25 08:22:00.654351,6.099206
channel-750,683344,30313661,30313678,17,2025-02-25 08:21:59.527411,2025-02-25 08:22:20.838533,21.311122
channel-750,683345,30313676,30313697,21,2025-02-25 08:22:18.662187,2025-02-25 08:22:45.456737,26.79455
channel-750,683346,30313697,30313703,6,2025-02-25 08:22:45.456737,2025-02-25 08:22:55.524064,10.067327
channel-750,683347,30313698,30313704,6,2025-02-25 08:22:48.152144,2025-02-25 08:22:56.657651,8.505507
channel-750,683348,30313707,30313720,13,2025-02-25 08:23:00.856371,2025-02-25 08:23:16.789480,15.933109
channel-750,683349,30313719,30313725,6,2025-02-25 08:23:15.697706,2025-02-25 08:23:23.574063,7.876357
channel-750,683350,30313738,30313756,18,2025-02-25 08:23:41.672987,2025-02-25 08:24:02.513653,20.840666
channel-750,683351,30313739,30313762,23,2025-02-25 08:23:42.932305,2025-02-25 08:24:09.394589,26.462284
channel-750,683352,30313745,30313756,11,2025-02-25 08:23:49.606901,2025-02-25 08:24:02.513653,12.906752
channel-750,683353,30313760,30313777,17,2025-02-25 08:24:06.952446,2025-02-25 08:24:28.723726,21.77128
channel-750,683354,30313832,30313842,10,2025-02-25 08:25:42.735256,2025-02-25 08:25:57.318186,14.58293
channel-750,683355,30313834,30313847,13,2025-02-25 08:25:46.062630,2025-02-25 08:26:03.400232,17.337602
channel-750,683356,30313887,30313905,18,2025-02-25 08:26:54.082714,2025-02-25 08:27:16.487080,22.404366
channel-750,683357,30313936,30313943,7,2025-02-25 08:27:55.599891,2025-02-25 08:28:04.969639,9.369748
channel-750,683358,30314041,30314046,5,2025-02-25 08:30:12.607604,2025-02-25 08:30:22.433660,9.826056
channel-750,683359,30314065,30314071,6,2025-02-25 08:30:46.103675,2025-02-25 08:30:54.479833,8.376158
channel-750,683360,30314092,30314107,15,2025-02-25 08:31:20.257331,2025-02-25 08:31:39.326466,19.069135
channel-750,683361,30314110,30314115,5,2025-02-25 08:31:42.828164,2025-02-25 08:31:48.656712,5.828548
channel-750,683362,30314122,30314126,4,2025-02-25 08:31:57.951643,2025-02-25 08:32:03.109268,5.157625
channel-750,683363,30314153,30314173,20,2025-02-25 08:32:38.857252,2025-02-25 08:33:04.264671,25.407419
channel-750,683364,30314181,30314194,13,2025-02-25 08:33:15.668536,2025-02-25 08:33:34.609107,18.940571
channel-750,683365,30314189,30314198,9,2025-02-25 08:33:26.898528,2025-02-25 08:33:39.387784,12.489256
channel-750,683366,30314258,30314275,17,2025-02-25 08:34:58.040444,2025-02-25 08:35:19.998794,21.95835
channel-750,683367,30314279,30314307,28,2025-02-25 08:35:25.692807,2025-02-25 08:36:02.031840,36.339033
channel-750,683368,30314282,30314295,13,2025-02-25 08:35:29.004746,2025-02-25 08:35:45.084976,16.08023
channel-750,683369,30314344,30314372,28,2025-02-25 08:36:48.135214,2025-02-25 08:37:23.351913,35.216699
channel-750,683370,30314363,30314366,3,2025-02-25 08:37:11.746034,2025-02-25 08:37:15.128129,3.382095
channel-750,683371,30314408,30314460,52,2025-02-25 08:38:10.288240,2025-02-25 08:39:20.061798,69.773558
channel-750,683372,30314435,30314440,5,2025-02-25 08:38:49.047961,2025-02-25 08:38:54.918790,5.870829
channel-750,683373,30314449,30314454,5,2025-02-25 08:39:05.753019,2025-02-25 08:39:11.996413,6.243394
channel-750,683374,30314463,30314468,5,2025-02-25 08:39:25.695048,2025-02-25 08:39:32.342649,6.647601
channel-750,683375,30314617,30314621,4,2025-02-25 08:42:44.514240,2025-02-25 08:42:50.763785,6.249545
channel-750,683376,30314642,30314654,12,2025-02-25 08:43:18.731655,2025-02-25 08:43:37.279156,18.547501
channel-750,683377,30314654,30314665,11,2025-02-25 08:43:37.279156,2025-02-25 08:43:49.999338,12.720182
channel-750,683378,30314672,30314683,11,2025-02-25 08:43:57.953621,2025-02-25 08:44:11.495426,13.541805
channel-750,683379,30314684,30314690,6,2025-02-25 08:44:14.112467,2025-02-25 08:44:21.448193,7.335726
channel-750,683380,30314692,30314704,12,2025-02-25 08:44:23.793692,2025-02-25 08:44:40.016690,16.222998
channel-750,683381,30314694,30314708,14,2025-02-25 08:44:27.165298,2025-02-25 08:44:45.031361,17.866063
channel-750,683382,30314703,30314708,5,2025-02-25 08:44:38.839104,2025-02-25 08:44:45.031361,6.192257
channel-750,683383,30314719,30314734,15,2025-02-25 08:44:58.854268,2025-02-25 08:45:18.860717,20.006449
channel-750,683384,30314729,30314734,5,2025-02-25 08:45:10.368649,2025-02-25 08:45:18.860717,8.492068
channel-750,683385,30314776,30314786,10,2025-02-25 08:46:12.464141,2025-02-25 08:46:24.566033,12.101892
channel-750,683386,30314788,30314796,8,2025-02-25 08:46:26.957646,2025-02-25 08:46:37.853573,10.895927
channel-750,683387,30314802,30314820,18,2025-02-25 08:46:46.011127,2025-02-25 08:47:06.850447,20.83932
channel-750,683388,30314833,30314846,13,2025-02-25 08:47:26.794256,2025-02-25 08:47:43.906042,17.111786
channel-750,683389,30314865,30314870,5,2025-02-25 08:48:08.167661,2025-02-25 08:48:13.883915,5.716254
channel-750,683390,30314872,30314877,5,2025-02-25 08:48:16.125537,2025-02-25 08:48:22.852687,6.72715
channel-750,683391,30314896,30314910,14,2025-02-25 08:48:46.176759,2025-02-25 08:49:05.788297,19.611538
channel-750,683392,30314968,30314980,12,2025-02-25 08:50:20.587359,2025-02-25 08:50:34.569915,13.982556
channel-750,683393,30315003,30315014,11,2025-02-25 08:51:04.933480,2025-02-25 08:51:19.835033,14.901553
channel-750,683394,30315015,30315033,18,2025-02-25 08:51:21.029193,2025-02-25 08:51:42.691997,21.662804
channel-750,683395,30315017,30315022,5,2025-02-25 08:51:23.804987,2025-02-25 08:51:29.526985,5.721998
channel-750,683396,30315024,30315029,5,2025-02-25 08:51:31.939441,2025-02-25 08:51:38.390618,6.451177
channel-750,683397,30315025,30315030,5,2025-02-25 08:51:34.070552,2025-02-25 08:51:39.441555,5.371003
channel-750,683398,30315028,30315034,6,2025-02-25 08:51:37.257328,2025-02-25 08:51:47.148545,9.891217
channel-750,683399,30315035,30315040,5,2025-02-25 08:51:48.412729,2025-02-25 08:51:55.302737,6.890008
channel-750,683400,30315038,30315054,16,2025-02-25 08:51:52.962812,2025-02-25 08:52:12.050626,19.087814
channel-750,683401,30315051,30315062,11,2025-02-25 08:52:08.787862,2025-02-25 08:52:23.070633,14.282771
channel-750,683402,30315078,30315086,8,2025-02-25 08:52:44.090487,2025-02-25 08:52:56.442706,12.352219
channel-750,683403,30315098,30315113,15,2025-02-25 08:53:11.373089,2025-02-25 08:53:28.688458,17.315369
channel-750,683404,30315103,30315112,9,2025-02-25 08:53:17.196492,2025-02-25 08:53:27.623201,10.426709
channel-750,683405,30315180,30315188,8,2025-02-25 08:54:54.760556,2025-02-25 08:55:06.115938,11.355382
channel-750,683406,30315202,30315207,5,2025-02-25 08:55:22.884867,2025-02-25 08:55:28.542020,5.657153
channel-750,683407,30315285,30315302,17,2025-02-25 08:57:14.513735,2025-02-25 08:57:36.195226,21.681491
channel-750,683408,30315289,30315303,14,2025-02-25 08:57:20.183762,2025-02-25 08:57:37.372590,17.188828
channel-750,683409,30315307,30315312,5,2025-02-25 08:57:43.060833,2025-02-25 08:57:49.254016,6.193183
channel-750,683410,30315445,30315450,5,2025-02-25 09:00:40.433651,2025-02-25 09:00:46.156616,5.722965
channel-750,683411,30315529,30315533,4,2025-02-25 09:02:29.740019,2025-02-25 09:02:34.249917,4.509898
channel-750,683412,30315580,30315588,8,2025-02-25 09:03:35.192641,2025-02-25 09:03:44.486876,9.294235
channel-750,683413,30315586,30315590,4,2025-02-25 09:03:42.056536,2025-02-25 09:03:47.697066,5.64053
channel-750,683414,30315705,30315723,18,2025-02-25 09:06:19.527506,2025-02-25 09:06:44.274692,24.747186
channel-750,683415,30315712,30315724,12,2025-02-25 09:06:28.146341,2025-02-25 09:06:45.341667,17.195326
channel-750,683416,30315885,30315896,11,2025-02-25 09:10:16.942478,2025-02-25 09:10:29.607678,12.6652
channel-750,683417,30315892,30315912,20,2025-02-25 09:10:25.144083,2025-02-25 09:10:51.677120,26.533037
channel-750,683418,30316089,30316094,5,2025-02-25 09:14:42.698784,2025-02-25 09:14:50.683683,7.984899
channel-750,683419,30316093,30316130,37,2025-02-25 09:14:49.514361,2025-02-25 09:15:36.585973,47.071612
channel-750,683420,30316098,30316103,5,2025-02-25 09:14:56.367077,2025-02-25 09:15:03.534464,7.167387
channel-750,683421,30316171,30316177,6,2025-02-25 09:16:29.899689,2025-02-25 09:16:36.641716,6.742027
channel-750,683422,30316333,30316338,5,2025-02-25 09:20:08.441383,2025-02-25 09:20:14.562600,6.121217
channel-750,683423,30316403,30316408,5,2025-02-25 09:21:41.319640,2025-02-25 09:21:48.266410,6.94677
channel-750,683424,30316448,30316452,4,2025-02-25 09:22:40.089313,2025-02-25 09:22:44.746816,4.657503
channel-750,683425,30316463,30316473,10,2025-02-25 09:22:58.852123,2025-02-25 09:23:12.107169,13.255046
channel-750,683426,30316468,30316480,12,2025-02-25 09:23:06.555773,2025-02-25 09:23:22.602967,16.047194
channel-750,683427,30316469,30316479,10,2025-02-25 09:23:07.740816,2025-02-25 09:23:21.446616,13.7058
channel-750,683428,30316508,30316512,4,2025-02-25 09:24:00.980748,2025-02-25 09:24:05.581853,4.601105
channel-750,683429,30316525,30316537,12,2025-02-25 09:24:22.693300,2025-02-25 09:24:37.948716,15.255416
channel-750,683430,30316617,30316621,4,2025-02-25 09:26:20.455945,2025-02-25 09:26:26.932704,6.476759
channel-750,683431,30316628,30316638,10,2025-02-25 09:26:36.249741,2025-02-25 09:26:50.365702,14.115961
channel-750,683432,30316669,30316685,16,2025-02-25 09:27:31.263292,2025-02-25 09:27:52.087364,20.824072
channel-750,683433,30316674,30316687,13,2025-02-25 09:27:37.993783,2025-02-25 09:27:54.419615,16.425832
channel-750,683434,30316692,30316698,6,2025-02-25 09:28:00.149272,2025-02-25 09:28:08.265088,8.115816
channel-750,683435,30316704,30316711,7,2025-02-25 09:28:16.833625,2025-02-25 09:28:25.382422,8.548797
channel-750,683436,30316769,30316777,8,2025-02-25 09:29:43.978013,2025-02-25 09:29:54.483321,10.505308
channel-750,683437,30316783,30316793,10,2025-02-25 09:30:02.582171,2025-02-25 09:30:16.090565,13.508394
channel-750,683438,30316833,30316839,6,2025-02-25 09:31:07.339534,2025-02-25 09:31:14.242701,6.903167
channel-750,683439,30316854,30316859,5,2025-02-25 09:31:33.247243,2025-02-25 09:31:39.244103,5.99686
channel-750,683440,30316913,30316920,7,2025-02-25 09:32:49.965339,2025-02-25 09:33:04.831761,14.866422
channel-750,683441,30316915,30316923,8,2025-02-25 09:32:55.406730,2025-02-25 09:33:09.384039,13.977309
channel-750,683442,30316975,30316984,9,2025-02-25 09:34:15.736952,2025-02-25 09:34:26.275634,10.538682
channel-750,683443,30317004,30317010,6,2025-02-25 09:34:53.230251,2025-02-25 09:35:00.103208,6.872957
channel-750,683444,30317006,30317020,14,2025-02-25 09:34:55.536151,2025-02-25 09:35:13.232928,17.696777
channel-750,683445,30317034,30317039,5,2025-02-25 09:35:31.542152,2025-02-25 09:35:37.194075,5.651923
channel-750,683446,30317128,30317138,10,2025-02-25 09:37:41.160354,2025-02-25 09:37:52.290583,11.130229
channel-750,683447,30317237,30317252,15,2025-02-25 09:39:58.728094,2025-02-25 09:40:17.552566,18.824472
channel-750,683448,30317284,30317289,5,2025-02-25 09:40:59.023279,2025-02-25 09:41:04.550653,5.527374
channel-750,683449,30317303,30317317,14,2025-02-25 09:41:22.025001,2025-02-25 09:41:40.031728,18.006727
channel-750,683450,30317324,30317333,9,2025-02-25 09:41:52.345572,2025-02-25 09:42:02.875777,10.530205
channel-750,683451,30317328,30317333,5,2025-02-25 09:41:57.067093,2025-02-25 09:42:02.875777,5.808684
channel-750,683452,30317343,30317348,5,2025-02-25 09:42:18.870528,2025-02-25 09:42:25.728771,6.858243
channel-750,683453,30317368,30317379,11,2025-02-25 09:42:50.863066,2025-02-25 09:43:04.528045,13.664979
channel-750,683454,30317370,30317384,14,2025-02-25 09:42:53.341987,2025-02-25 09:43:10.608935,17.266948
channel-750,683455,30317373,30317378,5,2025-02-25 09:42:56.654825,2025-02-25 09:43:02.367904,5.713079
channel-750,683456,30317607,30317613,6,2025-02-25 09:48:00.486768,2025-02-25 09:48:07.559011,7.072243
channel-750,683457,30317689,30317703,14,2025-02-25 09:49:42.711671,2025-02-25 09:50:02.230778,19.519107
channel-750,683458,30317705,30317711,6,2025-02-25 09:50:04.692968,2025-02-25 09:50:11.935679,7.242711
channel-750,683459,30317729,30317735,6,2025-02-25 09:50:35.990497,2025-02-25 09:50:42.548852,6.558355
channel-750,683460,30317741,30317746,5,2025-02-25 09:50:52.967781,2025-02-25 09:50:59.881371,6.91359
channel-750,683461,30317759,30317764,5,2025-02-25 09:51:19.549526,2025-02-25 09:51:25.430404,5.880878
channel-750,683462,30317818,30317823,5,2025-02-25 09:52:40.632456,2025-02-25 09:52:46.671533,6.039077
channel-750,683463,30317939,30317943,4,2025-02-25 09:55:21.545136,2025-02-25 09:55:30.720762,9.175626
channel-750,683464,30317939,30317954,15,2025-02-25 09:55:21.545136,2025-02-25 09:55:47.689547,26.144411
channel-750,683465,30317999,30318002,3,2025-02-25 09:56:46.433607,2025-02-25 09:56:49.931589,3.497982
channel-750,683466,30318020,30318025,5,2025-02-25 09:57:15.990460,2025-02-25 09:57:23.028404,7.037944
channel-750,683467,30318054,30318059,5,2025-02-25 09:58:03.043617,2025-02-25 09:58:08.734998,5.691381
channel-750,683468,30318076,30318079,3,2025-02-25 09:58:29.549653,2025-02-25 09:58:32.999172,3.449519
channel-750,683469,30318104,30318117,13,2025-02-25 09:59:08.750233,2025-02-25 09:59:23.788615,15.038382
channel-750,683470,30318123,30318136,13,2025-02-25 09:59:38.687827,2025-02-25 09:59:55.671668,16.983841
channel-750,683471,30318153,30318157,4,2025-02-25 10:00:16.139122,2025-02-25 10:00:20.731590,4.592468
channel-750,683472,30318230,30318243,13,2025-02-25 10:02:05.160981,2025-02-25 10:02:22.163457,17.002476
channel-750,683473,30318241,30318253,12,2025-02-25 10:02:18.810986,2025-02-25 10:02:37.466865,18.655879
channel-750,683474,30318298,30318309,11,2025-02-25 10:03:35.981553,2025-02-25 10:03:48.052295,12.070742
channel-750,683475,30318311,30318317,6,2025-02-25 10:03:50.399486,2025-02-25 10:03:59.296728,8.897242
channel-750,683476,30318319,30318327,8,2025-02-25 10:04:01.589011,2025-02-25 10:04:11.828154,10.239143
channel-750,683477,30318339,30318344,5,2025-02-25 10:04:26.116370,2025-02-25 10:04:33.946182,7.829812
channel-750,683478,30318345,30318354,9,2025-02-25 10:04:36.032004,2025-02-25 10:04:50.600059,14.568055
channel-750,683479,30318376,30318382,6,2025-02-25 10:05:22.433793,2025-02-25 10:05:29.763780,7.329987
channel-750,683480,30318386,30318405,19,2025-02-25 10:05:34.453751,2025-02-25 10:05:57.211428,22.757677
channel-750,683481,30318388,30318402,14,2025-02-25 10:05:36.721450,2025-02-25 10:05:53.823370,17.10192
channel-750,683482,30318394,30318399,5,2025-02-25 10:05:44.367757,2025-02-25 10:05:50.487618,6.119861
channel-750,683483,30318416,30318428,12,2025-02-25 10:06:14.669490,2025-02-25 10:06:30.868015,16.198525
channel-750,683484,30318421,30318427,6,2025-02-25 10:06:20.822810,2025-02-25 10:06:29.682290,8.85948
channel-750,683485,30318436,30318441,5,2025-02-25 10:06:40.338503,2025-02-25 10:06:46.335224,5.996721
channel-750,683486,30318444,30318448,4,2025-02-25 10:06:51.465732,2025-02-25 10:06:56.040876,4.575144
channel-750,683487,30318467,30318472,5,2025-02-25 10:07:25.298823,2025-02-25 10:07:33.044256,7.745433
channel-750,683488,30318540,30318549,9,2025-02-25 10:08:58.150602,2025-02-25 10:09:09.021631,10.871029
channel-750,683489,30318550,30318561,11,2025-02-25 10:09:10.115364,2025-02-25 10:09:24.660451,14.545087
channel-750,683490,30318563,30318571,8,2025-02-25 10:09:27.005536,2025-02-25 10:09:38.008530,11.002994
channel-750,683491,30318572,30318576,4,2025-02-25 10:09:39.126391,2025-02-25 10:09:54.389476,15.263085
channel-750,683492,30318574,30318591,17,2025-02-25 10:09:41.343318,2025-02-25 10:10:16.332168,34.98885
channel-750,683493,30318592,30318653,61,2025-02-25 10:10:17.575907,2025-02-25 10:11:37.082274,79.506367
channel-750,683494,30318608,30318653,45,2025-02-25 10:10:37.405525,2025-02-25 10:11:37.082274,59.676749
channel-750,683495,30318626,30318631,5,2025-02-25 10:11:00.245444,2025-02-25 10:11:06.074345,5.828901
channel-750,683496,30318645,30318653,8,2025-02-25 10:11:25.344061,2025-02-25 10:11:37.082274,11.738213
channel-750,683497,30318649,30318664,15,2025-02-25 10:11:32.421779,2025-02-25 10:11:51.978120,19.556341
channel-750,683498,30318677,30318682,5,2025-02-25 10:12:08.176122,2025-02-25 10:12:14.636214,6.460092
channel-750,683499,30318690,30318694,4,2025-02-25 10:12:23.801754,2025-02-25 10:12:31.835011,8.033257
channel-750,683500,30318730,30318734,4,2025-02-25 10:13:19.555390,2025-02-25 10:13:25.382467,5.827077
channel-750,683501,30318745,30318750,5,2025-02-25 10:13:39.180790,2025-02-25 10:13:46.179855,6.999065
channel-750,683502,30318780,30318785,5,2025-02-25 10:14:23.822005,2025-02-25 10:14:31.040098,7.218093
channel-750,683503,30318782,30318786,4,2025-02-25 10:14:27.056882,2025-02-25 10:14:35.474950,8.418068
channel-750,683504,30318788,30318806,18,2025-02-25 10:14:37.775908,2025-02-25 10:15:01.657391,23.881483
channel-750,683505,30318798,30318806,8,2025-02-25 10:14:50.497423,2025-02-25 10:15:01.657391,11.159968
channel-750,683506,30318802,30318814,12,2025-02-25 10:14:56.055288,2025-02-25 10:15:17.796669,21.741381
channel-750,683507,30318822,30318833,11,2025-02-25 10:15:27.044231,2025-02-25 10:15:39.729527,12.685296
channel-750,683508,30318848,30318878,30,2025-02-25 10:15:58.207752,2025-02-25 10:16:39.537538,41.329786
channel-750,683509,30318851,30318863,12,2025-02-25 10:16:01.873276,2025-02-25 10:16:19.962263,18.088987
channel-750,683510,30318863,30318868,5,2025-02-25 10:16:19.962263,2025-02-25 10:16:27.073018,7.110755
channel-750,683511,30318937,30318964,27,2025-02-25 10:18:01.519557,2025-02-25 10:18:36.479278,34.959721
channel-750,683512,30318941,30318949,8,2025-02-25 10:18:06.822080,2025-02-25 10:18:16.112334,9.290254
channel-750,683513,30318946,30318964,18,2025-02-25 10:18:12.686468,2025-02-25 10:18:36.479278,23.79281
channel-750,683514,30319028,30319035,7,2025-02-25 10:20:01.664042,2025-02-25 10:20:14.146867,12.482825
channel-750,683515,30319034,30319039,5,2025-02-25 10:20:12.985426,2025-02-25 10:20:19.397441,6.412015
channel-750,683516,30319073,30319088,15,2025-02-25 10:21:04.312223,2025-02-25 10:21:25.540670,21.228447
channel-750,683517,30319109,30319138,29,2025-02-25 10:21:54.946407,2025-02-25 10:22:30.362084,35.415677
channel-750,683518,30319152,30319155,3,2025-02-25 10:22:48.991784,2025-02-25 10:22:55.530161,6.538377
channel-750,683519,30319286,30319291,5,2025-02-25 10:25:55.294545,2025-02-25 10:26:02.067538,6.772993
channel-750,683520,30319289,30319293,4,2025-02-25 10:25:59.737231,2025-02-25 10:26:05.927257,6.190026
channel-750,683521,30319290,30319294,4,2025-02-25 10:26:00.861623,2025-02-25 10:26:07.115338,6.253715
channel-750,683522,30319311,30319316,5,2025-02-25 10:26:28.406303,2025-02-25 10:26:34.543221,6.136918
channel-750,683523,30319345,30319350,5,2025-02-25 10:27:13.949813,2025-02-25 10:27:19.767902,5.818089
channel-750,683524,30319390,30319393,3,2025-02-25 10:28:11.642425,2025-02-25 10:28:16.320635,4.67821
channel-750,683525,30319390,30319400,10,2025-02-25 10:28:11.642425,2025-02-25 10:28:29.037893,17.395468
channel-750,683526,30319403,30319407,4,2025-02-25 10:28:33.074670,2025-02-25 10:28:40.876397,7.801727
channel-750,683527,30319435,30319449,14,2025-02-25 10:29:19.173429,2025-02-25 10:29:36.395106,17.221677
channel-750,683528,30319450,30319455,5,2025-02-25 10:29:38.559645,2025-02-25 10:29:44.492357,5.932712
channel-750,683529,30319477,30319488,11,2025-02-25 10:30:14.671442,2025-02-25 10:30:30.033233,15.361791
channel-750,683530,30319479,30319485,6,2025-02-25 10:30:17.162270,2025-02-25 10:30:25.205479,8.043209
channel-750,683531,30319482,30319497,15,2025-02-25 10:30:21.085034,2025-02-25 10:30:44.128862,23.043828
channel-750,683532,30319483,30319493,10,2025-02-25 10:30:22.398772,2025-02-25 10:30:36.208306,13.809534
channel-750,683533,30319489,30319498,9,2025-02-25 10:30:31.307186,2025-02-25 10:30:46.278300,14.971114
channel-750,683534,30319505,30319516,11,2025-02-25 10:30:59.460496,2025-02-25 10:31:12.430590,12.970094
channel-750,683535,30319506,30319511,5,2025-02-25 10:31:00.643679,2025-02-25 10:31:06.473783,5.830104
channel-750,683536,30319526,30319532,6,2025-02-25 10:31:25.497674,2025-02-25 10:31:33.344244,7.84657
channel-750,683537,30319535,30319545,10,2025-02-25 10:31:38.792261,2025-02-25 10:31:51.698510,12.906249
channel-750,683538,30319538,30319569,31,2025-02-25 10:31:42.420960,2025-02-25 10:32:23.914915,41.493955
channel-750,683539,30319554,30319558,4,2025-02-25 10:32:01.880178,2025-02-25 10:32:06.797749,4.917571
channel-750,683540,30319558,30319563,5,2025-02-25 10:32:06.797749,2025-02-25 10:32:12.615753,5.818004
channel-750,683541,30319561,30319569,8,2025-02-25 10:32:10.034020,2025-02-25 10:32:23.914915,13.880895
channel-750,683542,30319571,30319582,11,2025-02-25 10:32:26.198013,2025-02-25 10:32:39.939437,13.741424
channel-750,683543,30319580,30319585,5,2025-02-25 10:32:36.584044,2025-02-25 10:32:44.783666,8.199622
channel-750,683544,30319597,30319612,15,2025-02-25 10:33:00.163361,2025-02-25 10:33:19.270335,19.106974
channel-750,683545,30319606,30319616,10,2025-02-25 10:33:12.135968,2025-02-25 10:33:29.165073,17.029105
channel-750,683546,30319607,30319615,8,2025-02-25 10:33:13.347471,2025-02-25 10:33:24.786847,11.439376
channel-750,683547,30319607,30319612,5,2025-02-25 10:33:13.347471,2025-02-25 10:33:19.270335,5.922864
channel-750,683548,30319614,30319635,21,2025-02-25 10:33:22.480258,2025-02-25 10:33:57.264178,34.78392
channel-750,683549,30319626,30319639,13,2025-02-25 10:33:45.104581,2025-02-25 10:34:03.220172,18.115591
channel-750,683550,30319641,30319654,13,2025-02-25 10:34:05.996364,2025-02-25 10:34:22.789790,16.793426
channel-750,683551,30319654,30319658,4,2025-02-25 10:34:22.789790,2025-02-25 10:34:28.505697,5.715907
channel-750,683552,30319661,30319671,10,2025-02-25 10:34:32.124557,2025-02-25 10:34:44.179205,12.054648
channel-750,683553,30319664,30319688,24,2025-02-25 10:34:35.596658,2025-02-25 10:35:10.236480,34.639822
channel-750,683554,30319676,30319687,11,2025-02-25 10:34:54.682593,2025-02-25 10:35:08.880874,14.198281
channel-750,683555,30319678,30319695,17,2025-02-25 10:34:58.238868,2025-02-25 10:35:19.322880,21.084012
channel-750,683556,30319681,30319698,17,2025-02-25 10:35:01.993069,2025-02-25 10:35:23.289529,21.29646
channel-750,683557,30319689,30319719,30,2025-02-25 10:35:11.502345,2025-02-25 10:35:49.395565,37.89322
channel-750,683558,30319719,30319729,10,2025-02-25 10:35:49.395565,2025-02-25 10:36:07.116638,17.721073
channel-750,683559,30319722,30319731,9,2025-02-25 10:35:53.063851,2025-02-25 10:36:10.126185,17.062334
channel-750,683560,30319724,30319742,18,2025-02-25 10:35:59.925682,2025-02-25 10:36:24.220839,24.295157
channel-750,683561,30319724,30319729,5,2025-02-25 10:35:59.925682,2025-02-25 10:36:07.116638,7.190956
channel-750,683562,30319730,30319756,26,2025-02-25 10:36:08.385216,2025-02-25 10:36:41.067861,32.682645
channel-750,683563,30319744,30319752,8,2025-02-25 10:36:26.302919,2025-02-25 10:36:36.392343,10.089424
channel-750,683564,30319764,30319774,10,2025-02-25 10:36:53.542939,2025-02-25 10:37:05.783403,12.240464
channel-750,683565,30319780,30319784,4,2025-02-25 10:37:14.062200,2025-02-25 10:37:18.627239,4.565039
channel-750,683566,30319805,30319810,5,2025-02-25 10:37:45.952092,2025-02-25 10:37:51.502281,5.550189
channel-750,683567,30319806,30319811,5,2025-02-25 10:37:47.030471,2025-02-25 10:37:52.683219,5.652748
channel-750,683568,30319823,30319841,18,2025-02-25 10:38:11.256740,2025-02-25 10:38:37.996304,26.739564
channel-750,683569,30319847,30319852,5,2025-02-25 10:38:45.932271,2025-02-25 10:38:54.393935,8.461664
channel-750,683570,30319914,30319918,4,2025-02-25 10:40:12.450254,2025-02-25 10:40:17.856622,5.406368
channel-750,683571,30319932,30319935,3,2025-02-25 10:40:36.944255,2025-02-25 10:40:41.970512,5.026257
channel-750,683572,30319934,30319949,15,2025-02-25 10:40:39.222564,2025-02-25 10:40:58.959780,19.737216
channel-750,683573,30319959,30319969,10,2025-02-25 10:41:14.918529,2025-02-25 10:41:28.502089,13.58356
channel-750,683574,30319995,30320012,17,2025-02-25 10:41:58.994738,2025-02-25 10:42:19.528652,20.533914
channel-750,683575,30320037,30320048,11,2025-02-25 10:42:53.166599,2025-02-25 10:43:11.588777,18.422178
channel-750,683576,30320052,30320055,3,2025-02-25 10:43:16.168511,2025-02-25 10:43:21.313525,5.145014
channel-750,683577,30320057,30320064,7,2025-02-25 10:43:23.884311,2025-02-25 10:43:35.504212,11.619901
channel-750,683578,30320118,30320126,8,2025-02-25 10:44:47.402771,2025-02-25 10:44:56.221414,8.818643
channel-750,683579,30320120,30320135,15,2025-02-25 10:44:49.636978,2025-02-25 10:45:07.581739,17.944761
channel-750,683580,30320125,30320138,13,2025-02-25 10:44:55.147832,2025-02-25 10:45:12.540718,17.392886
channel-750,683581,30320127,30320139,12,2025-02-25 10:44:57.997948,2025-02-25 10:45:13.582351,15.584403
channel-750,683582,30320210,30320221,11,2025-02-25 10:46:50.905641,2025-02-25 10:47:04.876730,13.971089
channel-750,683583,30320231,30320245,14,2025-02-25 10:47:16.980206,2025-02-25 10:47:37.264017,20.283811
channel-750,683584,30320346,30320361,15,2025-02-25 10:49:47.722823,2025-02-25 10:50:09.145195,21.422372
channel-750,683585,30320386,30320394,8,2025-02-25 10:50:41.157942,2025-02-25 10:50:51.940406,10.782464
channel-750,683586,30320386,30320397,11,2025-02-25 10:50:41.157942,2025-02-25 10:50:55.706459,14.548517
channel-750,683587,30320386,30320400,14,2025-02-25 10:50:41.157942,2025-02-25 10:50:59.197082,18.03914
channel-750,683588,30320387,30320400,13,2025-02-25 10:50:42.334144,2025-02-25 10:50:59.197082,16.862938
channel-750,683589,30320408,30320440,32,2025-02-25 10:51:10.556106,2025-02-25 10:51:53.469071,42.912965
channel-750,683590,30320410,30320430,20,2025-02-25 10:51:12.939247,2025-02-25 10:51:40.686279,27.747032
channel-750,683591,30320425,30320438,13,2025-02-25 10:51:34.491691,2025-02-25 10:51:51.227652,16.735961
channel-750,683592,30320477,30320482,5,2025-02-25 10:52:45.087234,2025-02-25 10:52:50.798149,5.710915
channel-750,683593,30320479,30320484,5,2025-02-25 10:52:47.347813,2025-02-25 10:52:53.173400,5.825587
channel-750,683594,30320493,30320500,7,2025-02-25 10:53:04.859311,2025-02-25 10:53:14.349087,9.489776
channel-750,683595,30320494,30320512,18,2025-02-25 10:53:06.005811,2025-02-25 10:53:31.181371,25.17556
channel-750,683596,30320500,30320505,5,2025-02-25 10:53:14.349087,2025-02-25 10:53:21.015244,6.666157
channel-750,683597,30320506,30320511,5,2025-02-25 10:53:23.138899,2025-02-25 10:53:28.868902,5.730003
channel-750,683598,30320511,30320527,16,2025-02-25 10:53:28.868902,2025-02-25 10:53:50.643500,21.774598
channel-750,683599,30320511,30320527,16,2025-02-25 10:53:28.868902,2025-02-25 10:53:50.643500,21.774598
channel-750,683600,30320513,30320518,5,2025-02-25 10:53:33.464804,2025-02-25 10:53:39.436898,5.972094
channel-750,683601,30320534,30320541,7,2025-02-25 10:53:58.710982,2025-02-25 10:54:11.106980,12.395998
channel-750,683602,30320561,30320593,32,2025-02-25 10:54:37.839353,2025-02-25 10:55:17.249249,39.409896
channel-750,683603,30320561,30320593,32,2025-02-25 10:54:37.839353,2025-02-25 10:55:17.249249,39.409896
channel-750,683604,30320573,30320583,10,2025-02-25 10:54:52.793928,2025-02-25 10:55:05.370412,12.576484
channel-750,683605,30320586,30320604,18,2025-02-25 10:55:08.820344,2025-02-25 10:55:33.068579,24.248235
channel-750,683606,30320586,30320591,5,2025-02-25 10:55:08.820344,2025-02-25 10:55:14.959885,6.139541
channel-750,683607,30320595,30320598,3,2025-02-25 10:55:19.512101,2025-02-25 10:55:24.148389,4.636288
channel-750,683608,30320620,30320630,10,2025-02-25 10:55:52.038113,2025-02-25 10:56:07.011003,14.97289
channel-750,683609,30320638,30320643,5,2025-02-25 10:56:16.423891,2025-02-25 10:56:22.455429,6.031538
channel-750,683610,30320646,30320648,2,2025-02-25 10:56:27.201006,2025-02-25 10:56:29.488116,2.28711
channel-750,683611,30320653,30320663,10,2025-02-25 10:56:38.509805,2025-02-25 10:56:54.674537,16.164732
channel-750,683612,30320665,30320680,15,2025-02-25 10:56:57.049880,2025-02-25 10:57:15.331091,18.281211
channel-750,683613,30320670,30320676,6,2025-02-25 10:57:03.913299,2025-02-25 10:57:10.740808,6.827509
channel-750,683614,30320689,30320702,13,2025-02-25 10:57:27.464796,2025-02-25 10:57:43.948846,16.48405
channel-750,683615,30320694,30320699,5,2025-02-25 10:57:34.788361,2025-02-25 10:57:40.627345,5.838984
channel-750,683616,30320701,30320706,5,2025-02-25 10:57:42.741771,2025-02-25 10:57:49.789398,7.047627
channel-750,683617,30320737,30320748,11,2025-02-25 10:58:30.416800,2025-02-25 10:58:45.164331,14.747531
channel-750,683618,30320741,30320747,6,2025-02-25 10:58:35.577679,2025-02-25 10:58:44.081383,8.503704
channel-750,683619,30320768,30320778,10,2025-02-25 10:59:12.956319,2025-02-25 10:59:24.082624,11.126305
channel-750,683620,30320778,30320787,9,2025-02-25 10:59:24.082624,2025-02-25 10:59:36.237014,12.15439
channel-750,683621,30320805,30320816,11,2025-02-25 11:00:03.104009,2025-02-25 11:00:16.149338,13.045329
channel-750,683622,30320816,30320821,5,2025-02-25 11:00:16.149338,2025-02-25 11:00:23.467584,7.318246
channel-750,683623,30320841,30320848,7,2025-02-25 11:00:49.099150,2025-02-25 11:00:58.221277,9.122127
channel-750,683624,30320873,30320880,7,2025-02-25 11:01:32.913133,2025-02-25 11:01:44.990066,12.076933
channel-750,683625,30320925,30320933,8,2025-02-25 11:02:43.462170,2025-02-25 11:02:53.882044,10.419874
channel-750,683626,30320933,30320937,4,2025-02-25 11:02:53.882044,2025-02-25 11:03:00.150856,6.268812
channel-750,683627,30320934,30320939,5,2025-02-25 11:02:56.182532,2025-02-25 11:03:02.379869,6.197337
channel-750,683628,30320968,30320979,11,2025-02-25 11:03:39.711647,2025-02-25 11:03:58.432920,18.721273
channel-750,683629,30320978,30320983,5,2025-02-25 11:03:57.312646,2025-02-25 11:04:02.950353,5.637707
channel-750,683630,30320987,30320991,4,2025-02-25 11:04:09.113703,2025-02-25 11:04:14.020406,4.906703
channel-750,683631,30321018,30321036,18,2025-02-25 11:04:50.434944,2025-02-25 11:05:14.297916,23.862972
channel-750,683632,30321059,30321064,5,2025-02-25 11:05:43.262397,2025-02-25 11:05:50.914650,7.652253
channel-750,683633,30321061,30321065,4,2025-02-25 11:05:47.272347,2025-02-25 11:05:52.158070,4.885723
channel-750,683634,30321064,30321069,5,2025-02-25 11:05:50.914650,2025-02-25 11:06:00.222219,9.307569
channel-750,683635,30321112,30321118,6,2025-02-25 11:06:53.019489,2025-02-25 11:07:03.082817,10.063328
channel-750,683636,30321243,30321253,10,2025-02-25 11:09:52.180515,2025-02-25 11:10:06.527573,14.347058
channel-750,683637,30321269,30321280,11,2025-02-25 11:10:25.121235,2025-02-25 11:10:42.254979,17.133744
channel-750,683638,30321354,30321372,18,2025-02-25 11:12:21.250431,2025-02-25 11:12:43.631474,22.381043
channel-750,683639,30321420,30321438,18,2025-02-25 11:13:43.789027,2025-02-25 11:14:05.568449,21.779422
channel-750,683640,30321563,30321580,17,2025-02-25 11:16:57.738419,2025-02-25 11:17:23.761451,26.023032
channel-750,683641,30321797,30321814,17,2025-02-25 11:22:15.264100,2025-02-25 11:22:40.415167,25.151067
channel-750,683642,30321894,30321904,10,2025-02-25 11:24:20.453391,2025-02-25 11:24:36.924581,16.47119
channel-750,683643,30321915,30321926,11,2025-02-25 11:24:52.078723,2025-02-25 11:25:09.358011,17.279288
channel-750,683644,30321942,30321952,10,2025-02-25 11:25:30.512237,2025-02-25 11:25:41.964135,11.451898
channel-750,683645,30321953,30321969,16,2025-02-25 11:25:44.273267,2025-02-25 11:26:03.260239,18.986972
channel-750,683646,30321975,30321992,17,2025-02-25 11:26:11.633550,2025-02-25 11:26:31.949650,20.3161
channel-750,683647,30321990,30321995,5,2025-02-25 11:26:29.617560,2025-02-25 11:26:35.558043,5.940483
channel-750,683648,30321992,30322000,8,2025-02-25 11:26:31.949650,2025-02-25 11:26:43.722033,11.772383
channel-750,683649,30321993,30321997,4,2025-02-25 11:26:33.163689,2025-02-25 11:26:37.702035,4.538346
channel-750,683650,30322071,30322080,9,2025-02-25 11:28:18.205812,2025-02-25 11:28:29.459060,11.253248
channel-750,683651,30322086,30322093,7,2025-02-25 11:28:36.636356,2025-02-25 11:28:46.888498,10.252142
channel-750,683652,30322098,30322104,6,2025-02-25 11:28:53.786916,2025-02-25 11:29:03.471141,9.684225
channel-750,683653,30322107,30322114,7,2025-02-25 11:29:07.388331,2025-02-25 11:29:20.984219,13.595888
channel-750,683654,30322228,30322239,11,2025-02-25 11:31:51.599305,2025-02-25 11:32:04.708891,13.109586
channel-750,683655,30322229,30322244,15,2025-02-25 11:31:52.705920,2025-02-25 11:32:12.321050,19.61513
channel-750,683656,30322278,30322288,10,2025-02-25 11:32:58.705451,2025-02-25 11:33:10.680473,11.975022
channel-750,683657,30322285,30322296,11,2025-02-25 11:33:07.205671,2025-02-25 11:33:22.277258,15.071587
channel-750,683658,30322293,30322298,5,2025-02-25 11:33:17.529186,2025-02-25 11:33:24.623643,7.094457
channel-750,683659,30322443,30322449,6,2025-02-25 11:36:38.190111,2025-02-25 11:36:44.943424,6.753313
channel-750,683660,30322562,30322573,11,2025-02-25 11:39:17.011313,2025-02-25 11:39:30.997982,13.986669
channel-750,683661,30322595,30322606,11,2025-02-25 11:39:57.290934,2025-02-25 11:40:12.816841,15.525907
channel-750,683662,30322615,30322623,8,2025-02-25 11:40:26.511780,2025-02-25 11:40:37.987397,11.475617
channel-750,683663,30322636,30322648,12,2025-02-25 11:41:00.272186,2025-02-25 11:41:14.526840,14.254654
channel-750,683664,30322644,30322654,10,2025-02-25 11:41:09.816438,2025-02-25 11:41:22.222257,12.405819
channel-750,683665,30322704,30322713,9,2025-02-25 11:42:25.410313,2025-02-25 11:42:40.646332,15.236019
channel-750,683666,30322708,30322722,14,2025-02-25 11:42:30.144829,2025-02-25 11:42:51.157074,21.012245
channel-750,683667,30322713,30322722,9,2025-02-25 11:42:40.646332,2025-02-25 11:42:51.157074,10.510742
channel-750,683668,30322769,30322782,13,2025-02-25 11:43:59.199887,2025-02-25 11:44:15.280116,16.080229
channel-750,683669,30322783,30322792,9,2025-02-25 11:44:16.539288,2025-02-25 11:44:28.091945,11.552657
channel-750,683670,30322836,30322846,10,2025-02-25 11:45:26.270103,2025-02-25 11:45:42.571776,16.301673
channel-750,683671,30322855,30322867,12,2025-02-25 11:45:54.995895,2025-02-25 11:46:10.579155,15.58326
channel-750,683672,30322857,30322870,13,2025-02-25 11:45:57.453765,2025-02-25 11:46:15.036852,17.583087
channel-750,683673,30322871,30322882,11,2025-02-25 11:46:17.251095,2025-02-25 11:46:30.219109,12.968014
channel-750,683674,30322872,30322882,10,2025-02-25 11:46:18.293809,2025-02-25 11:46:30.219109,11.9253
channel-750,683675,30322872,30322882,10,2025-02-25 11:46:18.293809,2025-02-25 11:46:30.219109,11.9253
channel-750,683676,30322877,30322888,11,2025-02-25 11:46:24.141913,2025-02-25 11:46:41.464407,17.322494
channel-750,683677,30322882,30322888,6,2025-02-25 11:46:30.219109,2025-02-25 11:46:41.464407,11.245298
channel-750,683678,30322882,30322898,16,2025-02-25 11:46:30.219109,2025-02-25 11:46:53.815082,23.595973
channel-750,683679,30322885,30322890,5,2025-02-25 11:46:37.812232,2025-02-25 11:46:43.633801,5.821569
channel-750,683680,30322886,30322891,5,2025-02-25 11:46:38.945251,2025-02-25 11:46:44.756434,5.811183
channel-750,683681,30322910,30322918,8,2025-02-25 11:47:08.114214,2025-02-25 11:47:19.311338,11.197124
channel-750,683682,30322934,30322948,14,2025-02-25 11:47:42.171115,2025-02-25 11:47:58.301198,16.130083
channel-750,683683,30322942,30322956,14,2025-02-25 11:47:51.537191,2025-02-25 11:48:12.140740,20.603549
channel-750,683684,30322944,30322963,19,2025-02-25 11:47:53.723040,2025-02-25 11:48:21.006505,27.283465
channel-750,683685,30322970,30322987,17,2025-02-25 11:48:33.386611,2025-02-25 11:48:55.075537,21.688926
channel-750,683686,30322982,30322997,15,2025-02-25 11:48:49.329556,2025-02-25 11:49:07.672005,18.342449
channel-750,683687,30322987,30322998,11,2025-02-25 11:48:55.075537,2025-02-25 11:49:09.437496,14.361959
channel-750,683688,30322988,30323004,16,2025-02-25 11:48:56.613659,2025-02-25 11:49:17.546268,20.932609
channel-750,683689,30322997,30323015,18,2025-02-25 11:49:07.672005,2025-02-25 11:49:30.470118,22.798113
channel-750,683690,30322999,30323018,19,2025-02-25 11:49:11.694068,2025-02-25 11:49:35.233458,23.53939
channel-750,683691,30323000,30323016,16,2025-02-25 11:49:12.871921,2025-02-25 11:49:32.864061,19.99214
channel-750,683692,30323001,30323013,12,2025-02-25 11:49:13.983154,2025-02-25 11:49:28.204982,14.221828
channel-750,683693,30323005,30323034,29,2025-02-25 11:49:18.760101,2025-02-25 11:49:54.820538,36.060437
channel-750,683694,30323006,30323051,45,2025-02-25 11:49:19.918729,2025-02-25 11:50:16.028741,56.110012
channel-750,683695,30323006,30323018,12,2025-02-25 11:49:19.918729,2025-02-25 11:49:35.233458,15.314729
channel-750,683696,30323009,30323044,35,2025-02-25 11:49:23.430383,2025-02-25 11:50:07.683417,44.253034
channel-750,683697,30323016,30323031,15,2025-02-25 11:49:32.864061,2025-02-25 11:49:51.391971,18.52791
channel-750,683698,30323022,30323031,9,2025-02-25 11:49:39.859461,2025-02-25 11:49:51.391971,11.53251
channel-750,683699,30323025,30323038,13,2025-02-25 11:49:43.456168,2025-02-25 11:49:59.845423,16.389255
channel-750,683700,30323025,30323039,14,2025-02-25 11:49:43.456168,2025-02-25 11:50:01.009396,17.553228
channel-750,683701,30323026,30323037,11,2025-02-25 11:49:45.081589,2025-02-25 11:49:58.505310,13.423721
channel-750,683702,30323028,30323051,23,2025-02-25 11:49:47.392770,2025-02-25 11:50:16.028741,28.635971
channel-750,683703,30323029,30323034,5,2025-02-25 11:49:48.483772,2025-02-25 11:49:54.820538,6.336766
channel-750,683704,30323046,30323058,12,2025-02-25 11:50:10.138569,2025-02-25 11:50:26.173496,16.034927
channel-750,683705,30323063,30323078,15,2025-02-25 11:50:31.974638,2025-02-25 11:50:52.745379,20.770741
channel-750,683706,30323074,30323088,14,2025-02-25 11:50:48.020952,2025-02-25 11:51:05.006642,16.98569
channel-750,683707,30323139,30323149,10,2025-02-25 11:52:09.874567,2025-02-25 11:52:24.056893,14.182326
channel-750,683708,30323141,30323149,8,2025-02-25 11:52:13.801925,2025-02-25 11:52:24.056893,10.254968
channel-750,683709,30323143,30323159,16,2025-02-25 11:52:16.092173,2025-02-25 11:52:39.201529,23.109356
channel-750,683710,30323146,30323160,14,2025-02-25 11:52:19.466264,2025-02-25 11:52:41.602872,22.136608
channel-750,683711,30323151,30323179,28,2025-02-25 11:52:29.474898,2025-02-25 11:53:05.920876,36.445978
channel-750,683712,30323163,30323177,14,2025-02-25 11:52:45.414689,2025-02-25 11:53:03.695692,18.281003
channel-750,683713,30323167,30323182,15,2025-02-25 11:52:51.110366,2025-02-25 11:53:09.682959,18.572593
channel-750,683714,30323177,30323182,5,2025-02-25 11:53:03.695692,2025-02-25 11:53:09.682959,5.987267
channel-750,683715,30323180,30323197,17,2025-02-25 11:53:07.253101,2025-02-25 11:53:28.660062,21.406961
channel-750,683716,30323205,30323226,21,2025-02-25 11:53:38.217655,2025-02-25 11:54:04.965354,26.747699
channel-750,683717,30323210,30323223,13,2025-02-25 11:53:45.122191,2025-02-25 11:54:00.993678,15.871487
channel-750,683718,30323212,30323224,12,2025-02-25 11:53:47.297554,2025-02-25 11:54:02.630252,15.332698
channel-750,683719,30323219,30323229,10,2025-02-25 11:53:55.300244,2025-02-25 11:54:09.892175,14.591931
channel-750,683720,30323220,30323241,21,2025-02-25 11:53:56.405857,2025-02-25 11:54:28.034840,31.628983
channel-750,683721,30323225,30323242,17,2025-02-25 11:54:03.905076,2025-02-25 11:54:29.191369,25.286293
channel-750,683722,30323245,30323260,15,2025-02-25 11:54:33.823427,2025-02-25 11:54:52.731974,18.908547
channel-750,683723,30323255,30323264,9,2025-02-25 11:54:45.615500,2025-02-25 11:54:57.900377,12.284877
channel-750,683724,30323262,30323276,14,2025-02-25 11:54:55.555610,2025-02-25 11:55:12.572944,17.017334
channel-750,683725,30323265,30323269,4,2025-02-25 11:54:58.925723,2025-02-25 11:55:04.006604,5.080881
channel-750,683726,30323275,30323280,5,2025-02-25 11:55:11.472138,2025-02-25 11:55:17.972802,6.500664
channel-750,683727,30323277,30323288,11,2025-02-25 11:55:13.787337,2025-02-25 11:55:27.803331,14.015994
channel-750,683728,30323282,30323287,5,2025-02-25 11:55:20.316891,2025-02-25 11:55:26.705854,6.388963
channel-750,683729,30323287,30323318,31,2025-02-25 11:55:26.705854,2025-02-25 11:56:08.322639,41.616785
channel-750,683730,30323302,30323316,14,2025-02-25 11:55:46.240781,2025-02-25 11:56:05.910082,19.669301
channel-750,683731,30323307,30323311,4,2025-02-25 11:55:54.158787,2025-02-25 11:55:58.772504,4.613717
channel-750,683732,30323336,30323352,16,2025-02-25 11:56:30.449025,2025-02-25 11:56:48.971879,18.522854
channel-750,683733,30323341,30323362,21,2025-02-25 11:56:36.246930,2025-02-25 11:57:07.167475,30.920545
channel-750,683734,30323364,30323385,21,2025-02-25 11:57:09.514094,2025-02-25 11:57:33.900765,24.386671
channel-750,683735,30323368,30323386,18,2025-02-25 11:57:14.153734,2025-02-25 11:57:35.146363,20.992629
channel-750,683736,30323381,30323396,15,2025-02-25 11:57:28.996499,2025-02-25 11:57:48.365284,19.368785
channel-750,683737,30323381,30323395,14,2025-02-25 11:57:28.996499,2025-02-25 11:57:46.745760,17.749261
channel-750,683738,30323398,30323412,14,2025-02-25 11:57:50.733677,2025-02-25 11:58:10.575598,19.841921
channel-750,683739,30323404,30323437,33,2025-02-25 11:57:58.573669,2025-02-25 11:58:41.663725,43.090056
channel-750,683740,30323414,30323419,5,2025-02-25 11:58:12.782579,2025-02-25 11:58:18.451382,5.668803
channel-750,683741,30323422,30323434,12,2025-02-25 11:58:22.859338,2025-02-25 11:58:38.308216,15.448878
channel-750,683742,30323425,30323430,5,2025-02-25 11:58:26.203183,2025-02-25 11:58:32.639049,6.435866
channel-750,683743,30323446,30323450,4,2025-02-25 11:58:51.609707,2025-02-25 11:58:56.168562,4.558855
channel-750,683744,30323448,30323457,9,2025-02-25 11:58:53.824279,2025-02-25 11:59:06.812289,12.98801
channel-750,683745,30323452,30323457,5,2025-02-25 11:58:59.669964,2025-02-25 11:59:06.812289,7.142325
channel-750,683746,30323464,30323481,17,2025-02-25 11:59:16.275919,2025-02-25 11:59:36.828014,20.552095
channel-750,683747,30323470,30323496,26,2025-02-25 11:59:23.275076,2025-02-25 11:59:55.879178,32.604102
channel-750,683748,30323475,30323479,4,2025-02-25 11:59:29.024817,2025-02-25 11:59:34.626583,5.601766
channel-750,683749,30323476,30323487,11,2025-02-25 11:59:30.225133,2025-02-25 11:59:43.689758,13.464625
channel-750,683750,30323486,30323502,16,2025-02-25 11:59:42.518657,2025-02-25 12:00:05.480521,22.961864
channel-750,683751,30323489,30323494,5,2025-02-25 11:59:45.896301,2025-02-25 11:59:53.552335,7.656034
channel-750,683752,30323491,30323506,15,2025-02-25 11:59:49.702364,2025-02-25 12:00:11.009453,21.307089
channel-750,683753,30323493,30323501,8,2025-02-25 11:59:51.903257,2025-02-25 12:00:04.046574,12.143317
channel-750,683754,30323521,30323530,9,2025-02-25 12:00:28.710894,2025-02-25 12:00:39.859124,11.14823
channel-750,683755,30323529,30323546,17,2025-02-25 12:00:38.698604,2025-02-25 12:00:59.585818,20.887214
channel-750,683756,30323531,30323541,10,2025-02-25 12:00:41.406567,2025-02-25 12:00:52.870836,11.464269
channel-750,683757,30323552,30323563,11,2025-02-25 12:01:07.660841,2025-02-25 12:01:21.312286,13.651445
channel-750,683758,30323573,30323587,14,2025-02-25 12:01:37.884644,2025-02-25 12:01:55.242925,17.358281
channel-750,683759,30323590,30323606,16,2025-02-25 12:01:59.217531,2025-02-25 12:02:20.942512,21.724981
channel-750,683760,30323606,30323611,5,2025-02-25 12:02:20.942512,2025-02-25 12:02:27.046715,6.104203
channel-750,683761,30323643,30323659,16,2025-02-25 12:03:06.344376,2025-02-25 12:03:26.423791,20.079415
channel-750,683762,30323651,30323669,18,2025-02-25 12:03:16.869539,2025-02-25 12:03:40.791365,23.921826
channel-750,683763,30323674,30323679,5,2025-02-25 12:03:48.904832,2025-02-25 12:03:54.794998,5.890166
channel-750,683764,30323694,30323717,23,2025-02-25 12:04:13.889098,2025-02-25 12:04:42.881153,28.992055
channel-750,683765,30323727,30323732,5,2025-02-25 12:04:56.898088,2025-02-25 12:05:02.628813,5.730725
channel-750,683766,30323747,30323752,5,2025-02-25 12:05:22.622055,2025-02-25 12:05:28.380123,5.758068
channel-750,683767,30323771,30323781,10,2025-02-25 12:05:50.605938,2025-02-25 12:06:06.208252,15.602314
channel-750,683768,30323817,30323827,10,2025-02-25 12:06:52.003650,2025-02-25 12:07:05.126808,13.123158
channel-750,683769,30323820,30323825,5,2025-02-25 12:06:55.487418,2025-02-25 12:07:02.782574,7.295156
channel-750,683770,30323824,30323829,5,2025-02-25 12:07:01.097734,2025-02-25 12:07:07.520278,6.422544
channel-750,683771,30323839,30323844,5,2025-02-25 12:07:20.365930,2025-02-25 12:07:29.022112,8.656182
channel-750,683772,30323852,30323876,24,2025-02-25 12:07:38.044961,2025-02-25 12:08:06.626466,28.581505
channel-750,683773,30323878,30323882,4,2025-02-25 12:08:08.789076,2025-02-25 12:08:13.760571,4.971495
channel-750,683774,30323883,30323888,5,2025-02-25 12:08:14.974344,2025-02-25 12:08:21.802884,6.82854
channel-750,683775,30323884,30323901,17,2025-02-25 12:08:16.032978,2025-02-25 12:08:38.712808,22.67983
channel-750,683776,30323889,30323899,10,2025-02-25 12:08:23.057513,2025-02-25 12:08:35.166783,12.10927
channel-750,683777,30323914,30323926,12,2025-02-25 12:08:53.244344,2025-02-25 12:09:14.334832,21.090488
channel-750,683778,30323915,30323934,19,2025-02-25 12:08:54.337832,2025-02-25 12:09:24.275419,29.937587
channel-750,683779,30323928,30323939,11,2025-02-25 12:09:17.597795,2025-02-25 12:09:32.139648,14.541853
channel-750,683780,30323936,30323940,4,2025-02-25 12:09:28.630362,2025-02-25 12:09:33.403932,4.77357
channel-750,683781,30323947,30323958,11,2025-02-25 12:09:41.472696,2025-02-25 12:09:55.809420,14.336724
channel-750,683782,30323967,30323978,11,2025-02-25 12:10:06.872593,2025-02-25 12:10:23.973255,17.100662
channel-750,683783,30323967,30323982,15,2025-02-25 12:10:06.872593,2025-02-25 12:10:29.544001,22.671408
channel-750,683784,30323970,30324007,37,2025-02-25 12:10:11.441994,2025-02-25 12:11:00.149931,48.707937
channel-750,683785,30323972,30323981,9,2025-02-25 12:10:13.732368,2025-02-25 12:10:28.259136,14.526768
channel-750,683786,30323975,30323992,17,2025-02-25 12:10:17.353761,2025-02-25 12:10:42.747800,25.394039
channel-750,683787,30323976,30323982,6,2025-02-25 12:10:18.487034,2025-02-25 12:10:29.544001,11.056967
channel-750,683788,30323978,30323993,15,2025-02-25 12:10:23.973255,2025-02-25 12:10:43.799418,19.826163
channel-750,683789,30323981,30324013,32,2025-02-25 12:10:28.259136,2025-02-25 12:11:08.480675,40.221539
channel-750,683790,30323986,30324000,14,2025-02-25 12:10:35.512338,2025-02-25 12:10:51.758188,16.24585
channel-750,683791,30324004,30324008,4,2025-02-25 12:10:56.682369,2025-02-25 12:11:01.186758,4.504389
channel-750,683792,30324041,30324064,23,2025-02-25 12:11:44.645720,2025-02-25 12:12:14.393777,29.748057
channel-750,683793,30324101,30324122,21,2025-02-25 12:13:01.602644,2025-02-25 12:13:29.122650,27.520006
channel-750,683794,30324105,30324109,4,2025-02-25 12:13:06.250559,2025-02-25 12:13:11.684407,5.433848
channel-750,683795,30324117,30324122,5,2025-02-25 12:13:22.581921,2025-02-25 12:13:29.122650,6.540729
channel-750,683796,30324131,30324141,10,2025-02-25 12:13:42.634599,2025-02-25 12:13:54.098719,11.46412
channel-750,683797,30324135,30324156,21,2025-02-25 12:13:47.284703,2025-02-25 12:14:14.150005,26.865302
channel-750,683798,30324137,30324154,17,2025-02-25 12:13:49.542098,2025-02-25 12:14:11.610763,22.068665
channel-750,683799,30324142,30324158,16,2025-02-25 12:13:56.256150,2025-02-25 12:14:16.599267,20.343117
channel-750,683800,30324144,30324156,12,2025-02-25 12:13:58.372148,2025-02-25 12:14:14.150005,15.777857
channel-750,683801,30324150,30324154,4,2025-02-25 12:14:05.367483,2025-02-25 12:14:11.610763,6.24328
channel-750,683802,30324161,30324192,31,2025-02-25 12:14:20.055321,2025-02-25 12:15:00.654477,40.599156
channel-750,683803,30324169,30324179,10,2025-02-25 12:14:30.429468,2025-02-25 12:14:43.713376,13.283908
channel-750,683804,30324176,30324190,14,2025-02-25 12:14:38.998200,2025-02-25 12:14:58.521418,19.523218
channel-750,683805,30324202,30324207,5,2025-02-25 12:15:15.282968,2025-02-25 12:15:20.998562,5.715594
channel-750,683806,30324204,30324215,11,2025-02-25 12:15:17.544181,2025-02-25 12:15:29.940656,12.396475
channel-750,683807,30324208,30324214,6,2025-02-25 12:15:22.099249,2025-02-25 12:15:28.828185,6.728936
channel-750,683809,30324226,30324242,16,2025-02-25 12:15:44.491443,2025-02-25 12:16:05.237815,20.746372
channel-750,683810,30324226,30324231,5,2025-02-25 12:15:44.491443,2025-02-25 12:15:50.673918,6.182475
channel-750,683811,30324233,30324238,5,2025-02-25 12:15:53.852124,2025-02-25 12:15:59.685727,5.833603
channel-750,683813,30324353,30324370,17,2025-02-25 12:18:26.327020,2025-02-25 12:18:53.226654,26.899634
channel-750,683814,30324356,30324362,6,2025-02-25 12:18:30.738168,2025-02-25 12:18:42.252661,11.514493
channel-750,683815,30324370,30324387,17,2025-02-25 12:18:53.226654,2025-02-25 12:19:15.804960,22.578306
channel-750,683816,30324412,30324436,24,2025-02-25 12:19:50.096594,2025-02-25 12:20:21.178038,31.081444
channel-750,683817,30324412,30324422,10,2025-02-25 12:19:50.096594,2025-02-25 12:20:04.861708,14.765114
channel-750,683818,30324474,30324494,20,2025-02-25 12:21:10.033803,2025-02-25 12:21:34.591418,24.557615
channel-750,683819,30324494,30324499,5,2025-02-25 12:21:34.591418,2025-02-25 12:21:41.242444,6.651026
channel-750,683820,30324500,30324510,10,2025-02-25 12:21:42.300889,2025-02-25 12:21:54.040996,11.740107
channel-750,683821,30324558,30324573,15,2025-02-25 12:22:55.616173,2025-02-25 12:23:13.880190,18.264017
channel-750,683822,30324585,30324602,17,2025-02-25 12:23:30.429910,2025-02-25 12:23:55.943842,25.513932
channel-750,683823,30324604,30324620,16,2025-02-25 12:23:58.298444,2025-02-25 12:24:20.730557,22.432113
channel-750,683824,30324608,30324624,16,2025-02-25 12:24:03.710389,2025-02-25 12:24:25.523717,21.813328
channel-750,683825,30324618,30324626,8,2025-02-25 12:24:18.515391,2025-02-25 12:24:28.073831,9.55844
channel-750,683826,30324626,30324632,6,2025-02-25 12:24:28.073831,2025-02-25 12:24:34.839383,6.765552
channel-750,683827,30324642,30324673,31,2025-02-25 12:24:46.613256,2025-02-25 12:25:25.113283,38.500027
channel-750,683828,30324648,30324656,8,2025-02-25 12:24:54.017715,2025-02-25 12:25:03.347522,9.329807
channel-750,683829,30324681,30324698,17,2025-02-25 12:25:35.245644,2025-02-25 12:26:00.518359,25.272715
channel-750,683830,30324686,30324718,32,2025-02-25 12:25:41.897440,2025-02-25 12:26:30.835069,48.937629
channel-750,683831,30324712,30324722,10,2025-02-25 12:26:24.039705,2025-02-25 12:26:35.432401,11.392696
channel-750,683832,30324718,30324728,10,2025-02-25 12:26:30.835069,2025-02-25 12:26:42.551175,11.716106
channel-750,683833,30324754,30324777,23,2025-02-25 12:27:16.665201,2025-02-25 12:27:45.202947,28.537746
channel-750,683834,30324794,30324798,4,2025-02-25 12:28:08.396150,2025-02-25 12:28:14.041746,5.645596
channel-750,683835,30324859,30324864,5,2025-02-25 12:29:34.059541,2025-02-25 12:29:41.798039,7.738498
channel-750,683836,30325014,30325017,3,2025-02-25 12:32:51.955623,2025-02-25 12:32:55.373712,3.418089
channel-750,683837,30325030,30325044,14,2025-02-25 12:33:13.575008,2025-02-25 12:33:32.688735,19.113727
channel-750,683838,30325097,30325104,7,2025-02-25 12:34:41.258334,2025-02-25 12:34:50.900619,9.642285
channel-750,683839,30325104,30325120,16,2025-02-25 12:34:50.900619,2025-02-25 12:35:10.893435,19.992816
channel-750,683840,30325150,30325156,6,2025-02-25 12:35:50.713055,2025-02-25 12:35:57.381401,6.668346
channel-750,683841,30325161,30325170,9,2025-02-25 12:36:03.645427,2025-02-25 12:36:14.953286,11.307859
channel-750,683842,30325208,30325231,23,2025-02-25 12:37:03.148806,2025-02-25 12:37:33.500501,30.351695
channel-750,683843,30325275,30325280,5,2025-02-25 12:38:32.426002,2025-02-25 12:38:38.426071,6.000069
channel-750,683844,30325328,30325332,4,2025-02-25 12:39:40.885363,2025-02-25 12:39:46.646384,5.761021
channel-750,683845,30325360,30325369,9,2025-02-25 12:40:22.594742,2025-02-25 12:40:32.753306,10.158564
channel-750,683846,30325447,30325464,17,2025-02-25 12:42:17.172464,2025-02-25 12:42:36.770957,19.598493
channel-750,683847,30325510,30325525,15,2025-02-25 12:43:38.896247,2025-02-25 12:43:56.292451,17.396204
channel-750,683848,30325516,30325522,6,2025-02-25 12:43:45.760010,2025-02-25 12:43:52.808035,7.048025
channel-750,683849,30325523,30325542,19,2025-02-25 12:43:53.940448,2025-02-25 12:44:17.670935,23.730487
channel-750,683850,30325563,30325580,17,2025-02-25 12:44:45.828286,2025-02-25 12:45:07.665762,21.837476
channel-750,683851,30325585,30325594,9,2025-02-25 12:45:14.745429,2025-02-25 12:45:26.227227,11.481798
channel-750,683852,30325590,30325595,5,2025-02-25 12:45:21.648675,2025-02-25 12:45:27.615765,5.96709
channel-750,683853,30325620,30325626,6,2025-02-25 12:45:59.197566,2025-02-25 12:46:06.304202,7.106636
channel-750,683854,30325650,30325659,9,2025-02-25 12:46:39.926266,2025-02-25 12:46:50.756673,10.830407
channel-750,683855,30325694,30325703,9,2025-02-25 12:47:39.408202,2025-02-25 12:47:49.772488,10.364286
channel-750,683856,30325706,30325716,10,2025-02-25 12:47:53.789159,2025-02-25 12:48:05.385691,11.596532
channel-750,683857,30325720,30325729,9,2025-02-25 12:48:10.938844,2025-02-25 12:48:23.655156,12.716312
channel-750,683858,30325744,30325755,11,2025-02-25 12:48:43.764556,2025-02-25 12:48:57.321750,13.557194
channel-750,683859,30325818,30325827,9,2025-02-25 12:50:17.454364,2025-02-25 12:50:29.025411,11.571047
channel-750,683860,30325821,30325826,5,2025-02-25 12:50:20.945459,2025-02-25 12:50:27.980087,7.034628
channel-750,683861,30325837,30325851,14,2025-02-25 12:50:41.836669,2025-02-25 12:50:58.578879,16.74221
channel-750,683862,30325978,30325990,12,2025-02-25 12:53:43.550393,2025-02-25 12:54:00.585377,17.034984
channel-750,683863,30326059,30326072,13,2025-02-25 12:55:32.783969,2025-02-25 12:55:49.868742,17.084773
channel-750,683864,30326093,30326110,17,2025-02-25 12:56:16.233780,2025-02-25 12:56:41.057906,24.824126
channel-750,683865,30326114,30326143,29,2025-02-25 12:56:45.607142,2025-02-25 12:57:21.197896,35.590754
channel-750,683866,30326177,30326182,5,2025-02-25 12:58:04.477313,2025-02-25 12:58:11.873619,7.396306
channel-750,683867,30326212,30326221,9,2025-02-25 12:58:52.299082,2025-02-25 12:59:03.844527,11.545445
channel-750,683868,30326212,30326222,10,2025-02-25 12:58:52.299082,2025-02-25 12:59:05.033458,12.734376
channel-750,683869,30326239,30326246,7,2025-02-25 12:59:26.241274,2025-02-25 12:59:38.067547,11.826273
channel-750,683870,30326244,30326256,12,2025-02-25 12:59:32.132466,2025-02-25 12:59:50.510771,18.378305
channel-750,683871,30326255,30326268,13,2025-02-25 12:59:49.474357,2025-02-25 13:00:10.218003,20.743646
channel-750,683872,30326261,30326273,12,2025-02-25 12:59:57.388217,2025-02-25 13:00:19.008894,21.620677
channel-750,683873,30326265,30326274,9,2025-02-25 13:00:02.670760,2025-02-25 13:00:20.338160,17.6674
channel-750,683874,30326272,30326277,5,2025-02-25 13:00:17.845701,2025-02-25 13:00:23.879665,6.033964
channel-750,683875,30326323,30326328,5,2025-02-25 13:01:22.483132,2025-02-25 13:01:28.222819,5.739687
channel-750,683876,30326334,30326350,16,2025-02-25 13:01:35.677237,2025-02-25 13:01:54.171172,18.493935
channel-750,683877,30326352,30326357,5,2025-02-25 13:01:56.687174,2025-02-25 13:02:05.365998,8.678824
channel-750,683878,30326367,30326373,6,2025-02-25 13:02:18.115731,2025-02-25 13:02:25.075264,6.959533
channel-750,683879,30326367,30326381,14,2025-02-25 13:02:18.115731,2025-02-25 13:02:34.670886,16.555155
channel-750,683880,30326588,30331661,5073,2025-02-25 13:07:00.627927,2025-02-25 14:57:01.792945,6601.165018
channel-750,683881,30326592,30326605,13,2025-02-25 13:07:05.321922,2025-02-25 13:07:21.974851,16.652929
channel-750,683882,30326594,30326607,13,2025-02-25 13:07:08.077853,2025-02-25 13:07:24.494483,16.41663
channel-750,683883,30326607,30326611,4,2025-02-25 13:07:24.494483,2025-02-25 13:07:29.140130,4.645647
channel-750,683884,30326608,30326630,22,2025-02-25 13:07:25.715514,2025-02-25 13:07:56.122737,30.407223
channel-750,683885,30326613,30326622,9,2025-02-25 13:07:33.960726,2025-02-25 13:07:45.402806,11.44208
channel-750,683886,30326641,30326651,10,2025-02-25 13:08:09.857866,2025-02-25 13:08:21.983173,12.125307
channel-750,683887,30326671,30326688,17,2025-02-25 13:08:47.127256,2025-02-25 13:09:11.518153,24.390897
channel-750,683888,30326693,30326697,4,2025-02-25 13:09:19.071399,2025-02-25 13:09:24.546115,5.474716
channel-750,683889,30326725,30326747,22,2025-02-25 13:09:59.861886,2025-02-25 13:10:29.384220,29.522334
channel-750,683890,30326746,30326756,10,2025-02-25 13:10:28.254460,2025-02-25 13:10:40.308614,12.054154
channel-750,683891,30326752,30326763,11,2025-02-25 13:10:35.533253,2025-02-25 13:10:49.123083,13.58983
channel-750,683892,30326757,30326771,14,2025-02-25 13:10:41.541857,2025-02-25 13:10:58.814072,17.272215
channel-750,683893,30326762,30326777,15,2025-02-25 13:10:48.014757,2025-02-25 13:11:05.655408,17.640651
channel-750,683894,30326778,30326798,20,2025-02-25 13:11:06.849009,2025-02-25 13:11:33.255864,26.406855
channel-750,683895,30326778,30326782,4,2025-02-25 13:11:06.849009,2025-02-25 13:11:12.934561,6.085552
channel-750,683896,30326818,30326832,14,2025-02-25 13:11:58.135850,2025-02-25 13:12:15.303475,17.167625
channel-750,683897,30326977,30326982,5,2025-02-25 13:15:26.596560,2025-02-25 13:15:32.281489,5.684929
channel-750,683898,30327046,30327051,5,2025-02-25 13:16:52.803087,2025-02-25 13:17:01.066242,8.263155
channel-750,683899,30327079,30327093,14,2025-02-25 13:17:38.839158,2025-02-25 13:17:56.891053,18.051895
channel-750,683900,30327082,30327089,7,2025-02-25 13:17:43.356306,2025-02-25 13:17:51.570189,8.213883
channel-750,683901,30327092,30327097,5,2025-02-25 13:17:55.450378,2025-02-25 13:18:01.644146,6.193768
channel-750,683902,30327099,30327108,9,2025-02-25 13:18:04.008431,2025-02-25 13:18:14.458180,10.449749
channel-750,683903,30327230,30327246,16,2025-02-25 13:20:55.131225,2025-02-25 13:21:14.529725,19.3985
channel-750,683904,30327267,30327280,13,2025-02-25 13:21:38.875216,2025-02-25 13:21:55.523508,16.648292
channel-750,683905,30327430,30327435,5,2025-02-25 13:25:11.651381,2025-02-25 13:25:17.456130,5.804749
channel-750,683906,30327436,30327471,35,2025-02-25 13:25:18.584534,2025-02-25 13:26:02.002387,43.417853
channel-750,683907,30327505,30327509,4,2025-02-25 13:26:49.060394,2025-02-25 13:26:53.728416,4.668022
channel-750,683908,30327576,30327586,10,2025-02-25 13:28:24.691370,2025-02-25 13:28:36.718735,12.027365
channel-750,683909,30327645,30327653,8,2025-02-25 13:29:52.571267,2025-02-25 13:30:02.518930,9.947663
channel-750,683910,30327735,30327739,4,2025-02-25 13:31:49.540256,2025-02-25 13:31:56.625163,7.084907
channel-750,683911,30327752,30327756,4,2025-02-25 13:32:13.353361,2025-02-25 13:32:18.928413,5.575052
channel-750,683912,30327756,30327771,15,2025-02-25 13:32:18.928413,2025-02-25 13:32:37.697077,18.768664
channel-750,683913,30327770,30327776,6,2025-02-25 13:32:36.480790,2025-02-25 13:32:43.300046,6.819256
channel-750,683914,30327834,30327840,6,2025-02-25 13:33:58.786622,2025-02-25 13:34:06.143494,7.356872
channel-750,683915,30327843,30327848,5,2025-02-25 13:34:09.632388,2025-02-25 13:34:15.239759,5.607371
channel-750,683916,30327881,30327895,14,2025-02-25 13:34:56.735366,2025-02-25 13:35:13.699949,16.964583
channel-750,683917,30327966,30327978,12,2025-02-25 13:36:47.372585,2025-02-25 13:37:03.446615,16.07403
channel-750,683918,30327968,30327973,5,2025-02-25 13:36:50.823986,2025-02-25 13:36:56.794260,5.970274
channel-750,683919,30327971,30327976,5,2025-02-25 13:36:54.469780,2025-02-25 13:37:00.146748,5.676968
channel-750,683920,30327994,30327999,5,2025-02-25 13:37:23.933495,2025-02-25 13:37:31.447919,7.514424
channel-750,683921,30327996,30327999,3,2025-02-25 13:37:26.662866,2025-02-25 13:37:31.447919,4.785053
channel-750,683922,30328015,30328021,6,2025-02-25 13:37:52.029029,2025-02-25 13:37:58.751248,6.722219
channel-750,683923,30328015,30328033,18,2025-02-25 13:37:52.029029,2025-02-25 13:38:13.476635,21.447606
channel-750,683924,30328050,30328075,25,2025-02-25 13:38:36.781707,2025-02-25 13:39:07.848946,31.067239
channel-750,683925,30328063,30328068,5,2025-02-25 13:38:52.716605,2025-02-25 13:38:58.575495,5.85889
channel-750,683926,30328064,30328085,21,2025-02-25 13:38:53.959199,2025-02-25 13:39:20.660776,26.701577
channel-750,683927,30328068,30328081,13,2025-02-25 13:38:58.575495,2025-02-25 13:39:15.718020,17.142525
channel-750,683928,30328104,30328114,10,2025-02-25 13:39:45.925206,2025-02-25 13:39:59.890142,13.964936
channel-750,683929,30328132,30328141,9,2025-02-25 13:40:25.917759,2025-02-25 13:40:36.262798,10.345039
channel-750,683930,30328150,30328157,7,2025-02-25 13:40:49.403977,2025-02-25 13:40:57.603794,8.199817
channel-750,683931,30328273,30328278,5,2025-02-25 13:43:24.184967,2025-02-25 13:43:31.606176,7.421209
channel-750,683932,30328284,30328290,6,2025-02-25 13:43:38.649247,2025-02-25 13:43:47.681620,9.032373
channel-750,683933,30328299,30328310,11,2025-02-25 13:43:57.864582,2025-02-25 13:44:12.181043,14.316461
channel-750,683934,30328324,30328332,8,2025-02-25 13:44:28.758000,2025-02-25 13:44:38.261429,9.503429
channel-750,683935,30328354,30328359,5,2025-02-25 13:45:08.026387,2025-02-25 13:45:17.667776,9.641389
channel-750,683936,30328355,30328359,4,2025-02-25 13:45:09.537566,2025-02-25 13:45:17.667776,8.13021
channel-750,683937,30328418,30328422,4,2025-02-25 13:46:31.493223,2025-02-25 13:46:37.123600,5.630377
channel-750,683938,30328520,30328537,17,2025-02-25 13:48:43.310548,2025-02-25 13:49:04.488858,21.17831
channel-750,683939,30328521,30328526,5,2025-02-25 13:48:44.490756,2025-02-25 13:48:50.318085,5.827329
channel-750,683940,30328562,30328574,12,2025-02-25 13:49:35.832374,2025-02-25 13:49:56.122629,20.290255
channel-750,683941,30328607,30328611,4,2025-02-25 13:50:38.970860,2025-02-25 13:50:45.205051,6.234191
channel-750,683942,30328637,30328654,17,2025-02-25 13:51:19.618250,2025-02-25 13:51:39.763067,20.144817
channel-750,683943,30328637,30328646,9,2025-02-25 13:51:19.618250,2025-02-25 13:51:30.642577,11.024327
channel-750,683944,30328760,30328765,5,2025-02-25 13:53:54.244587,2025-02-25 13:54:03.285932,9.041345
channel-750,683945,30328839,30328845,6,2025-02-25 13:55:36.785996,2025-02-25 13:55:45.359980,8.573984
channel-750,683946,30328876,30328881,5,2025-02-25 13:56:25.933567,2025-02-25 13:56:31.388513,5.454946
channel-750,683947,30328891,30328903,12,2025-02-25 13:56:45.021204,2025-02-25 13:57:01.328811,16.307607
channel-750,683948,30328917,30328925,8,2025-02-25 13:57:18.931131,2025-02-25 13:57:28.295439,9.364308
channel-750,683949,30328974,30328987,13,2025-02-25 13:58:34.236399,2025-02-25 13:58:54.296643,20.060244
channel-750,683950,30329051,30329056,5,2025-02-25 14:00:16.983437,2025-02-25 14:00:22.712742,5.729305
channel-750,683951,30329054,30329058,4,2025-02-25 14:00:20.433646,2025-02-25 14:00:26.141147,5.707501
channel-750,683952,30329066,30329075,9,2025-02-25 14:00:36.573846,2025-02-25 14:00:47.928140,11.354294
channel-750,683953,30329474,30329479,5,2025-02-25 14:09:26.598693,2025-02-25 14:09:32.199987,5.601294
channel-750,683954,30329496,30329505,9,2025-02-25 14:09:52.563457,2025-02-25 14:10:04.688342,12.124885
channel-750,683955,30329540,30329559,19,2025-02-25 14:10:47.488417,2025-02-25 14:11:12.778648,25.290231
channel-750,683956,30329575,30329588,13,2025-02-25 14:11:36.270469,2025-02-25 14:11:52.827790,16.557321
channel-750,683957,30329641,30329645,4,2025-02-25 14:13:01.812689,2025-02-25 14:13:07.591766,5.779077
channel-750,683958,30329789,30329811,22,2025-02-25 14:16:14.741961,2025-02-25 14:16:43.642315,28.900354
channel-750,683959,30329818,30329828,10,2025-02-25 14:16:55.213362,2025-02-25 14:17:09.453247,14.239885
channel-750,683960,30329877,30329893,16,2025-02-25 14:18:12.894533,2025-02-25 14:18:32.521912,19.627379
channel-750,683961,30329915,30329940,25,2025-02-25 14:19:01.228387,2025-02-25 14:19:33.245748,32.017361
channel-750,683962,30329982,30329990,8,2025-02-25 14:20:26.262936,2025-02-25 14:20:36.813936,10.551
channel-750,683963,30330077,30330092,15,2025-02-25 14:22:35.215793,2025-02-25 14:22:53.852776,18.636983
channel-750,683964,30330081,30330095,14,2025-02-25 14:22:39.756980,2025-02-25 14:22:57.279990,17.52301
channel-750,683965,30330099,30330103,4,2025-02-25 14:23:01.846384,2025-02-25 14:23:06.671827,4.825443
channel-750,683966,30330169,30330182,13,2025-02-25 14:24:27.069152,2025-02-25 14:24:45.659880,18.590728
channel-750,683967,30330204,30330208,4,2025-02-25 14:25:13.767910,2025-02-25 14:25:19.664263,5.896353
channel-750,683968,30330204,30330216,12,2025-02-25 14:25:13.767910,2025-02-25 14:25:28.637605,14.869695
channel-750,683969,30330259,30330264,5,2025-02-25 14:26:31.305964,2025-02-25 14:26:37.029973,5.724009
channel-750,683970,30330517,30330521,4,2025-02-25 14:32:06.619180,2025-02-25 14:32:11.722717,5.103537
channel-750,683971,30330529,30330535,6,2025-02-25 14:32:21.815302,2025-02-25 14:32:28.614218,6.798916
channel-750,683972,30330619,30330631,12,2025-02-25 14:34:19.392040,2025-02-25 14:34:35.205884,15.813844
channel-750,683973,30330629,30330633,4,2025-02-25 14:34:31.895345,2025-02-25 14:34:37.511508,5.616163
channel-750,683974,30330661,30330672,11,2025-02-25 14:35:13.295920,2025-02-25 14:35:27.028948,13.733028
channel-750,683975,30330688,30330702,14,2025-02-25 14:35:48.588508,2025-02-25 14:36:05.944127,17.355619
channel-750,683976,30330729,30330733,4,2025-02-25 14:36:41.057161,2025-02-25 14:36:47.616213,6.559052
channel-750,683977,30330840,30330843,3,2025-02-25 14:39:02.744422,2025-02-25 14:39:07.285380,4.540958
channel-750,683978,30330881,30330900,19,2025-02-25 14:39:59.611407,2025-02-25 14:40:22.442365,22.830958
channel-750,683979,30330946,30330950,4,2025-02-25 14:41:23.538619,2025-02-25 14:41:32.847775,9.309156
channel-750,683980,30331022,30331034,12,2025-02-25 14:43:04.253468,2025-02-25 14:43:18.304069,14.050601
channel-750,683981,30331022,30331038,16,2025-02-25 14:43:04.253468,2025-02-25 14:43:24.290757,20.037289
channel-750,683982,30331024,30331037,13,2025-02-25 14:43:06.781252,2025-02-25 14:43:21.616398,14.835146
channel-750,683983,30331040,30331049,9,2025-02-25 14:43:26.868609,2025-02-25 14:43:40.875067,14.006458
channel-750,683984,30331054,30331060,6,2025-02-25 14:43:46.504360,2025-02-25 14:43:57.924047,11.419687
channel-750,683985,30331060,30331071,11,2025-02-25 14:43:57.924047,2025-02-25 14:44:12.790343,14.866296
channel-750,683986,30331132,30331141,9,2025-02-25 14:45:30.888845,2025-02-25 14:45:43.047657,12.158812
channel-750,683987,30331207,30331212,5,2025-02-25 14:47:07.066112,2025-02-25 14:47:17.038264,9.972152
channel-750,683988,30331223,30331227,4,2025-02-25 14:47:31.301487,2025-02-25 14:47:35.815338,4.513851
channel-750,683989,30331226,30331236,10,2025-02-25 14:47:34.610489,2025-02-25 14:47:46.330311,11.719822
channel-750,683990,30331268,30331280,12,2025-02-25 14:48:30.833792,2025-02-25 14:48:47.039727,16.205935
channel-750,683991,30331333,30331343,10,2025-02-25 14:49:53.060650,2025-02-25 14:50:06.974427,13.913777
channel-750,683992,30331346,30331351,5,2025-02-25 14:50:11.066774,2025-02-25 14:50:16.800536,5.733762
channel-750,683993,30331375,30331379,4,2025-02-25 14:50:47.098165,2025-02-25 14:50:52.917540,5.819375
channel-750,683994,30331416,30331425,9,2025-02-25 14:51:43.484564,2025-02-25 14:51:55.216934,11.73237
channel-750,683995,30331460,30331474,14,2025-02-25 14:52:37.979206,2025-02-25 14:52:59.968825,21.989619
channel-750,683996,30331470,30331475,5,2025-02-25 14:52:55.243855,2025-02-25 14:53:01.089989,5.846134
channel-750,683997,30331472,30331496,24,2025-02-25 14:52:57.627483,2025-02-25 14:53:28.600699,30.973216
channel-750,683998,30331493,30331498,5,2025-02-25 14:53:25.247687,2025-02-25 14:53:30.861688,5.614001
channel-750,683999,30331539,30331546,7,2025-02-25 14:54:24.504734,2025-02-25 14:54:33.632090,9.127356
channel-750,684000,30331578,30331581,3,2025-02-25 14:55:17.197793,2025-02-25 14:55:22.025083,4.82729
channel-750,684001,30331594,30331605,11,2025-02-25 14:55:37.059819,2025-02-25 14:55:52.194905,15.135086
channel-750,684002,30331599,30331609,10,2025-02-25 14:55:45.126040,2025-02-25 14:55:57.499684,12.373644
channel-750,684003,30331604,30331608,4,2025-02-25 14:55:50.965749,2025-02-25 14:55:55.776787,4.811038
channel-750,684004,30331635,30331647,12,2025-02-25 14:56:29.907524,2025-02-25 14:56:44.246456,14.338932
channel-750,684005,30331678,30331682,4,2025-02-25 14:57:21.785605,2025-02-25 14:57:32.424238,10.638633
channel-750,684006,30331754,30331759,5,2025-02-25 14:59:09.547188,2025-02-25 14:59:15.288377,5.741189
channel-750,684007,30331783,30331788,5,2025-02-25 14:59:45.594372,2025-02-25 14:59:52.342616,6.748244
channel-750,684008,30331849,30331854,5,2025-02-25 15:01:12.334408,2025-02-25 15:01:18.327993,5.993585
channel-750,684009,30331943,30331948,5,2025-02-25 15:03:16.783164,2025-02-25 15:03:22.345290,5.562126
channel-750,684010,30331959,30331975,16,2025-02-25 15:03:35.042248,2025-02-25 15:03:55.621971,20.579723
channel-750,684011,30331962,30331975,13,2025-02-25 15:03:38.550170,2025-02-25 15:03:55.621971,17.071801
channel-750,684012,30331965,30331975,10,2025-02-25 15:03:42.179975,2025-02-25 15:03:55.621971,13.441996
channel-750,684013,30331988,30331994,6,2025-02-25 15:04:14.791854,2025-02-25 15:04:21.923391,7.131537
channel-750,684014,30331990,30331998,8,2025-02-25 15:04:17.051209,2025-02-25 15:04:28.459867,11.408658
channel-750,684015,30332207,30332217,10,2025-02-25 15:09:03.019113,2025-02-25 15:09:15.361041,12.341928
channel-750,684016,30332207,30332211,4,2025-02-25 15:09:03.019113,2025-02-25 15:09:08.557065,5.537952
channel-750,684017,30332246,30332250,4,2025-02-25 15:09:55.581611,2025-02-25 15:10:01.185178,5.603567
channel-750,684018,30332290,30332300,10,2025-02-25 15:10:52.514682,2025-02-25 15:11:07.606156,15.091474
channel-750,684019,30332387,30332396,9,2025-02-25 15:13:01.087464,2025-02-25 15:13:11.487259,10.399795
channel-750,684020,30332441,30332455,14,2025-02-25 15:14:11.647457,2025-02-25 15:14:32.369291,20.721834
channel-750,684021,30332468,30332483,15,2025-02-25 15:14:49.653414,2025-02-25 15:15:09.448918,19.795504
channel-750,684022,30332712,30332719,7,2025-02-25 15:20:12.109554,2025-02-25 15:20:19.968926,7.859372
channel-750,684023,30332723,30332727,4,2025-02-25 15:20:28.681221,2025-02-25 15:20:34.362659,5.681438
channel-750,684024,30332750,30332761,11,2025-02-25 15:21:03.474713,2025-02-25 15:21:18.316219,14.841506
channel-750,684025,30332773,30332787,14,2025-02-25 15:21:35.545124,2025-02-25 15:21:51.689190,16.144066
channel-750,684026,30332774,30332790,16,2025-02-25 15:21:36.733603,2025-02-25 15:21:56.271757,19.538154
channel-750,684027,30332796,30332809,13,2025-02-25 15:22:04.019472,2025-02-25 15:22:19.944774,15.925302
channel-750,684028,30332802,30332812,10,2025-02-25 15:22:11.605445,2025-02-25 15:22:24.555031,12.949586
channel-750,684029,30332815,30332830,15,2025-02-25 15:22:28.050996,2025-02-25 15:22:47.122890,19.071894
channel-750,684030,30332827,30332831,4,2025-02-25 15:22:43.602499,2025-02-25 15:22:48.787247,5.184748
channel-750,684031,30332848,30332862,14,2025-02-25 15:23:09.234128,2025-02-25 15:23:30.923286,21.689158
channel-750,684032,30332867,30332878,11,2025-02-25 15:23:37.413060,2025-02-25 15:23:51.060096,13.647036
channel-750,684033,30332876,30332887,11,2025-02-25 15:23:48.641610,2025-02-25 15:24:03.639091,14.997481
channel-750,684034,30332888,30332906,18,2025-02-25 15:24:04.866740,2025-02-25 15:24:27.326930,22.46019
channel-750,684035,30332889,30332903,14,2025-02-25 15:24:05.962912,2025-02-25 15:24:23.781077,17.818165
channel-750,684036,30332902,30332912,10,2025-02-25 15:24:22.626961,2025-02-25 15:24:35.242728,12.615767
channel-750,684037,30332907,30332920,13,2025-02-25 15:24:28.457314,2025-02-25 15:24:44.281908,15.824594
channel-750,684038,30332935,30332940,5,2025-02-25 15:25:06.750169,2025-02-25 15:25:14.087240,7.337071
channel-750,684039,30332945,30332950,5,2025-02-25 15:25:22.227976,2025-02-25 15:25:28.273494,6.045518
channel-750,684040,30332988,30333007,19,2025-02-25 15:26:16.329172,2025-02-25 15:26:40.515564,24.186392
channel-750,684041,30332993,30333007,14,2025-02-25 15:26:22.170642,2025-02-25 15:26:40.515564,18.344922
channel-750,684042,30333034,30333051,17,2025-02-25 15:27:20.092458,2025-02-25 15:27:40.032323,19.939865
channel-750,684043,30333054,30333067,13,2025-02-25 15:27:43.556766,2025-02-25 15:27:59.214188,15.657422
channel-750,684044,30333078,30333092,14,2025-02-25 15:28:13.528553,2025-02-25 15:28:32.358401,18.829848
channel-750,684045,30333100,30333110,10,2025-02-25 15:28:41.979405,2025-02-25 15:28:53.785252,11.805847
channel-750,684046,30333137,30333143,6,2025-02-25 15:29:33.972038,2025-02-25 15:29:41.318216,7.346178
channel-750,684047,30333139,30333153,14,2025-02-25 15:29:36.665394,2025-02-25 15:29:53.164443,16.499049
channel-750,684048,30333150,30333155,5,2025-02-25 15:29:49.602313,2025-02-25 15:29:55.762817,6.160504
channel-750,684049,30333238,30333253,15,2025-02-25 15:31:47.310585,2025-02-25 15:32:05.986579,18.675994
channel-750,684050,30333243,30333257,14,2025-02-25 15:31:54.330012,2025-02-25 15:32:11.549362,17.21935
channel-750,684051,30333250,30333254,4,2025-02-25 15:32:02.491633,2025-02-25 15:32:07.195027,4.703394
channel-750,684052,30333288,30333293,5,2025-02-25 15:32:49.514103,2025-02-25 15:32:57.476478,7.962375
channel-750,684053,30333331,30333348,17,2025-02-25 15:33:46.069844,2025-02-25 15:34:10.328410,24.258566
channel-750,684054,30333354,30333356,2,2025-02-25 15:34:17.223891,2025-02-25 15:34:19.517657,2.293766
channel-750,684055,30333381,30333397,16,2025-02-25 15:34:56.036936,2025-02-25 15:35:17.388103,21.351167
channel-750,684056,30333384,30333395,11,2025-02-25 15:34:59.426665,2025-02-25 15:35:14.971960,15.545295
channel-750,684057,30333401,30333415,14,2025-02-25 15:35:22.245926,2025-02-25 15:35:40.919174,18.673248
channel-750,684058,30333427,30333451,24,2025-02-25 15:35:56.227891,2025-02-25 15:36:27.205888,30.977997
channel-750,684059,30333430,30333448,18,2025-02-25 15:35:59.618269,2025-02-25 15:36:22.783444,23.165175
channel-750,684060,30333444,30333449,5,2025-02-25 15:36:17.995833,2025-02-25 15:36:23.966935,5.971102
channel-750,684061,30333449,30333464,15,2025-02-25 15:36:23.966935,2025-02-25 15:36:44.139360,20.172425
channel-750,684062,30333459,30333467,8,2025-02-25 15:36:38.293891,2025-02-25 15:36:47.478241,9.18435
channel-750,684063,30333461,30333466,5,2025-02-25 15:36:40.715384,2025-02-25 15:36:46.393688,5.678304
channel-750,684064,30333469,30333475,6,2025-02-25 15:36:54.219024,2025-02-25 15:37:02.116230,7.897206
channel-750,684065,30333479,30333512,33,2025-02-25 15:37:06.933920,2025-02-25 15:37:49.991658,43.057738
channel-750,684066,30333482,30333494,12,2025-02-25 15:37:10.448626,2025-02-25 15:37:25.761628,15.313002
channel-750,684067,30333488,30333504,16,2025-02-25 15:37:17.973337,2025-02-25 15:37:38.668448,20.695111
channel-750,684068,30333490,30333508,18,2025-02-25 15:37:21.059955,2025-02-25 15:37:45.233558,24.173603
channel-750,684069,30333490,30333495,5,2025-02-25 15:37:21.059955,2025-02-25 15:37:26.879630,5.819675
channel-750,684070,30333491,30333502,11,2025-02-25 15:37:22.143171,2025-02-25 15:37:36.346272,14.203101
channel-750,684071,30333492,30333517,25,2025-02-25 15:37:23.532284,2025-02-25 15:37:56.814708,33.282424
channel-750,684072,30333495,30333549,54,2025-02-25 15:37:26.879630,2025-02-25 15:38:39.275107,72.395477
channel-750,684073,30333496,30333508,12,2025-02-25 15:37:29.507413,2025-02-25 15:37:45.233558,15.726145
channel-750,684074,30333506,30333549,43,2025-02-25 15:37:43.090440,2025-02-25 15:38:39.275107,56.184667
channel-750,684075,30333513,30333524,11,2025-02-25 15:37:51.179979,2025-02-25 15:38:05.731716,14.551737
channel-750,684076,30333525,30333541,16,2025-02-25 15:38:10.215208,2025-02-25 15:38:29.322614,19.107406
channel-750,684077,30333526,30333546,20,2025-02-25 15:38:11.613440,2025-02-25 15:38:35.810976,24.197536
channel-750,684078,30333529,30333542,13,2025-02-25 15:38:15.210195,2025-02-25 15:38:30.426652,15.216457
channel-750,684079,30333541,30333551,10,2025-02-25 15:38:29.322614,2025-02-25 15:38:44.071364,14.74875
channel-750,684080,30333546,30333550,4,2025-02-25 15:38:35.810976,2025-02-25 15:38:41.423578,5.612602
channel-750,684081,30333556,30333585,29,2025-02-25 15:38:54.413058,2025-02-25 15:39:31.433221,37.020163
channel-750,684082,30333562,30333573,11,2025-02-25 15:39:01.851061,2025-02-25 15:39:16.420366,14.569305
channel-750,684083,30333562,30333570,8,2025-02-25 15:39:01.851061,2025-02-25 15:39:12.861346,11.010285
channel-750,684084,30333563,30333576,13,2025-02-25 15:39:02.967722,2025-02-25 15:39:20.852700,17.884978
channel-750,684085,30333565,30333577,12,2025-02-25 15:39:06.657044,2025-02-25 15:39:22.019211,15.362167
channel-750,684086,30333578,30333591,13,2025-02-25 15:39:23.258400,2025-02-25 15:39:38.736098,15.477698
channel-750,684087,30333593,30333605,12,2025-02-25 15:39:41.188844,2025-02-25 15:39:56.554330,15.365486
channel-750,684088,30333609,30333614,5,2025-02-25 15:40:01.451510,2025-02-25 15:40:08.307884,6.856374
channel-750,684089,30333622,30333642,20,2025-02-25 15:40:19.796742,2025-02-25 15:40:48.462175,28.665433
channel-750,684090,30333623,30333633,10,2025-02-25 15:40:20.854553,2025-02-25 15:40:34.057886,13.203333
channel-750,684091,30333632,30333652,20,2025-02-25 15:40:32.953436,2025-02-25 15:41:00.164978,27.211542
channel-750,684092,30333664,30333679,15,2025-02-25 15:41:17.348491,2025-02-25 15:41:34.627463,17.278972
channel-750,684093,30333665,30333670,5,2025-02-25 15:41:18.670758,2025-02-25 15:41:24.400059,5.729301
channel-750,684094,30333669,30333674,5,2025-02-25 15:41:23.314508,2025-02-25 15:41:28.805299,5.490791
channel-750,684095,30333676,30333698,22,2025-02-25 15:41:31.267618,2025-02-25 15:42:00.996736,29.729118
channel-750,684096,30333697,30333702,5,2025-02-25 15:41:59.932730,2025-02-25 15:42:06.555287,6.622557
channel-750,684097,30333701,30333719,18,2025-02-25 15:42:05.214631,2025-02-25 15:42:28.103648,22.889017
channel-750,684098,30333704,30333708,4,2025-02-25 15:42:08.885765,2025-02-25 15:42:14.504928,5.619163
channel-750,684099,30333709,30333719,10,2025-02-25 15:42:16.817085,2025-02-25 15:42:28.103648,11.286563
channel-750,684100,30333729,30333736,7,2025-02-25 15:42:42.329994,2025-02-25 15:42:52.180001,9.850007
channel-750,684101,30333730,30333747,17,2025-02-25 15:42:44.394735,2025-02-25 15:43:05.503816,21.109081
channel-750,684102,30333730,30333758,28,2025-02-25 15:42:44.394735,2025-02-25 15:43:24.223438,39.828703
channel-750,684103,30333747,30333757,10,2025-02-25 15:43:05.503816,2025-02-25 15:43:22.053174,16.549358
channel-750,684104,30333789,30333820,31,2025-02-25 15:44:02.534932,2025-02-25 15:44:43.758892,41.22396
channel-750,684105,30333847,30333865,18,2025-02-25 15:45:18.580230,2025-02-25 15:45:48.566095,29.985865
channel-750,684106,30333851,30333865,14,2025-02-25 15:45:26.611133,2025-02-25 15:45:48.566095,21.954962
channel-750,684107,30333852,30333857,5,2025-02-25 15:45:27.764312,2025-02-25 15:45:35.783138,8.018826
channel-750,684108,30333862,30333877,15,2025-02-25 15:45:41.790414,2025-02-25 15:46:04.477321,22.686907
channel-750,684109,30333868,30333878,10,2025-02-25 15:45:51.955061,2025-02-25 15:46:05.891543,13.936482
channel-750,684110,30333868,30333874,6,2025-02-25 15:45:51.955061,2025-02-25 15:46:00.120941,8.16588
channel-750,684111,30333877,30333899,22,2025-02-25 15:46:04.477321,2025-02-25 15:46:34.022324,29.545003
channel-750,684112,30333878,30333883,5,2025-02-25 15:46:05.891543,2025-02-25 15:46:12.674037,6.782494
channel-750,684113,30333880,30333889,9,2025-02-25 15:46:08.285415,2025-02-25 15:46:20.956396,12.670981
channel-750,684114,30333884,30333888,4,2025-02-25 15:46:13.845856,2025-02-25 15:46:19.747809,5.901953
channel-750,684115,30333887,30333892,5,2025-02-25 15:46:18.320814,2025-02-25 15:46:24.479171,6.158357
channel-750,684116,30333893,30333903,10,2025-02-25 15:46:25.567640,2025-02-25 15:46:40.149347,14.581707
channel-750,684117,30333894,30333908,14,2025-02-25 15:46:26.727060,2025-02-25 15:46:45.965944,19.238884
channel-750,684118,30333897,30333902,5,2025-02-25 15:46:31.850664,2025-02-25 15:46:37.614108,5.763444
channel-750,684119,30333899,30333918,19,2025-02-25 15:46:34.022324,2025-02-25 15:46:57.774627,23.752303
channel-750,684120,30333902,30333914,12,2025-02-25 15:46:37.614108,2025-02-25 15:46:53.139287,15.525179
channel-750,684121,30333903,30333939,36,2025-02-25 15:46:40.149347,2025-02-25 15:47:23.885117,43.73577
channel-750,684122,30333904,30333919,15,2025-02-25 15:46:41.165076,2025-02-25 15:46:59.792367,18.627291
channel-750,684123,30333913,30333929,16,2025-02-25 15:46:52.007720,2025-02-25 15:47:11.441024,19.433304
channel-750,684124,30333914,30333919,5,2025-02-25 15:46:53.139287,2025-02-25 15:46:59.792367,6.65308
channel-750,684125,30333917,30333931,14,2025-02-25 15:46:56.502105,2025-02-25 15:47:13.713601,17.211496
channel-750,684126,30333937,30333951,14,2025-02-25 15:47:21.705283,2025-02-25 15:47:40.047886,18.342603
channel-750,684127,30333945,30333962,17,2025-02-25 15:47:33.002242,2025-02-25 15:47:54.514211,21.511969
channel-750,684128,30333960,30333968,8,2025-02-25 15:47:52.188265,2025-02-25 15:48:04.846665,12.6584
channel-750,684129,30333971,30333994,23,2025-02-25 15:48:10.367226,2025-02-25 15:48:40.404354,30.037128
channel-750,684130,30333988,30333993,5,2025-02-25 15:48:33.441524,2025-02-25 15:48:39.235962,5.794438
channel-750,684131,30333998,30334003,5,2025-02-25 15:48:46.113075,2025-02-25 15:48:51.852628,5.739553
channel-750,684132,30334036,30334070,34,2025-02-25 15:49:36.629316,2025-02-25 15:50:19.016949,42.387633
channel-750,684133,30334061,30334075,14,2025-02-25 15:50:08.671937,2025-02-25 15:50:27.035342,18.363405
channel-750,684134,30334092,30334108,16,2025-02-25 15:50:49.176856,2025-02-25 15:51:10.232294,21.055438
channel-750,684135,30334127,30334149,22,2025-02-25 15:51:32.984797,2025-02-25 15:52:00.510312,27.525515
channel-750,684136,30334138,30334150,12,2025-02-25 15:51:46.773207,2025-02-25 15:52:02.262503,15.489296
channel-750,684137,30334161,30334175,14,2025-02-25 15:52:17.833255,2025-02-25 15:52:35.870592,18.037337
channel-750,684138,30334166,30334181,15,2025-02-25 15:52:23.753491,2025-02-25 15:52:45.841076,22.087585
channel-750,684139,30334168,30334181,13,2025-02-25 15:52:26.091036,2025-02-25 15:52:45.841076,19.75004
channel-750,684140,30334169,30334178,9,2025-02-25 15:52:27.279647,2025-02-25 15:52:39.209909,11.930262
channel-750,684141,30334175,30334185,10,2025-02-25 15:52:35.870592,2025-02-25 15:52:51.076988,15.206396
channel-750,684142,30334176,30334185,9,2025-02-25 15:52:37.060655,2025-02-25 15:52:51.076988,14.016333
channel-750,684143,30334177,30334185,8,2025-02-25 15:52:38.178453,2025-02-25 15:52:51.076988,12.898535
channel-750,684144,30334179,30334194,15,2025-02-25 15:52:40.282759,2025-02-25 15:53:02.904210,22.621451
channel-750,684145,30334186,30334195,9,2025-02-25 15:52:52.305937,2025-02-25 15:53:05.217795,12.911858
channel-750,684146,30334194,30334203,9,2025-02-25 15:53:02.904210,2025-02-25 15:53:19.618053,16.713843
channel-750,684147,30334194,30334232,38,2025-02-25 15:53:02.904210,2025-02-25 15:53:58.842474,55.938264
channel-750,684148,30334197,30334216,19,2025-02-25 15:53:10.837561,2025-02-25 15:53:35.052936,24.215375
channel-750,684149,30334198,30334214,16,2025-02-25 15:53:12.978531,2025-02-25 15:53:32.793930,19.815399
channel-750,684150,30334205,30334232,27,2025-02-25 15:53:21.825133,2025-02-25 15:53:58.842474,37.017341
channel-750,684151,30334206,30334217,11,2025-02-25 15:53:22.927985,2025-02-25 15:53:36.375657,13.447672
channel-750,684152,30334208,30334225,17,2025-02-25 15:53:25.484961,2025-02-25 15:53:46.324627,20.839666
channel-750,684153,30334212,30334225,13,2025-02-25 15:53:30.359786,2025-02-25 15:53:46.324627,15.964841
channel-750,684154,30334213,30334238,25,2025-02-25 15:53:31.564464,2025-02-25 15:54:05.980479,34.416015
channel-750,684155,30334217,30334229,12,2025-02-25 15:53:36.375657,2025-02-25 15:53:55.300235,18.924578
channel-750,684156,30334218,30334225,7,2025-02-25 15:53:38.101348,2025-02-25 15:53:46.324627,8.223279
channel-750,684157,30334221,30334231,10,2025-02-25 15:53:41.429716,2025-02-25 15:53:57.722115,16.292399
channel-750,684158,30334229,30334235,6,2025-02-25 15:53:55.300235,2025-02-25 15:54:02.348873,7.048638
channel-750,684159,30334238,30334256,18,2025-02-25 15:54:05.980479,2025-02-25 15:54:30.111169,24.13069
channel-750,684160,30334239,30334244,5,2025-02-25 15:54:07.097008,2025-02-25 15:54:15.440271,8.343263
channel-750,684161,30334240,30334245,5,2025-02-25 15:54:09.359818,2025-02-25 15:54:16.605067,7.245249
channel-750,684162,30334248,30334259,11,2025-02-25 15:54:20.085136,2025-02-25 15:54:33.525634,13.440498
channel-750,684163,30334249,30334259,10,2025-02-25 15:54:21.851695,2025-02-25 15:54:33.525634,11.673939
channel-750,684164,30334249,30334264,15,2025-02-25 15:54:21.851695,2025-02-25 15:54:40.290370,18.438675
channel-750,684165,30334250,30334317,67,2025-02-25 15:54:23.084890,2025-02-25 15:55:50.236422,87.151532
channel-750,684166,30334254,30334259,5,2025-02-25 15:54:27.599395,2025-02-25 15:54:33.525634,5.926239
channel-750,684167,30334254,30334259,5,2025-02-25 15:54:27.599395,2025-02-25 15:54:33.525634,5.926239
channel-750,684168,30334254,30334266,12,2025-02-25 15:54:27.599395,2025-02-25 15:54:43.544053,15.944658
channel-750,684169,30334269,30334284,15,2025-02-25 15:54:46.990906,2025-02-25 15:55:06.488101,19.497195
channel-750,684170,30334271,30334275,4,2025-02-25 15:54:49.418302,2025-02-25 15:54:55.035289,5.616987
channel-750,684171,30334276,30334289,13,2025-02-25 15:54:56.393016,2025-02-25 15:55:12.913261,16.520245
channel-750,684172,30334277,30334293,16,2025-02-25 15:54:57.508946,2025-02-25 15:55:18.583024,21.074078
channel-750,684173,30334278,30334288,10,2025-02-25 15:54:58.569494,2025-02-25 15:55:11.087569,12.518075
channel-750,684174,30334278,30334292,14,2025-02-25 15:54:58.569494,2025-02-25 15:55:17.490421,18.920927
channel-750,684175,30334307,30334373,66,2025-02-25 15:55:35.779481,2025-02-25 15:57:05.946634,90.167153
channel-750,684176,30334309,30334314,5,2025-02-25 15:55:37.915248,2025-02-25 15:55:46.004406,8.089158
channel-750,684177,30334314,30334334,20,2025-02-25 15:55:46.004406,2025-02-25 15:56:14.072346,28.06794
channel-750,684178,30334349,30334367,18,2025-02-25 15:56:33.253206,2025-02-25 15:56:57.974731,24.721525
channel-750,684179,30334350,30334356,6,2025-02-25 15:56:34.399988,2025-02-25 15:56:44.700535,10.300547
channel-750,684180,30334355,30334366,11,2025-02-25 15:56:43.579381,2025-02-25 15:56:56.585545,13.006164
channel-750,684181,30334356,30334373,17,2025-02-25 15:56:44.700535,2025-02-25 15:57:05.946634,21.246099
channel-750,684182,30334361,30334423,62,2025-02-25 15:56:50.649126,2025-02-25 15:58:17.051740,86.402614
channel-750,684183,30334361,30334374,13,2025-02-25 15:56:50.649126,2025-02-25 15:57:10.385774,19.736648
channel-750,684184,30334373,30334378,5,2025-02-25 15:57:05.946634,2025-02-25 15:57:15.001884,9.05525
channel-750,684185,30334373,30334378,5,2025-02-25 15:57:05.946634,2025-02-25 15:57:15.001884,9.05525
channel-750,684186,30334486,30334495,9,2025-02-25 15:59:36.137541,2025-02-25 15:59:47.463887,11.326346
channel-750,684187,30334515,30334520,5,2025-02-25 16:00:14.190270,2025-02-25 16:00:19.883669,5.693399
channel-750,684188,30334519,30334523,4,2025-02-25 16:00:18.726623,2025-02-25 16:00:23.563640,4.837017
channel-750,684189,30334565,30334585,20,2025-02-25 16:01:21.941625,2025-02-25 16:01:47.477468,25.535843
channel-750,684190,30334600,30334617,17,2025-02-25 16:02:12.025816,2025-02-25 16:02:32.312721,20.286905
channel-750,684191,30334610,30334615,5,2025-02-25 16:02:23.299758,2025-02-25 16:02:29.644994,6.345236
channel-750,684192,30334666,30334670,4,2025-02-25 16:03:34.578343,2025-02-25 16:03:39.237030,4.658687
channel-750,684193,30334674,30334678,4,2025-02-25 16:03:45.614123,2025-02-25 16:03:52.217249,6.603126
channel-750,684194,30334679,30334695,16,2025-02-25 16:03:53.294519,2025-02-25 16:04:16.759917,23.465398
channel-750,684195,30334709,30334714,5,2025-02-25 16:04:33.699741,2025-02-25 16:04:39.874646,6.174905
channel-750,684196,30334760,30334762,2,2025-02-25 16:05:36.108684,2025-02-25 16:05:39.339779,3.231095
channel-750,684197,30334843,30334848,5,2025-02-25 16:07:29.510818,2025-02-25 16:07:36.192059,6.681241
channel-750,684198,30334843,30334850,7,2025-02-25 16:07:29.510818,2025-02-25 16:07:39.995487,10.484669
channel-750,684199,30334875,30334880,5,2025-02-25 16:08:14.119794,2025-02-25 16:08:19.888598,5.768804
channel-750,684200,30334904,30334909,5,2025-02-25 16:08:49.379226,2025-02-25 16:08:55.089422,5.710196
channel-750,684201,30334943,30334953,10,2025-02-25 16:09:41.588427,2025-02-25 16:09:55.166711,13.578284
channel-750,684202,30335063,30335067,4,2025-02-25 16:12:20.097369,2025-02-25 16:12:27.975869,7.8785
channel-750,684203,30335184,30335195,11,2025-02-25 16:14:58.325550,2025-02-25 16:15:14.478995,16.153445
channel-750,684204,30335272,30335279,7,2025-02-25 16:16:58.830100,2025-02-25 16:17:06.878959,8.048859
channel-750,684205,30335346,30335350,4,2025-02-25 16:18:32.123791,2025-02-25 16:18:36.688419,4.564628
channel-750,684206,30335360,30335364,4,2025-02-25 16:18:53.469840,2025-02-25 16:18:58.341119,4.871279
channel-750,684207,30335391,30335405,14,2025-02-25 16:19:34.322647,2025-02-25 16:19:50.605125,16.282478
channel-750,684208,30335402,30335413,11,2025-02-25 16:19:47.215844,2025-02-25 16:20:01.582596,14.366752
channel-750,684209,30335422,30335427,5,2025-02-25 16:20:13.184029,2025-02-25 16:20:22.406257,9.222228
channel-750,684210,30335440,30335450,10,2025-02-25 16:20:39.132242,2025-02-25 16:20:53.776692,14.64445
channel-750,684211,30335651,30335660,9,2025-02-25 16:25:20.002462,2025-02-25 16:25:31.641581,11.639119
channel-750,684212,30335666,30335671,5,2025-02-25 16:25:39.723472,2025-02-25 16:25:46.259935,6.536463
channel-750,684213,30335755,30335760,5,2025-02-25 16:27:34.719717,2025-02-25 16:27:40.280728,5.561011
channel-750,684214,30335895,30335905,10,2025-02-25 16:30:41.333464,2025-02-25 16:30:54.433012,13.099548
channel-750,684215,30335945,30335956,11,2025-02-25 16:31:43.492998,2025-02-25 16:31:57.241397,13.748399
channel-750,684216,30335952,30335958,6,2025-02-25 16:31:51.458135,2025-02-25 16:31:59.530102,8.071967
channel-750,684217,30335957,30335961,4,2025-02-25 16:31:58.407176,2025-02-25 16:32:02.969408,4.562232
channel-750,684218,30335976,30335985,9,2025-02-25 16:32:22.196727,2025-02-25 16:32:34.934816,12.738089
channel-750,684219,30335993,30336003,10,2025-02-25 16:32:45.972346,2025-02-25 16:32:59.071770,13.099424
channel-750,684220,30336021,30336038,17,2025-02-25 16:33:24.210488,2025-02-25 16:33:47.869534,23.659046
channel-750,684221,30336028,30336038,10,2025-02-25 16:33:34.446904,2025-02-25 16:33:47.869534,13.42263
channel-750,684222,30336035,30336046,11,2025-02-25 16:33:44.463429,2025-02-25 16:34:00.456854,15.993425
channel-750,684223,30336038,30336043,5,2025-02-25 16:33:47.869534,2025-02-25 16:33:57.003636,9.134102
channel-750,684224,30336143,30336148,5,2025-02-25 16:36:02.859732,2025-02-25 16:36:08.432498,5.572766
channel-750,684225,30336179,30336204,25,2025-02-25 16:36:48.819881,2025-02-25 16:37:25.294834,36.474953
channel-750,684226,30336189,30336204,15,2025-02-25 16:37:04.479179,2025-02-25 16:37:25.294834,20.815655
channel-750,684227,30336243,30336265,22,2025-02-25 16:38:13.458136,2025-02-25 16:38:44.342648,30.884512
channel-750,684228,30336256,30336268,12,2025-02-25 16:38:33.092168,2025-02-25 16:38:48.679287,15.587119
channel-750,684229,30336258,30336271,13,2025-02-25 16:38:35.689192,2025-02-25 16:38:52.197450,16.508258
channel-750,684230,30336258,30336269,11,2025-02-25 16:38:35.689192,2025-02-25 16:38:49.903186,14.213994
channel-750,684231,30336266,30336277,11,2025-02-25 16:38:46.442818,2025-02-25 16:39:00.634166,14.191348
channel-750,684232,30336272,30336282,10,2025-02-25 16:38:53.484658,2025-02-25 16:39:06.636895,13.152237
channel-750,684233,30336282,30336287,5,2025-02-25 16:39:06.636895,2025-02-25 16:39:12.046616,5.409721
channel-750,684234,30336282,30336296,14,2025-02-25 16:39:06.636895,2025-02-25 16:39:23.664213,17.027318
channel-750,684235,30336301,30336317,16,2025-02-25 16:39:29.959950,2025-02-25 16:39:49.909687,19.949737
channel-750,684236,30336302,30336324,22,2025-02-25 16:39:31.314512,2025-02-25 16:40:03.499984,32.185472
channel-750,684237,30336309,30336322,13,2025-02-25 16:39:40.359474,2025-02-25 16:39:56.684933,16.325459
channel-750,684238,30336310,30336322,12,2025-02-25 16:39:41.479577,2025-02-25 16:39:56.684933,15.205356
channel-750,684239,30336325,30336329,4,2025-02-25 16:40:05.592541,2025-02-25 16:40:11.486310,5.893769
channel-750,684240,30336332,30336342,10,2025-02-25 16:40:15.761046,2025-02-25 16:40:29.304878,13.543832
channel-750,684241,30336335,30336349,14,2025-02-25 16:40:19.145757,2025-02-25 16:40:40.689646,21.543889
channel-750,684242,30336352,30336379,27,2025-02-25 16:40:45.307669,2025-02-25 16:41:18.105841,32.798172
channel-750,684243,30336357,30336369,12,2025-02-25 16:40:51.492832,2025-02-25 16:41:05.565300,14.072468
channel-750,684244,30336357,30336388,31,2025-02-25 16:40:51.492832,2025-02-25 16:41:30.465827,38.972995
channel-750,684245,30336359,30336371,12,2025-02-25 16:40:53.875898,2025-02-25 16:41:09.013552,15.137654
channel-750,684246,30336364,30336376,12,2025-02-25 16:41:00.052693,2025-02-25 16:41:14.707624,14.654931
channel-750,684247,30336366,30336375,9,2025-02-25 16:41:02.319101,2025-02-25 16:41:13.603592,11.284491
channel-750,684248,30336366,30336379,13,2025-02-25 16:41:02.319101,2025-02-25 16:41:18.105841,15.78674
channel-750,684249,30336367,30336380,13,2025-02-25 16:41:03.443259,2025-02-25 16:41:19.319619,15.87636
channel-750,684250,30336372,30336386,14,2025-02-25 16:41:10.238042,2025-02-25 16:41:26.925005,16.686963
channel-750,684251,30336375,30336389,14,2025-02-25 16:41:13.603592,2025-02-25 16:41:31.558534,17.954942
channel-750,684252,30336402,30336406,4,2025-02-25 16:41:46.994237,2025-02-25 16:41:51.640897,4.64666
channel-750,684253,30336412,30336452,40,2025-02-25 16:42:00.328136,2025-02-25 16:42:52.264031,51.935895
channel-750,684254,30336423,30336437,14,2025-02-25 16:42:15.117422,2025-02-25 16:42:33.165933,18.048511
channel-750,684255,30336444,30336456,12,2025-02-25 16:42:42.055638,2025-02-25 16:42:56.846998,14.79136
channel-750,684256,30336450,30336458,8,2025-02-25 16:42:49.060291,2025-02-25 16:43:02.441295,13.381004
channel-750,684257,30336456,30336471,15,2025-02-25 16:42:56.846998,2025-02-25 16:43:18.991803,22.144805
channel-750,684258,30336465,30336492,27,2025-02-25 16:43:11.197493,2025-02-25 16:43:46.644501,35.447008
channel-750,684259,30336475,30336490,15,2025-02-25 16:43:25.115887,2025-02-25 16:43:42.993384,17.877497
channel-750,684260,30336478,30336493,15,2025-02-25 16:43:28.870092,2025-02-25 16:43:47.882201,19.012109
channel-750,684261,30336481,30336492,11,2025-02-25 16:43:32.213481,2025-02-25 16:43:46.644501,14.43102
channel-750,684262,30336484,30336491,7,2025-02-25 16:43:35.574588,2025-02-25 16:43:44.113408,8.53882
channel-750,684263,30336485,30336497,12,2025-02-25 16:43:36.699104,2025-02-25 16:43:53.112005,16.412901
channel-750,684264,30336487,30336497,10,2025-02-25 16:43:38.930973,2025-02-25 16:43:53.112005,14.181032
channel-750,684265,30336490,30336499,9,2025-02-25 16:43:42.993384,2025-02-25 16:43:57.014237,14.020853
channel-750,684266,30336493,30336513,20,2025-02-25 16:43:47.882201,2025-02-25 16:44:14.607011,26.72481
channel-750,684267,30336494,30336498,4,2025-02-25 16:43:49.535843,2025-02-25 16:43:55.848860,6.313017
channel-750,684268,30336500,30336513,13,2025-02-25 16:43:59.213563,2025-02-25 16:44:14.607011,15.393448
channel-750,684269,30336509,30336514,5,2025-02-25 16:44:09.929086,2025-02-25 16:44:15.746498,5.817412
channel-750,684270,30336520,30336536,16,2025-02-25 16:44:25.221464,2025-02-25 16:44:50.609352,25.387888
channel-750,684271,30336520,30336535,15,2025-02-25 16:44:25.221464,2025-02-25 16:44:49.470936,24.249472
channel-750,684272,30336520,30336531,11,2025-02-25 16:44:25.221464,2025-02-25 16:44:43.444606,18.223142
channel-750,684273,30336523,30336527,4,2025-02-25 16:44:32.214282,2025-02-25 16:44:37.496314,5.282032
channel-750,684274,30336524,30336534,10,2025-02-25 16:44:33.431586,2025-02-25 16:44:48.420888,14.989302
channel-750,684275,30336537,30336548,11,2025-02-25 16:44:51.977038,2025-02-25 16:45:04.562604,12.585566
channel-750,684276,30336543,30336559,16,2025-02-25 16:44:59.051652,2025-02-25 16:45:17.541088,18.489436
channel-750,684277,30336544,30336555,11,2025-02-25 16:45:00.206374,2025-02-25 16:45:12.423031,12.216657
channel-750,684278,30336557,30336572,15,2025-02-25 16:45:14.783443,2025-02-25 16:45:34.920743,20.1373
channel-750,684279,30336560,30336571,11,2025-02-25 16:45:18.774497,2025-02-25 16:45:32.779476,14.004979
channel-750,684280,30336563,30336597,34,2025-02-25 16:45:22.229433,2025-02-25 16:46:08.055926,45.826493
channel-750,684281,30336591,30336603,12,2025-02-25 16:46:00.244322,2025-02-25 16:46:15.143712,14.89939
channel-750,684282,30336598,30336615,17,2025-02-25 16:46:09.464855,2025-02-25 16:46:30.219310,20.754455
channel-750,684283,30336600,30336605,5,2025-02-25 16:46:11.686574,2025-02-25 16:46:17.540826,5.854252
channel-750,684284,30336600,30336612,12,2025-02-25 16:46:11.686574,2025-02-25 16:46:25.572514,13.88594
channel-750,684285,30336600,30336612,12,2025-02-25 16:46:11.686574,2025-02-25 16:46:25.572514,13.88594
channel-750,684286,30336605,30336624,19,2025-02-25 16:46:17.540826,2025-02-25 16:46:40.705011,23.164185
channel-750,684287,30336607,30336621,14,2025-02-25 16:46:19.808024,2025-02-25 16:46:37.270256,17.462232
channel-750,684288,30336608,30336618,10,2025-02-25 16:46:21.017532,2025-02-25 16:46:33.886281,12.868749
channel-750,684289,30336612,30336628,16,2025-02-25 16:46:25.572514,2025-02-25 16:46:46.026227,20.453713
channel-750,684290,30336629,30336647,18,2025-02-25 16:46:47.175156,2025-02-25 16:47:10.398190,23.223034
channel-750,684291,30336633,30336647,14,2025-02-25 16:46:52.949995,2025-02-25 16:47:10.398190,17.448195
channel-750,684292,30336654,30336688,34,2025-02-25 16:47:19.323663,2025-02-25 16:48:11.373630,52.049967
channel-750,684293,30336659,30336671,12,2025-02-25 16:47:24.955404,2025-02-25 16:47:41.184668,16.229264
channel-750,684294,30336670,30336677,7,2025-02-25 16:47:39.928932,2025-02-25 16:47:54.505968,14.577036
channel-750,684295,30336673,30336678,5,2025-02-25 16:47:43.359686,2025-02-25 16:47:55.717505,12.357819
channel-750,684296,30336693,30336713,20,2025-02-25 16:48:18.037580,2025-02-25 16:48:43.519094,25.481514
channel-750,684297,30336738,30336759,21,2025-02-25 16:49:16.446744,2025-02-25 16:49:42.885702,26.438958
channel-750,684298,30336756,30336765,9,2025-02-25 16:49:37.648112,2025-02-25 16:49:51.432183,13.784071
channel-750,684299,30336778,30336789,11,2025-02-25 16:50:07.025866,2025-02-25 16:50:19.929535,12.903669
channel-750,684300,30336783,30336814,31,2025-02-25 16:50:12.951211,2025-02-25 16:50:53.961749,41.010538
channel-750,684301,30336822,30336826,4,2025-02-25 16:51:02.872361,2025-02-25 16:51:08.422097,5.549736
channel-750,684302,30336828,30336845,17,2025-02-25 16:51:10.797504,2025-02-25 16:51:41.029922,30.232418
channel-750,684303,30336830,30336836,6,2025-02-25 16:51:13.008982,2025-02-25 16:51:21.063073,8.054091
channel-750,684304,30336838,30336840,2,2025-02-25 16:51:24.160913,2025-02-25 16:51:26.445333,2.28442
channel-750,684305,30336844,30336856,12,2025-02-25 16:51:39.876779,2025-02-25 16:51:55.433056,15.556277
channel-750,684306,30336846,30336850,4,2025-02-25 16:51:42.103957,2025-02-25 16:51:46.963105,4.859148
channel-750,684307,30336852,30336861,9,2025-02-25 16:51:49.200240,2025-02-25 16:52:01.718580,12.51834
channel-750,684308,30336853,30336866,13,2025-02-25 16:51:50.293857,2025-02-25 16:52:07.414412,17.120555
channel-750,684309,30336865,30336882,17,2025-02-25 16:52:06.274341,2025-02-25 16:52:29.277434,23.003093
channel-750,684310,30336871,30336901,30,2025-02-25 16:52:13.466789,2025-02-25 16:52:53.010574,39.543785
channel-750,684311,30336889,30336897,8,2025-02-25 16:52:37.719823,2025-02-25 16:52:48.700197,10.980374
channel-750,684312,30336890,30336893,3,2025-02-25 16:52:38.792002,2025-02-25 16:52:43.369491,4.577489
channel-750,684313,30336906,30336919,13,2025-02-25 16:52:59.612959,2025-02-25 16:53:15.028626,15.415667
channel-750,684314,30336912,30336953,41,2025-02-25 16:53:06.872987,2025-02-25 16:53:59.897890,53.024903
channel-750,684315,30336954,30336971,17,2025-02-25 16:54:01.976633,2025-02-25 16:54:23.200889,21.224256
channel-750,684316,30336954,30336980,26,2025-02-25 16:54:01.976633,2025-02-25 16:54:33.684167,31.707534
channel-750,684317,30337016,30337026,10,2025-02-25 16:55:23.553797,2025-02-25 16:55:38.067937,14.51414
channel-750,684318,30337028,30337058,30,2025-02-25 16:55:40.294398,2025-02-25 16:56:17.513288,37.21889
channel-750,684319,30337030,30337051,21,2025-02-25 16:55:43.678532,2025-02-25 16:56:08.900812,25.22228
channel-750,684320,30337074,30337095,21,2025-02-25 16:56:38.050329,2025-02-25 16:57:07.851086,29.800757
channel-750,684321,30337100,30337107,7,2025-02-25 16:57:14.911318,2025-02-25 16:57:26.738560,11.827242
channel-750,684322,30337155,30337160,5,2025-02-25 16:58:27.455781,2025-02-25 16:58:33.526042,6.070261
channel-750,684323,30337396,30337401,5,2025-02-25 17:03:50.535948,2025-02-25 17:03:56.452567,5.916619
channel-750,684324,30337533,30337538,5,2025-02-25 17:06:52.587849,2025-02-25 17:06:58.483460,5.895611
channel-750,684325,30337563,30337567,4,2025-02-25 17:07:30.749526,2025-02-25 17:07:35.312320,4.562794
channel-750,684326,30337675,30337688,13,2025-02-25 17:09:54.946992,2025-02-25 17:10:10.604537,15.657545
channel-750,684327,30337740,30337746,6,2025-02-25 17:11:23.473686,2025-02-25 17:11:32.082736,8.60905
channel-750,684328,30337787,30337798,11,2025-02-25 17:12:25.809935,2025-02-25 17:12:39.904509,14.094574
channel-750,684329,30337811,30337823,12,2025-02-25 17:12:55.048204,2025-02-25 17:13:10.681362,15.633158
channel-750,684330,30337850,30337868,18,2025-02-25 17:13:48.060568,2025-02-25 17:14:08.681939,20.621371
channel-750,684331,30337870,30337876,6,2025-02-25 17:14:12.197099,2025-02-25 17:14:20.623716,8.426617
channel-750,684332,30337872,30337885,13,2025-02-25 17:14:15.695991,2025-02-25 17:14:33.337330,17.641339
channel-750,684333,30337895,30337910,15,2025-02-25 17:14:47.247030,2025-02-25 17:15:07.168777,19.921747
channel-750,684334,30337898,30337903,5,2025-02-25 17:14:50.581198,2025-02-25 17:14:56.108983,5.527785
channel-750,684335,30337898,30337906,8,2025-02-25 17:14:50.581198,2025-02-25 17:14:59.417110,8.835912
channel-750,684336,30337910,30337924,14,2025-02-25 17:15:07.168777,2025-02-25 17:15:26.823491,19.654714
channel-750,684337,30337912,30337921,9,2025-02-25 17:15:10.048415,2025-02-25 17:15:22.317807,12.269392
channel-750,684338,30337917,30337927,10,2025-02-25 17:15:15.819731,2025-02-25 17:15:30.101414,14.281683
channel-750,684339,30337940,30337944,4,2025-02-25 17:15:45.912448,2025-02-25 17:15:50.679192,4.766744
channel-750,684340,30337946,30337961,15,2025-02-25 17:15:53.654562,2025-02-25 17:16:11.803814,18.149252
channel-750,684341,30337967,30337974,7,2025-02-25 17:16:51.485125,2025-02-25 17:17:05.782769,14.297644
channel-750,684342,30337967,30337974,7,2025-02-25 17:16:51.485125,2025-02-25 17:17:05.782769,14.297644
channel-750,684343,30337972,30337985,13,2025-02-25 17:16:59.102962,2025-02-25 17:17:23.489464,24.386502
channel-750,684344,30337977,30337987,10,2025-02-25 17:17:12.828249,2025-02-25 17:17:30.249456,17.421207
channel-750,684345,30337978,30337988,10,2025-02-25 17:17:14.952150,2025-02-25 17:17:31.656780,16.70463
channel-750,684346,30338015,30338027,12,2025-02-25 17:18:09.283562,2025-02-25 17:18:25.097136,15.813574
channel-750,684347,30338039,30338043,4,2025-02-25 17:18:40.262960,2025-02-25 17:18:45.131002,4.868042
channel-750,684348,30338046,30338055,9,2025-02-25 17:18:49.065709,2025-02-25 17:19:00.455478,11.389769
channel-750,684349,30338049,30338074,25,2025-02-25 17:18:52.442473,2025-02-25 17:19:26.247558,33.805085
channel-750,684350,30338050,30338059,9,2025-02-25 17:18:53.544503,2025-02-25 17:19:06.605877,13.061374
channel-750,684351,30338062,30338066,4,2025-02-25 17:19:10.093339,2025-02-25 17:19:14.686057,4.592718
channel-750,684352,30338071,30338082,11,2025-02-25 17:19:21.755303,2025-02-25 17:19:36.674363,14.91906
channel-750,684353,30338110,30338127,17,2025-02-25 17:20:11.108256,2025-02-25 17:20:37.207969,26.099713
channel-750,684354,30338142,30338146,4,2025-02-25 17:20:55.663508,2025-02-25 17:21:03.518252,7.854744
channel-750,684355,30338143,30338153,10,2025-02-25 17:20:57.487597,2025-02-25 17:21:13.108870,15.621273
channel-750,684356,30338177,30338199,22,2025-02-25 17:21:46.304268,2025-02-25 17:22:12.463547,26.159279
channel-750,684357,30338191,30338199,8,2025-02-25 17:22:02.404532,2025-02-25 17:22:12.463547,10.059015
channel-750,684358,30338203,30338208,5,2025-02-25 17:22:17.441041,2025-02-25 17:22:22.826226,5.385185
channel-750,684359,30338213,30338228,15,2025-02-25 17:22:31.254457,2025-02-25 17:22:50.019521,18.765064
channel-750,684360,30338236,30338259,23,2025-02-25 17:22:59.181866,2025-02-25 17:23:32.096946,32.91508
channel-750,684361,30338250,30338266,16,2025-02-25 17:23:21.866113,2025-02-25 17:23:41.581956,19.715843
channel-750,684362,30338251,30338266,15,2025-02-25 17:23:23.005093,2025-02-25 17:23:41.581956,18.576863
channel-750,684363,30338282,30338292,10,2025-02-25 17:24:02.144932,2025-02-25 17:24:13.916422,11.77149
channel-750,684364,30338300,30338322,22,2025-02-25 17:24:23.864429,2025-02-25 17:24:52.726420,28.861991
channel-750,684365,30338328,30338345,17,2025-02-25 17:25:00.208704,2025-02-25 17:25:25.759906,25.551202
channel-750,684366,30338350,30338379,29,2025-02-25 17:25:35.923260,2025-02-25 17:26:14.903824,38.980564
channel-750,684367,30338355,30338376,21,2025-02-25 17:25:42.829024,2025-02-25 17:26:11.193246,28.364222
channel-750,684368,30338358,30338376,18,2025-02-25 17:25:46.250986,2025-02-25 17:26:11.193246,24.94226
channel-750,684369,30338366,30338382,16,2025-02-25 17:25:58.867712,2025-02-25 17:26:18.554256,19.686544
channel-750,684370,30338367,30338385,18,2025-02-25 17:26:00.065236,2025-02-25 17:26:22.037427,21.972191
channel-750,684371,30338374,30338379,5,2025-02-25 17:26:08.247350,2025-02-25 17:26:14.903824,6.656474
channel-750,684372,30338374,30338391,17,2025-02-25 17:26:08.247350,2025-02-25 17:26:30.144548,21.897198
channel-750,684373,30338375,30338386,11,2025-02-25 17:26:09.968136,2025-02-25 17:26:23.164441,13.196305
channel-750,684374,30338379,30338407,28,2025-02-25 17:26:14.903824,2025-02-25 17:26:50.669886,35.766062
channel-750,684375,30338380,30338392,12,2025-02-25 17:26:16.132020,2025-02-25 17:26:31.263062,15.131042
channel-750,684376,30338391,30338396,5,2025-02-25 17:26:30.144548,2025-02-25 17:26:35.619832,5.475284
channel-750,684377,30338413,30338444,31,2025-02-25 17:26:59.563183,2025-02-25 17:27:37.466858,37.903675
channel-750,684378,30338415,30338427,12,2025-02-25 17:27:02.777231,2025-02-25 17:27:17.047556,14.270325
channel-750,684379,30338437,30338451,14,2025-02-25 17:27:28.756792,2025-02-25 17:27:45.506359,16.749567
channel-750,684380,30338447,30338456,9,2025-02-25 17:27:40.807682,2025-02-25 17:27:52.546021,11.738339
channel-750,684381,30338460,30338472,12,2025-02-25 17:27:58.995982,2025-02-25 17:28:13.938932,14.94295
channel-750,684382,30338481,30338498,17,2025-02-25 17:28:26.871034,2025-02-25 17:28:48.172258,21.301224
channel-750,684383,30338497,30338514,17,2025-02-25 17:28:47.020646,2025-02-25 17:29:13.721715,26.701069
channel-750,684384,30338504,30338514,10,2025-02-25 17:28:56.435828,2025-02-25 17:29:13.721715,17.285887
channel-750,684385,30338508,30338518,10,2025-02-25 17:29:05.681051,2025-02-25 17:29:22.409318,16.728267
channel-750,684386,30338514,30338518,4,2025-02-25 17:29:13.721715,2025-02-25 17:29:22.409318,8.687603
channel-750,684387,30338519,30338535,16,2025-02-25 17:29:23.944597,2025-02-25 17:29:43.869377,19.92478
channel-750,684388,30338532,30338544,12,2025-02-25 17:29:40.408174,2025-02-25 17:29:58.834682,18.426508
channel-750,684389,30338532,30338540,8,2025-02-25 17:29:40.408174,2025-02-25 17:29:54.284887,13.876713
channel-750,684390,30338537,30338549,12,2025-02-25 17:29:46.195841,2025-02-25 17:30:06.388734,20.192893
channel-750,684391,30338542,30338552,10,2025-02-25 17:29:56.656357,2025-02-25 17:30:10.249623,13.593266
channel-750,684392,30338542,30338555,13,2025-02-25 17:29:56.656357,2025-02-25 17:30:13.707366,17.051009
channel-750,684393,30338544,30338548,4,2025-02-25 17:29:58.834682,2025-02-25 17:30:04.040747,5.206065
channel-750,684394,30338546,30338557,11,2025-02-25 17:30:01.188414,2025-02-25 17:30:15.917053,14.728639
channel-750,684395,30338564,30338574,10,2025-02-25 17:30:23.924770,2025-02-25 17:30:37.335967,13.411197
channel-750,684396,30338569,30338598,29,2025-02-25 17:30:29.890712,2025-02-25 17:31:11.926754,42.036042
channel-750,684397,30338569,30338580,11,2025-02-25 17:30:29.890712,2025-02-25 17:30:44.358455,14.467743
channel-750,684398,30338569,30338580,11,2025-02-25 17:30:29.890712,2025-02-25 17:30:44.358455,14.467743
channel-750,684399,30338574,30338584,10,2025-02-25 17:30:37.335967,2025-02-25 17:30:53.653932,16.317965
channel-750,684400,30338591,30338605,14,2025-02-25 17:31:02.647197,2025-02-25 17:31:21.069460,18.422263
channel-750,684401,30338637,30338654,17,2025-02-25 17:32:00.755173,2025-02-25 17:32:22.674642,21.919469
channel-750,684402,30338656,30338661,5,2025-02-25 17:32:28.144607,2025-02-25 17:32:34.176471,6.031864
channel-750,684403,30338690,30338702,12,2025-02-25 17:33:15.162644,2025-02-25 17:33:30.899266,15.736622
channel-750,684404,30338700,30338725,25,2025-02-25 17:33:28.335943,2025-02-25 17:33:59.280701,30.944758
channel-750,684405,30338725,30338741,16,2025-02-25 17:33:59.280701,2025-02-25 17:34:21.240197,21.959496
channel-750,684406,30338735,30338739,4,2025-02-25 17:34:13.192440,2025-02-25 17:34:18.682068,5.489628
channel-750,684407,30338752,30338774,22,2025-02-25 17:34:37.949514,2025-02-25 17:35:07.443750,29.494236
channel-750,684408,30338777,30338787,10,2025-02-25 17:35:10.934772,2025-02-25 17:35:22.729790,11.795018
channel-750,684409,30338779,30338792,13,2025-02-25 17:35:13.306029,2025-02-25 17:35:29.502292,16.196263
channel-750,684410,30338796,30338809,13,2025-02-25 17:35:35.297535,2025-02-25 17:35:51.848687,16.551152
channel-750,684411,30338799,30338813,14,2025-02-25 17:35:38.969334,2025-02-25 17:35:56.570156,17.600822
channel-750,684412,30338803,30338815,12,2025-02-25 17:35:44.312892,2025-02-25 17:35:58.779641,14.466749
channel-750,684413,30338819,30338832,13,2025-02-25 17:36:04.611759,2025-02-25 17:36:20.671182,16.059423
channel-750,684414,30338823,30338842,19,2025-02-25 17:36:08.950015,2025-02-25 17:36:37.707436,28.757421
channel-750,684415,30338838,30338848,10,2025-02-25 17:36:30.328289,2025-02-25 17:36:48.869830,18.541541
channel-750,684416,30338841,30338852,11,2025-02-25 17:36:35.051070,2025-02-25 17:36:53.680375,18.629305
channel-750,684417,30338844,30338848,4,2025-02-25 17:36:43.289074,2025-02-25 17:36:48.869830,5.580756
channel-750,684418,30338847,30338857,10,2025-02-25 17:36:47.799325,2025-02-25 17:36:59.580316,11.780991
channel-750,684419,30338884,30338892,8,2025-02-25 17:37:32.103943,2025-02-25 17:37:44.044175,11.940232
channel-750,684420,30338886,30338908,22,2025-02-25 17:37:34.510257,2025-02-25 17:38:04.312826,29.802569
channel-750,684421,30338925,30338935,10,2025-02-25 17:38:28.738769,2025-02-25 17:38:40.995455,12.256686
channel-750,684422,30338941,30338954,13,2025-02-25 17:38:48.846513,2025-02-25 17:39:08.069856,19.223343
channel-750,684423,30338946,30338967,21,2025-02-25 17:38:54.680264,2025-02-25 17:39:25.467891,30.787627
channel-750,684424,30338957,30338967,10,2025-02-25 17:39:11.473102,2025-02-25 17:39:25.467891,13.994789
channel-750,684425,30338994,30339003,9,2025-02-25 17:40:00.349192,2025-02-25 17:40:12.608018,12.258826
channel-750,684426,30339005,30339012,7,2025-02-25 17:40:14.886763,2025-02-25 17:40:25.993313,11.10655
channel-750,684427,30339026,30339035,9,2025-02-25 17:40:44.876167,2025-02-25 17:40:56.208198,11.332031
channel-750,684428,30339041,30339048,7,2025-02-25 17:41:03.621980,2025-02-25 17:41:11.398014,7.776034
channel-750,684429,30339066,30339077,11,2025-02-25 17:41:33.176435,2025-02-25 17:41:47.009922,13.833487
channel-750,684430,30339080,30339085,5,2025-02-25 17:41:51.606647,2025-02-25 17:41:57.593228,5.986581
channel-750,684431,30339094,30339103,9,2025-02-25 17:42:09.273091,2025-02-25 17:42:24.230253,14.957162
channel-750,684432,30339095,30339100,5,2025-02-25 17:42:10.417776,2025-02-25 17:42:20.834750,10.416974
channel-750,684433,30339105,30339116,11,2025-02-25 17:42:27.559487,2025-02-25 17:42:40.861959,13.302472
channel-750,684434,30339118,30339128,10,2025-02-25 17:42:43.136655,2025-02-25 17:42:54.817995,11.68134
channel-750,684435,30339145,30339163,18,2025-02-25 17:43:17.582920,2025-02-25 17:43:45.694880,28.11196
channel-750,684436,30339164,30339174,10,2025-02-25 17:43:46.724482,2025-02-25 17:43:58.875629,12.151147
channel-750,684437,30339168,30339172,4,2025-02-25 17:43:51.910441,2025-02-25 17:43:56.512106,4.601665
channel-750,684438,30339177,30339182,5,2025-02-25 17:44:07.288344,2025-02-25 17:44:12.961230,5.672886
channel-750,684439,30339206,30339230,24,2025-02-25 17:44:43.087168,2025-02-25 17:45:14.051434,30.964266
channel-750,684440,30339240,30339251,11,2025-02-25 17:45:26.804933,2025-02-25 17:45:39.516339,12.711406
channel-750,684441,30339267,30339291,24,2025-02-25 17:45:59.758510,2025-02-25 17:46:34.824738,35.066228
channel-750,684442,30339277,30339282,5,2025-02-25 17:46:13.343671,2025-02-25 17:46:23.451601,10.10793
channel-750,684443,30339285,30339295,10,2025-02-25 17:46:27.933756,2025-02-25 17:46:39.894679,11.960923
channel-750,684444,30339302,30339307,5,2025-02-25 17:46:51.144529,2025-02-25 17:46:57.002491,5.857962
channel-750,684445,30339305,30339311,6,2025-02-25 17:46:54.448996,2025-02-25 17:47:01.917208,7.468212
channel-750,684446,30339309,30339342,33,2025-02-25 17:46:59.263194,2025-02-25 17:47:45.097142,45.833948
channel-750,684447,30339321,30339328,7,2025-02-25 17:47:13.468260,2025-02-25 17:47:23.585776,10.117516
channel-750,684448,30339326,30339342,16,2025-02-25 17:47:21.253615,2025-02-25 17:47:45.097142,23.843527
channel-750,684449,30339340,30339345,5,2025-02-25 17:47:39.540321,2025-02-25 17:47:48.327045,8.786724
channel-750,684450,30339351,30339369,18,2025-02-25 17:47:55.944703,2025-02-25 17:48:21.833088,25.888385
channel-750,684451,30339453,30339460,7,2025-02-25 17:50:10.221738,2025-02-25 17:50:20.102892,9.881154
channel-750,684452,30339559,30339574,15,2025-02-25 17:52:29.957226,2025-02-25 17:52:49.485216,19.52799
channel-750,684453,30339561,30339570,9,,2025-02-25 17:52:44.760053,
channel-750,684454,30339577,30339581,4,2025-02-25 17:52:53.009499,2025-02-25 17:53:01.413543,8.404044
channel-750,684455,30339603,30339616,13,2025-02-25 17:53:30.527438,2025-02-25 17:53:46.760834,16.233396
channel-750,684456,30339651,30339661,10,2025-02-25 17:54:31.709192,2025-02-25 17:54:43.844665,12.135473
channel-750,684457,30339703,30339727,24,2025-02-25 17:55:38.969635,2025-02-25 17:56:14.119805,35.15017
channel-750,684458,30339758,30339781,23,2025-02-25 17:56:53.309290,2025-02-25 17:57:24.034025,30.724735
channel-750,684459,30339775,30339785,10,2025-02-25 17:57:16.282391,2025-02-25 17:57:28.498853,12.216462
channel-750,684460,30339803,30339812,9,2025-02-25 17:57:55.295143,2025-02-25 17:58:06.891738,11.596595
channel-750,684461,30339814,30339837,23,2025-02-25 17:58:09.143327,2025-02-25 17:58:40.256816,31.113489
channel-750,684462,30339850,30339862,12,2025-02-25 17:58:56.344369,2025-02-25 17:59:13.375196,17.030827
channel-750,684463,30339875,30339896,21,2025-02-25 17:59:28.084235,2025-02-25 17:59:55.485448,27.401213
channel-750,684464,30339893,30339905,12,2025-02-25 17:59:51.463782,2025-02-25 18:00:07.110220,15.646438
channel-750,684465,30339903,30339915,12,2025-02-25 18:00:03.592126,2025-02-25 18:00:19.524737,15.932611
channel-750,684466,30339905,30339925,20,2025-02-25 18:00:07.110220,2025-02-25 18:00:31.968081,24.857861
channel-750,684467,30339912,30339917,5,2025-02-25 18:00:16.224062,2025-02-25 18:00:21.805850,5.581788
channel-750,684468,30339917,30339922,5,2025-02-25 18:00:21.805850,2025-02-25 18:00:28.600192,6.794342
channel-750,684469,30339951,30339964,13,2025-02-25 18:01:04.329984,2025-02-25 18:01:26.511598,22.181614
channel-750,684470,30339959,30339963,4,2025-02-25 18:01:17.831976,2025-02-25 18:01:24.347050,6.515074
channel-750,684471,30339961,30339968,7,2025-02-25 18:01:21.152236,2025-02-25 18:01:32.505825,11.353589
channel-750,684472,30339977,30339988,11,2025-02-25 18:01:43.239822,2025-02-25 18:01:56.340588,13.100766
channel-750,684473,30339984,30339994,10,2025-02-25 18:01:51.283071,2025-02-25 18:02:04.105199,12.822128
channel-750,684474,30339998,30340020,22,2025-02-25 18:02:11.743071,2025-02-25 18:02:41.350913,29.607842
channel-750,684475,30340013,30340026,13,2025-02-25 18:02:33.506094,2025-02-25 18:02:49.776231,16.270137
channel-750,684476,30340036,30340050,14,2025-02-25 18:03:01.771422,2025-02-25 18:03:19.388690,17.617268
channel-750,684477,30340045,30340055,10,2025-02-25 18:03:12.386029,2025-02-25 18:03:26.597822,14.211793
channel-750,684478,30340058,30340086,28,2025-02-25 18:03:30.029188,2025-02-25 18:04:05.072730,35.043542
channel-750,684479,30340072,30340084,12,2025-02-25 18:03:47.963614,2025-02-25 18:04:02.875109,14.911495
channel-750,684480,30340086,30340090,4,2025-02-25 18:04:05.072730,2025-02-25 18:04:09.633346,4.560616
channel-750,684481,30340094,30340105,11,2025-02-25 18:04:15.795232,2025-02-25 18:04:30.190219,14.394987
channel-750,684482,30340095,30340100,5,2025-02-25 18:04:16.909589,2025-02-25 18:04:23.896733,6.987144
channel-750,684483,30340105,30340115,10,2025-02-25 18:04:30.190219,2025-02-25 18:04:41.859764,11.669545
channel-750,684484,30340123,30340149,26,2025-02-25 18:04:51.188538,2025-02-25 18:05:25.563163,34.374625
channel-750,684485,30340126,30340139,13,2025-02-25 18:04:55.359973,2025-02-25 18:05:11.094911,15.734938
channel-750,684486,30340144,30340153,9,2025-02-25 18:05:18.301742,2025-02-25 18:05:31.111081,12.809339
channel-750,684487,30340149,30340159,10,2025-02-25 18:05:25.563163,2025-02-25 18:05:38.835502,13.272339
channel-750,684488,30340173,30340178,5,2025-02-25 18:05:59.538201,2025-02-25 18:06:05.295237,5.757036
channel-750,684489,30340179,30340190,11,2025-02-25 18:06:07.484467,2025-02-25 18:06:24.827923,17.343456
channel-750,684490,30340192,30340205,13,2025-02-25 18:06:27.185335,2025-02-25 18:06:44.065587,16.880252
channel-750,684491,30340226,30340242,16,2025-02-25 18:07:14.075894,2025-02-25 18:07:33.926991,19.851097
channel-750,684492,30340242,30340247,5,2025-02-25 18:07:33.926991,2025-02-25 18:07:40.668705,6.741714
channel-750,684493,30340243,30340253,10,2025-02-25 18:07:36.274258,2025-02-25 18:07:48.726577,12.452319
channel-750,684494,30340290,30340299,9,2025-02-25 18:08:34.080218,2025-02-25 18:08:46.983176,12.902958
channel-750,684495,30340312,30340316,4,2025-02-25 18:09:02.356857,2025-02-25 18:09:08.502502,6.145645
channel-750,684496,30340370,30340384,14,2025-02-25 18:10:18.298319,2025-02-25 18:10:35.573923,17.275604
channel-750,684497,30340377,30340388,11,2025-02-25 18:10:26.493938,2025-02-25 18:10:40.713492,14.219554
channel-750,684498,30340500,30340503,3,2025-02-25 18:13:08.740227,2025-02-25 18:13:12.648076,3.907849
channel-750,684499,30340507,30340513,6,2025-02-25 18:13:22.140774,2025-02-25 18:13:28.810050,6.669276
channel-750,684500,30340512,30340516,4,2025-02-25 18:13:27.682108,2025-02-25 18:13:33.502169,5.820061
channel-750,684501,30340627,30340637,10,2025-02-25 18:15:57.448464,2025-02-25 18:16:09.946176,12.497712
channel-750,684502,30340654,30340662,8,2025-02-25 18:16:31.568686,2025-02-25 18:16:42.440865,10.872179
channel-750,684503,30340662,30340664,2,2025-02-25 18:16:42.440865,2025-02-25 18:16:44.749127,2.308262
channel-750,684504,30340701,30340706,5,2025-02-25 18:17:35.257059,2025-02-25 18:17:40.904958,5.647899
channel-750,684505,30341069,30341089,20,2025-02-25 18:25:41.360306,2025-02-25 18:26:05.294922,23.934616
channel-750,684506,30341125,30341132,7,2025-02-25 18:26:53.736815,2025-02-25 18:27:01.857399,8.120584
channel-750,684507,30341130,30341135,5,2025-02-25 18:26:59.420058,2025-02-25 18:27:05.561527,6.141469
channel-750,684508,30341201,30341206,5,2025-02-25 18:28:31.698847,2025-02-25 18:28:37.394968,5.696121
channel-750,684509,30341223,30341230,7,2025-02-25 18:29:01.057759,2025-02-25 18:29:09.063965,8.006206
channel-750,684510,30341274,30341283,9,2025-02-25 18:30:08.385119,2025-02-25 18:30:20.381948,11.996829
channel-750,684511,30341307,30341312,5,2025-02-25 18:30:50.029192,2025-02-25 18:30:56.899162,6.86997
channel-750,684512,30341328,30341337,9,2025-02-25 18:31:16.130161,2025-02-25 18:31:27.863612,11.733451
channel-750,684513,30341415,30341420,5,2025-02-25 18:33:11.971819,2025-02-25 18:33:17.716233,5.744414
channel-750,684514,30341420,30341425,5,2025-02-25 18:33:17.716233,2025-02-25 18:33:23.584171,5.867938
channel-750,684515,30341446,30341450,4,2025-02-25 18:33:53.603866,2025-02-25 18:33:58.186504,4.582638
channel-750,684516,30341454,30341460,6,2025-02-25 18:34:07.533928,2025-02-25 18:34:14.181397,6.647469
channel-750,684517,30341459,30341464,5,2025-02-25 18:34:13.092118,2025-02-25 18:34:18.891859,5.799741
channel-750,684518,30341462,30341466,4,2025-02-25 18:34:16.449683,2025-02-25 18:34:23.664795,7.215112
channel-750,684519,30341482,30341487,5,2025-02-25 18:34:44.714454,2025-02-25 18:34:50.186893,5.472439
channel-750,684520,30341569,30341579,10,2025-02-25 18:36:36.715517,2025-02-25 18:36:48.325039,11.609522
channel-750,684521,30341586,30341593,7,2025-02-25 18:36:57.450971,2025-02-25 18:37:05.956028,8.505057
channel-750,684522,30341606,30341618,12,2025-02-25 18:37:24.827176,2025-02-25 18:37:40.673538,15.846362
channel-750,684523,30341658,30341668,10,2025-02-25 18:38:32.662203,2025-02-25 18:38:47.807821,15.145618
channel-750,684524,30341731,30341742,11,2025-02-25 18:40:13.868423,2025-02-25 18:40:27.011018,13.142595
channel-750,684525,30341760,30341779,19,2025-02-25 18:40:50.726388,2025-02-25 18:41:15.061847,24.335459
channel-750,684526,30341829,30341834,5,2025-02-25 18:42:21.802748,2025-02-25 18:42:27.737349,5.934601
channel-750,684527,30341832,30341838,6,2025-02-25 18:42:25.204230,2025-02-25 18:42:32.315377,7.111147
channel-750,684528,30341833,30341838,5,2025-02-25 18:42:26.347434,2025-02-25 18:42:32.315377,5.967943
channel-750,684529,30341856,30341860,4,2025-02-25 18:42:56.338389,2025-02-25 18:43:00.877048,4.538659
channel-750,684530,30341864,30341869,5,2025-02-25 18:43:10.062001,2025-02-25 18:43:16.986117,6.924116
channel-750,684531,30341868,30341872,4,2025-02-25 18:43:15.829105,2025-02-25 18:43:20.973029,5.143924
channel-750,684532,30341892,30341908,16,2025-02-25 18:43:46.332632,2025-02-25 18:44:05.945323,19.612691
channel-750,684533,30341943,30341948,5,2025-02-25 18:44:50.109601,2025-02-25 18:44:55.943043,5.833442
channel-750,684534,30341963,30341974,11,2025-02-25 18:45:14.523159,2025-02-25 18:45:30.465485,15.942326
channel-750,684535,30342040,30342050,10,2025-02-25 18:46:55.049503,2025-02-25 18:47:08.181376,13.131873
channel-750,684536,30342040,30342058,18,2025-02-25 18:46:55.049503,2025-02-25 18:47:17.108022,22.058519
channel-750,684537,30342066,30342071,5,2025-02-25 18:47:26.147069,2025-02-25 18:47:32.311872,6.164803
channel-750,684538,30342080,30342086,6,2025-02-25 18:47:45.855341,2025-02-25 18:47:54.929644,9.074303
channel-750,684539,30342111,30342116,5,2025-02-25 18:48:25.890466,2025-02-25 18:48:32.037481,6.147015
channel-750,684540,30342370,30342392,22,2025-02-25 18:53:56.158294,2025-02-25 18:54:23.159999,27.001705
channel-750,684541,30342432,30342450,18,2025-02-25 18:55:17.006599,2025-02-25 18:55:39.061557,22.054958
channel-750,684542,30342479,30342491,12,2025-02-25 18:56:18.822090,2025-02-25 18:56:35.743391,16.921301
channel-750,684543,30342500,30342523,23,2025-02-25 18:56:47.123047,2025-02-25 18:57:16.612795,29.489748
channel-750,684544,30342556,30342577,21,2025-02-25 18:57:58.021848,2025-02-25 18:58:24.881984,26.860136
channel-750,684545,30342594,30342599,5,2025-02-25 18:58:45.419019,2025-02-25 18:58:51.690586,6.271567
channel-750,684546,30342616,30342640,24,2025-02-25 18:59:12.749332,2025-02-25 18:59:43.016129,30.266797
channel-750,684547,30342643,30342657,14,2025-02-25 18:59:46.568734,2025-02-25 19:00:09.288786,22.720052
channel-750,684548,30342650,30342654,4,2025-02-25 18:59:55.162981,2025-02-25 19:00:05.950143,10.787162
channel-750,684549,30342656,30342668,12,2025-02-25 19:00:08.179114,2025-02-25 19:00:25.225319,17.046205
channel-750,684550,30342660,30342687,27,2025-02-25 19:00:13.881147,2025-02-25 19:00:50.765096,36.883949
channel-750,684551,30342661,30342666,5,2025-02-25 19:00:16.160275,2025-02-25 19:00:22.956691,6.796416
channel-750,684552,30342662,30342674,12,2025-02-25 19:00:18.525255,2025-02-25 19:00:32.259207,13.733952
channel-750,684553,30342691,30342695,4,2025-02-25 19:00:55.610902,2025-02-25 19:01:04.229104,8.618202
channel-750,684554,30342696,30342719,23,2025-02-25 19:01:05.403763,2025-02-25 19:01:35.483100,30.079337
channel-750,684555,30342703,30342708,5,2025-02-25 19:01:13.328656,2025-02-25 19:01:20.327664,6.999008
channel-750,684556,30342714,30342718,4,2025-02-25 19:01:28.340508,2025-02-25 19:01:33.382432,5.041924
channel-750,684557,30342755,30342776,21,2025-02-25 19:02:19.493454,2025-02-25 19:02:47.036332,27.542878
channel-750,684558,30342783,30342788,5,2025-02-25 19:02:54.774807,2025-02-25 19:03:01.436465,6.661658
channel-750,684559,30342785,30342799,14,,2025-02-25 19:03:14.801115,
channel-750,684560,30342791,30342805,14,2025-02-25 19:03:04.744110,2025-02-25 19:03:21.937842,17.193732
channel-750,684561,30342793,30342805,12,2025-02-25 19:03:07.169570,2025-02-25 19:03:21.937842,14.768272
channel-750,684562,30342804,30342822,18,2025-02-25 19:03:20.873913,2025-02-25 19:03:42.773335,21.899422
channel-750,684563,30342811,30342824,13,2025-02-25 19:03:29.920334,2025-02-25 19:03:45.123999,15.203665
channel-750,684564,30342818,30342839,21,2025-02-25 19:03:38.214345,2025-02-25 19:04:08.362794,30.148449
channel-750,684565,30342822,30342834,12,2025-02-25 19:03:42.773335,2025-02-25 19:04:01.606321,18.832986
channel-750,684566,30342832,30342836,4,2025-02-25 19:03:59.142694,2025-02-25 19:04:04.946515,5.803821
channel-750,684567,30342842,30342847,5,2025-02-25 19:04:12.588776,2025-02-25 19:04:18.620348,6.031572
channel-750,684568,30342846,30342861,15,2025-02-25 19:04:17.502219,2025-02-25 19:04:41.568303,24.066084
channel-750,684569,30342850,30342858,8,2025-02-25 19:04:22.014116,2025-02-25 19:04:33.575164,11.561048
channel-750,684570,30342853,30342865,12,2025-02-25 19:04:26.848461,2025-02-25 19:04:47.430961,20.5825
channel-750,684571,30342853,30342858,5,2025-02-25 19:04:26.848461,2025-02-25 19:04:33.575164,6.726703
channel-750,684572,30342854,30342864,10,2025-02-25 19:04:27.973862,2025-02-25 19:04:45.226875,17.253013
channel-750,684573,30342864,30342876,12,2025-02-25 19:04:45.226875,2025-02-25 19:04:59.965598,14.738723
channel-750,684574,30342869,30342885,16,2025-02-25 19:04:52.049173,2025-02-25 19:05:10.316445,18.267272
channel-750,684575,30342876,30342890,14,2025-02-25 19:04:59.965598,2025-02-25 19:05:16.036854,16.071256
channel-750,684576,30342879,30342902,23,2025-02-25 19:05:03.260948,2025-02-25 19:05:31.635181,28.374233
channel-750,684577,30342880,30342891,11,2025-02-25 19:05:04.305341,2025-02-25 19:05:18.001267,13.695926
channel-750,684578,30342888,30342895,7,2025-02-25 19:05:13.838642,2025-02-25 19:05:22.608954,8.770312
channel-750,684579,30342892,30342903,11,2025-02-25 19:05:19.134049,2025-02-25 19:05:35.974293,16.840244
channel-750,684580,30342901,30342906,5,2025-02-25 19:05:30.425298,2025-02-25 19:05:39.702817,9.277519
channel-750,684581,30342908,30342921,13,2025-02-25 19:05:42.857150,2025-02-25 19:06:00.334709,17.477559
channel-750,684582,30342909,30342918,9,2025-02-25 19:05:44.093393,2025-02-25 19:05:57.104361,13.010968
channel-750,684583,30342923,30342937,14,2025-02-25 19:06:02.651876,2025-02-25 19:06:19.210722,16.558846
channel-750,684584,30342928,30342939,11,2025-02-25 19:06:09.107490,2025-02-25 19:06:21.340016,12.232526
channel-750,684585,30342949,30342971,22,2025-02-25 19:06:36.393640,2025-02-25 19:07:05.260244,28.866604
channel-750,684586,30342954,30342959,5,2025-02-25 19:06:43.371844,2025-02-25 19:06:49.261427,5.889583
channel-750,684587,30342974,30342979,5,2025-02-25 19:07:08.676802,2025-02-25 19:07:14.662282,5.98548
channel-750,684588,30342987,30342993,6,2025-02-25 19:07:24.481161,2025-02-25 19:07:35.639386,11.158225
channel-750,684589,30342987,30343001,14,2025-02-25 19:07:24.481161,2025-02-25 19:07:47.852188,23.371027
channel-750,684590,30342998,30343009,11,2025-02-25 19:07:44.262333,2025-02-25 19:07:56.938268,12.675935
channel-750,684591,30343007,30343028,21,2025-02-25 19:07:54.780286,2025-02-25 19:08:20.324888,25.544602
channel-750,684592,30343026,30343030,4,2025-02-25 19:08:18.201045,2025-02-25 19:08:23.652547,5.451502
channel-750,684593,30343028,30343040,12,2025-02-25 19:08:20.324888,2025-02-25 19:08:36.179544,15.854656
channel-750,684594,30343053,30343058,5,2025-02-25 19:08:52.269742,2025-02-25 19:08:59.860544,7.590802
channel-750,684595,30343055,30343073,18,2025-02-25 19:08:55.540878,2025-02-25 19:09:16.985098,21.44422
channel-750,684596,30343071,30343090,19,2025-02-25 19:09:14.649788,2025-02-25 19:09:42.677291,28.027503
channel-750,684597,30343097,30343101,4,2025-02-25 19:09:52.934641,2025-02-25 19:09:57.433864,4.499223
channel-750,684598,30343104,30343115,11,2025-02-25 19:10:00.561127,2025-02-25 19:10:13.468351,12.907224
channel-750,684599,30343143,30343147,4,2025-02-25 19:10:52.550567,2025-02-25 19:10:57.000220,4.449653
channel-750,684600,30343149,30343180,31,2025-02-25 19:10:59.518899,2025-02-25 19:11:41.331771,41.812872
channel-750,684601,30343154,30343193,39,2025-02-25 19:11:07.008837,2025-02-25 19:11:58.509125,51.500288
channel-750,684602,30343160,30343165,5,2025-02-25 19:11:14.782714,2025-02-25 19:11:21.468245,6.685531
channel-750,684603,30343164,30343169,5,2025-02-25 19:11:20.351585,2025-02-25 19:11:27.046336,6.694751
channel-750,684604,30343177,30343182,5,2025-02-25 19:11:37.964999,2025-02-25 19:11:43.748835,5.783836
channel-750,684605,30343201,30343206,5,2025-02-25 19:12:08.667963,2025-02-25 19:12:14.238856,5.570893
channel-750,684606,30343206,30343228,22,2025-02-25 19:12:14.238856,2025-02-25 19:12:41.673748,27.434892
channel-750,684607,30343215,30343221,6,2025-02-25 19:12:25.703704,2025-02-25 19:12:33.379579,7.675875
channel-750,684608,30343228,30343233,5,2025-02-25 19:12:41.673748,2025-02-25 19:12:47.463852,5.790104
channel-750,684609,30343237,30343243,6,2025-02-25 19:12:51.936859,2025-02-25 19:13:00.201911,8.265052
channel-750,684610,30343261,30343275,14,2025-02-25 19:13:23.675456,2025-02-25 19:13:40.509179,16.833723
channel-750,684611,30343273,30343298,25,2025-02-25 19:13:38.355809,2025-02-25 19:14:11.690525,33.334716
channel-750,684612,30343345,30343349,4,2025-02-25 19:15:17.098925,2025-02-25 19:15:22.566523,5.467598
channel-750,684613,30343424,30343428,4,2025-02-25 19:16:57.010859,2025-02-25 19:17:01.608560,4.597701
channel-750,684614,30343556,30343573,17,2025-02-25 19:19:50.240380,2025-02-25 19:20:09.449203,19.208823
channel-750,684615,30343560,30343571,11,2025-02-25 19:19:54.611911,2025-02-25 19:20:07.009155,12.397244
channel-750,684616,30343580,30343589,9,2025-02-25 19:20:18.228380,2025-02-25 19:20:30.777709,12.549329
channel-750,684617,30343583,30343595,12,2025-02-25 19:20:22.104196,2025-02-25 19:20:38.776279,16.672083
channel-750,684618,30343584,30343594,10,2025-02-25 19:20:24.264196,2025-02-25 19:20:37.661203,13.397007
channel-750,684619,30343603,30343608,5,2025-02-25 19:20:48.162981,2025-02-25 19:20:58.300696,10.137715
channel-750,684620,30343606,30343612,6,2025-02-25 19:20:55.723650,2025-02-25 19:21:02.733324,7.009674
channel-750,684621,30343625,30343630,5,2025-02-25 19:21:21.072590,2025-02-25 19:21:26.311913,5.239323
channel-750,684622,30343676,30343680,4,2025-02-25 19:22:23.721975,2025-02-25 19:22:28.895810,5.173835
channel-750,684623,30343751,30343763,12,2025-02-25 19:24:05.527906,2025-02-25 19:24:20.091660,14.563754
channel-750,684624,30343772,30343777,5,2025-02-25 19:24:33.127170,2025-02-25 19:24:40.227316,7.100146
channel-750,684625,30343816,30343836,20,2025-02-25 19:25:29.389590,2025-02-25 19:25:55.002955,25.613365
channel-750,684626,30343837,30343842,5,2025-02-25 19:25:56.101134,2025-02-25 19:26:02.849710,6.748576
channel-750,684627,30343882,30343891,9,2025-02-25 19:26:54.030309,2025-02-25 19:27:04.357666,10.327357
channel-750,684628,30343906,30343911,5,2025-02-25 19:27:22.107271,2025-02-25 19:27:29.616905,7.509634
channel-750,684629,30343942,30343951,9,2025-02-25 19:28:11.494535,2025-02-25 19:28:26.194135,14.6996
channel-750,684630,30343944,30343959,15,2025-02-25 19:28:15.288535,2025-02-25 19:28:35.417765,20.12923
channel-750,684631,30343964,30343968,4,2025-02-25 19:28:42.212648,2025-02-25 19:28:46.843098,4.63045
channel-750,684632,30344006,30344016,10,2025-02-25 19:29:32.892697,2025-02-25 19:29:45.181987,12.28929
channel-750,684633,30344045,30344051,6,2025-02-25 19:30:24.731345,2025-02-25 19:30:32.602270,7.870925
channel-750,684634,30344054,30344060,6,2025-02-25 19:30:36.156113,2025-02-25 19:30:44.144772,7.988659
channel-750,684635,30344058,30344070,12,2025-02-25 19:30:41.942105,2025-02-25 19:30:56.462531,14.520426
channel-750,684636,30344062,30344078,16,2025-02-25 19:30:47.109727,2025-02-25 19:31:06.088771,18.979044
channel-750,684637,30344078,30344083,5,2025-02-25 19:31:06.088771,2025-02-25 19:31:11.977737,5.888966
channel-750,684638,30344105,30344109,4,2025-02-25 19:31:40.826478,2025-02-25 19:31:47.067773,6.241295
channel-750,684639,30344142,30344147,5,2025-02-25 19:32:28.559410,2025-02-25 19:32:38.294789,9.735379
channel-750,684640,30344195,30344203,8,2025-02-25 19:33:36.729982,2025-02-25 19:33:48.783791,12.053809
channel-750,684641,30344203,30344212,9,2025-02-25 19:33:48.783791,2025-02-25 19:33:59.648721,10.86493
channel-750,684642,30344231,30344237,6,2025-02-25 19:34:22.091282,2025-02-25 19:34:30.370297,8.279015
channel-750,684643,30344374,30344378,4,2025-02-25 19:37:26.356982,2025-02-25 19:37:30.982509,4.625527
channel-750,684644,30344466,30344477,11,2025-02-25 19:39:21.772976,2025-02-25 19:39:41.063403,19.290427
channel-750,684645,30344491,30344496,5,2025-02-25 19:39:59.454986,2025-02-25 19:40:05.599983,6.144997
channel-750,684646,30344542,30344554,12,2025-02-25 19:41:02.267684,2025-02-25 19:41:17.759985,15.492301
channel-750,684647,30344614,30344625,11,2025-02-25 19:42:38.703401,2025-02-25 19:42:52.357069,13.653668
channel-750,684648,30344767,30344778,11,2025-02-25 19:45:54.151173,2025-02-25 19:46:09.519203,15.36803
channel-750,684649,30344804,30344807,3,2025-02-25 19:46:42.535957,2025-02-25 19:46:46.113404,3.577447
channel-750,684650,30344846,30344857,11,2025-02-25 19:47:36.029075,2025-02-25 19:47:48.727741,12.698666
channel-750,684651,30344859,30344864,5,2025-02-25 19:47:52.191414,2025-02-25 19:47:58.631629,6.440215
channel-750,684652,30344875,30344890,15,2025-02-25 19:48:11.281731,2025-02-25 19:48:31.566523,20.284792
channel-750,684653,30344876,30344892,16,2025-02-25 19:48:13.594152,2025-02-25 19:48:33.879109,20.284957
channel-750,684654,30344909,30344920,11,2025-02-25 19:48:57.323894,2025-02-25 19:49:09.773126,12.449232
channel-750,684655,30344926,30344931,5,2025-02-25 19:49:20.239271,2025-02-25 19:49:26.637332,6.398061
channel-750,684656,30344943,30344955,12,2025-02-25 19:49:40.711576,2025-02-25 19:49:54.293232,13.581656
channel-750,684657,30344955,30344959,4,2025-02-25 19:49:54.293232,2025-02-25 19:49:58.775718,4.482486
channel-750,684658,30344980,30344989,9,2025-02-25 19:50:30.039259,2025-02-25 19:50:44.845759,14.8065
channel-750,684659,30345004,30345010,6,2025-02-25 19:51:03.291819,2025-02-25 19:51:10.105985,6.814166
channel-750,684660,30345011,30345021,10,2025-02-25 19:51:11.275298,2025-02-25 19:51:24.887539,13.612241
channel-750,684661,30345025,30345029,4,2025-02-25 19:51:30.575753,2025-02-25 19:51:36.645250,6.069497
channel-750,684662,30345045,30345056,11,2025-02-25 19:51:56.238368,2025-02-25 19:52:08.991015,12.752647
channel-750,684663,30345063,30345081,18,2025-02-25 19:52:17.385050,2025-02-25 19:52:43.699429,26.314379
channel-750,684664,30345078,30345088,10,2025-02-25 19:52:39.132795,2025-02-25 19:52:52.631320,13.498525
channel-750,684665,30345081,30345087,6,2025-02-25 19:52:43.699429,2025-02-25 19:52:51.065968,7.366539
channel-750,684666,30345088,30345092,4,2025-02-25 19:52:52.631320,2025-02-25 19:52:58.973984,6.342664
channel-750,684667,30345093,30345107,14,2025-02-25 19:53:00.064680,2025-02-25 19:53:19.011247,18.946567
channel-750,684668,30345095,30345111,16,2025-02-25 19:53:03.384431,2025-02-25 19:53:24.767015,21.382584
channel-750,684669,30345095,30345107,12,2025-02-25 19:53:03.384431,2025-02-25 19:53:19.011247,15.626816
channel-750,684670,30345097,30345102,5,2025-02-25 19:53:06.901466,2025-02-25 19:53:12.999801,6.098335
channel-750,684671,30345110,30345121,11,2025-02-25 19:53:23.618332,2025-02-25 19:53:38.667862,15.04953
channel-750,684672,30345113,30345135,22,2025-02-25 19:53:27.085006,2025-02-25 19:53:55.173901,28.088895
channel-750,684673,30345137,30345142,5,2025-02-25 19:53:58.595527,2025-02-25 19:54:04.189047,5.59352
channel-750,684674,30345143,30345153,10,2025-02-25 19:54:05.564969,2025-02-25 19:54:18.728793,13.163824
channel-750,684675,30345181,30345201,20,2025-02-25 19:54:55.751367,2025-02-25 19:55:22.988531,27.237164
channel-750,684676,30345182,30345205,23,2025-02-25 19:54:56.985598,2025-02-25 19:55:27.379031,30.393433
channel-750,684677,30345207,30345220,13,2025-02-25 19:55:30.690311,2025-02-25 19:55:47.769594,17.079283
channel-750,684678,30345208,30345223,15,2025-02-25 19:55:31.829354,2025-02-25 19:55:51.059110,19.229756
channel-750,684679,30345223,30345237,14,2025-02-25 19:55:51.059110,2025-02-25 19:56:08.785671,17.726561
channel-750,684680,30345227,30345241,14,2025-02-25 19:55:57.610727,2025-02-25 19:56:13.525806,15.915079
channel-750,684681,30345227,30345231,4,2025-02-25 19:55:57.610727,2025-02-25 19:56:02.307105,4.696378
channel-750,684682,30345236,30345249,13,2025-02-25 19:56:07.675459,2025-02-25 19:56:26.909633,19.234174
channel-750,684683,30345244,30345255,11,2025-02-25 19:56:21.142402,2025-02-25 19:56:33.738545,12.596143
channel-750,684684,30345253,30345257,4,2025-02-25 19:56:31.437509,2025-02-25 19:56:36.549230,5.111721
channel-750,684685,30345260,30345284,24,2025-02-25 19:56:41.083174,2025-02-25 19:57:09.701751,28.618577
channel-750,684686,30345260,30345271,11,2025-02-25 19:56:41.083174,2025-02-25 19:56:54.007774,12.9246
channel-750,684687,30345265,30345276,11,2025-02-25 19:56:46.791842,2025-02-25 19:56:59.510636,12.718794
channel-750,684688,30345274,30345284,10,2025-02-25 19:56:57.452342,2025-02-25 19:57:09.701751,12.249409
channel-750,684689,30345278,30345291,13,2025-02-25 19:57:01.643919,2025-02-25 19:57:18.629441,16.985522
channel-750,684690,30345283,30345297,14,2025-02-25 19:57:08.559170,2025-02-25 19:57:25.778781,17.219611
channel-750,684691,30345284,30345301,17,2025-02-25 19:57:09.701751,2025-02-25 19:57:30.344466,20.642715
channel-750,684692,30345297,30345302,5,2025-02-25 19:57:25.778781,2025-02-25 19:57:31.524649,5.745868
channel-750,684693,30345304,30345319,15,2025-02-25 19:57:33.819201,2025-02-25 19:57:53.494562,19.675361
channel-750,684694,30345306,30345319,13,2025-02-25 19:57:36.139552,2025-02-25 19:57:53.494562,17.35501
channel-750,684695,30345308,30345320,12,2025-02-25 19:57:39.835810,2025-02-25 19:57:55.333789,15.497979
channel-750,684696,30345322,30345347,25,2025-02-25 19:57:58.819504,2025-02-25 19:58:31.042149,32.222645
channel-750,684697,30345331,30345343,12,2025-02-25 19:58:11.616359,2025-02-25 19:58:26.206243,14.589884
channel-750,684698,30345338,30345343,5,2025-02-25 19:58:20.652185,2025-02-25 19:58:26.206243,5.554058
channel-750,684699,30345341,30345347,6,2025-02-25 19:58:23.986823,2025-02-25 19:58:31.042149,7.055326
channel-750,684700,30345344,30345360,16,2025-02-25 19:58:27.424141,2025-02-25 19:58:48.315300,20.891159
channel-750,684701,30345355,30345370,15,2025-02-25 19:58:41.005487,2025-02-25 19:59:01.693892,20.688405
channel-750,684702,30345369,30345378,9,2025-02-25 19:58:59.888851,2025-02-25 19:59:12.130029,12.241178
channel-750,684703,30345372,30345382,10,2025-02-25 19:59:04.047121,2025-02-25 19:59:16.835530,12.788409
channel-750,684704,30345375,30345378,3,2025-02-25 19:59:07.533730,2025-02-25 19:59:12.130029,4.596299
channel-750,684705,30345376,30345385,9,2025-02-25 19:59:08.714648,2025-02-25 19:59:21.457591,12.742943
channel-750,684706,30345378,30345400,22,2025-02-25 19:59:12.130029,2025-02-25 19:59:43.470480,31.340451
channel-750,684707,30345380,30345384,4,2025-02-25 19:59:14.494247,2025-02-25 19:59:19.223344,4.729097
channel-750,684708,30345385,30345402,17,2025-02-25 19:59:21.457591,2025-02-25 19:59:46.806684,25.349093
channel-750,684709,30345387,30345402,15,2025-02-25 19:59:27.541021,2025-02-25 19:59:46.806684,19.265663
channel-750,684710,30345397,30345409,12,2025-02-25 19:59:40.177717,2025-02-25 19:59:55.691604,15.513887
channel-750,684711,30345400,30345411,11,2025-02-25 19:59:43.470480,2025-02-25 19:59:57.970086,14.499606
channel-750,684712,30345414,30345419,5,2025-02-25 20:00:01.364329,2025-02-25 20:00:11.476680,10.112351
channel-750,684713,30345422,30345433,11,2025-02-25 20:00:16.510440,2025-02-25 20:00:31.292812,14.782372
channel-750,684714,30345422,30345427,5,2025-02-25 20:00:16.510440,2025-02-25 20:00:23.696278,7.185838
channel-750,684715,30345429,30345442,13,2025-02-25 20:00:26.524475,2025-02-25 20:00:42.767222,16.242747
channel-750,684716,30345432,30345448,16,2025-02-25 20:00:30.199875,2025-02-25 20:00:49.775263,19.575388
channel-750,684717,30345441,30345451,10,2025-02-25 20:00:41.563069,2025-02-25 20:00:53.191014,11.627945
channel-750,684718,30345444,30345454,10,2025-02-25 20:00:45.172112,2025-02-25 20:00:57.727847,12.555735
channel-750,684719,30345451,30345465,14,2025-02-25 20:00:53.191014,2025-02-25 20:01:11.718831,18.527817
channel-750,684720,30345453,30345467,14,2025-02-25 20:00:55.440417,2025-02-25 20:01:13.931673,18.491256
channel-750,684721,30345458,30345486,28,2025-02-25 20:01:02.775096,2025-02-25 20:01:37.184796,34.4097
channel-750,684722,30345468,30345485,17,2025-02-25 20:01:15.162181,2025-02-25 20:01:35.695456,20.533275
channel-750,684723,30345474,30345492,18,2025-02-25 20:01:21.725435,2025-02-25 20:01:44.696803,22.971368
channel-750,684724,30345477,30345482,5,2025-02-25 20:01:25.387886,2025-02-25 20:01:31.146950,5.759064
channel-750,684725,30345503,30345514,11,2025-02-25 20:02:01.087933,2025-02-25 20:02:14.183390,13.095457
channel-750,684726,30345511,30345522,11,2025-02-25 20:02:10.724048,2025-02-25 20:02:25.002821,14.278773
channel-750,684727,30345513,30345535,22,2025-02-25 20:02:13.106693,2025-02-25 20:02:41.678764,28.572071
channel-750,684728,30345529,30345533,4,2025-02-25 20:02:34.813527,2025-02-25 20:02:39.216239,4.402712
channel-750,684729,30345554,30345561,7,2025-02-25 20:03:07.294434,2025-02-25 20:03:15.427015,8.132581
channel-750,684730,30345574,30345589,15,2025-02-25 20:03:30.243999,2025-02-25 20:03:53.326474,23.082475
channel-750,684731,30345586,30345595,9,2025-02-25 20:03:48.841500,2025-02-25 20:04:03.535635,14.694135
channel-750,684732,30345621,30345631,10,2025-02-25 20:04:36.509451,2025-02-25 20:04:49.299364,12.789913
channel-750,684733,30345642,30345663,21,2025-02-25 20:05:02.690467,2025-02-25 20:05:31.407725,28.717258
channel-750,684734,30345651,30345670,19,2025-02-25 20:05:14.823658,2025-02-25 20:05:39.960127,25.136469
channel-750,684735,30345651,30345663,12,2025-02-25 20:05:14.823658,2025-02-25 20:05:31.407725,16.584067
channel-750,684736,30345653,30345670,17,2025-02-25 20:05:19.056401,2025-02-25 20:05:39.960127,20.903726
channel-750,684737,30345654,30345672,18,2025-02-25 20:05:21.247800,2025-02-25 20:05:43.904650,22.65685
channel-750,684738,30345666,30345675,9,2025-02-25 20:05:35.013037,2025-02-25 20:05:47.230650,12.217613
channel-750,684739,30345671,30345676,5,2025-02-25 20:05:41.152515,2025-02-25 20:05:48.397315,7.2448
channel-750,684740,30345685,30345695,10,2025-02-25 20:05:59.866173,2025-02-25 20:06:12.701262,12.835089
channel-750,684741,30345686,30345707,21,2025-02-25 20:06:01.174919,2025-02-25 20:06:26.222501,25.047582
channel-750,684742,30345711,30345722,11,2025-02-25 20:06:30.786826,2025-02-25 20:06:45.089040,14.302214
channel-750,684743,30345716,30345743,27,2025-02-25 20:06:38.047863,2025-02-25 20:07:10.163529,32.115666
channel-750,684744,30345717,30345727,10,2025-02-25 20:06:39.245271,2025-02-25 20:06:50.892242,11.646971
channel-750,684745,30345724,30345739,15,2025-02-25 20:06:47.525099,2025-02-25 20:07:04.439955,16.914856
channel-750,684746,30345728,30345740,12,2025-02-25 20:06:51.977566,2025-02-25 20:07:05.646333,13.668767
channel-750,684747,30345736,30345746,10,2025-02-25 20:07:01.105605,2025-02-25 20:07:14.621870,13.516265
channel-750,684748,30345738,30345747,9,2025-02-25 20:07:03.294700,2025-02-25 20:07:15.708667,12.413967
channel-750,684749,30345752,30345760,8,2025-02-25 20:07:21.965555,2025-02-25 20:07:33.797615,11.83206
channel-750,684750,30345752,30345768,16,2025-02-25 20:07:21.965555,2025-02-25 20:07:42.892257,20.926702
channel-750,684751,30345756,30345768,12,2025-02-25 20:07:26.778467,2025-02-25 20:07:42.892257,16.11379
channel-750,684752,30345758,30345771,13,2025-02-25 20:07:28.993833,2025-02-25 20:07:46.324254,17.330421
channel-750,684753,30345780,30345800,20,2025-02-25 20:07:58.190199,2025-02-25 20:08:24.646999,26.4568
channel-750,684754,30345784,30345795,11,2025-02-25 20:08:03.690480,2025-02-25 20:08:18.516893,14.826413
channel-750,684755,30345793,30345798,5,2025-02-25 20:08:16.135800,2025-02-25 20:08:22.458024,6.322224
channel-750,684756,30345795,30345802,7,2025-02-25 20:08:18.516893,2025-02-25 20:08:30.240959,11.724066
channel-750,684757,30345800,30345810,10,2025-02-25 20:08:24.646999,2025-02-25 20:08:39.193013,14.546014
channel-750,684758,30345826,30345836,10,2025-02-25 20:08:58.650129,2025-02-25 20:09:11.434258,12.784129
channel-750,684759,30345833,30345854,21,2025-02-25 20:09:07.937112,2025-02-25 20:09:37.887291,29.950179
channel-750,684760,30345838,30345849,11,2025-02-25 20:09:15.806663,2025-02-25 20:09:31.346161,15.539498
channel-750,684761,30345842,30345852,10,2025-02-25 20:09:20.419886,2025-02-25 20:09:35.722832,15.302946
channel-750,684762,30345854,30345863,9,2025-02-25 20:09:37.887291,2025-02-25 20:09:49.112456,11.225165
channel-750,684763,30345860,30345870,10,2025-02-25 20:09:44.656323,2025-02-25 20:09:56.980207,12.323884
channel-750,684764,30345862,30345880,18,2025-02-25 20:09:46.902171,2025-02-25 20:10:09.463410,22.561239
channel-750,684765,30345883,30345894,11,2025-02-25 20:10:12.836991,2025-02-25 20:10:27.182911,14.34592
channel-750,684766,30345886,30345898,12,2025-02-25 20:10:17.452740,2025-02-25 20:10:31.762276,14.309536
channel-750,684767,30345895,30345925,30,2025-02-25 20:10:28.303864,2025-02-25 20:11:07.311494,39.00763
channel-750,684768,30345912,30345934,22,2025-02-25 20:10:50.595460,2025-02-25 20:11:20.406793,29.811333
channel-750,684769,30345951,30345961,10,2025-02-25 20:11:41.344775,2025-02-25 20:11:53.690223,12.345448
channel-750,684770,30345951,30345961,10,2025-02-25 20:11:41.344775,2025-02-25 20:11:53.690223,12.345448
channel-750,684771,30345972,30345997,25,2025-02-25 20:12:07.298281,2025-02-25 20:12:39.203387,31.905106
channel-750,684772,30345977,30345987,10,2025-02-25 20:12:14.242809,2025-02-25 20:12:27.965937,13.723128
channel-750,684773,30345983,30345995,12,2025-02-25 20:12:21.848549,2025-02-25 20:12:36.928056,15.079507
channel-750,684774,30345990,30345996,6,2025-02-25 20:12:31.317720,2025-02-25 20:12:37.988433,6.670713
channel-750,684775,30346003,30346017,14,2025-02-25 20:12:47.171642,2025-02-25 20:13:06.780076,19.608434
channel-750,684776,30346010,30346020,10,2025-02-25 20:12:58.380001,2025-02-25 20:13:11.736127,13.356126
channel-750,684777,30346026,30346038,12,2025-02-25 20:13:18.819773,2025-02-25 20:13:34.903471,16.083698
channel-750,684778,30346037,30346061,24,2025-02-25 20:13:33.775174,2025-02-25 20:14:03.306139,29.530965
channel-750,684779,30346095,30346118,23,2025-02-25 20:14:48.017074,2025-02-25 20:15:18.720847,30.703773
channel-750,684780,30346117,30346129,12,2025-02-25 20:15:17.608033,2025-02-25 20:15:32.420229,14.812196
channel-750,684781,30346121,30346127,6,2025-02-25 20:15:22.017968,2025-02-25 20:15:28.793017,6.775049
channel-750,684782,30346123,30346127,4,2025-02-25 20:15:24.283121,2025-02-25 20:15:28.793017,4.509896
channel-750,684783,30346152,30346163,11,2025-02-25 20:15:59.894874,2025-02-25 20:16:14.241939,14.347065
channel-750,684784,30346156,30346182,26,2025-02-25 20:16:05.625282,2025-02-25 20:16:39.951345,34.326063
channel-750,684785,30346187,30346197,10,2025-02-25 20:16:46.679726,2025-02-25 20:17:00.892229,14.212503
channel-750,684786,30346213,30346228,15,2025-02-25 20:17:25.154693,2025-02-25 20:17:43.060500,17.905807
channel-750,684787,30346215,30346240,25,2025-02-25 20:17:27.389861,2025-02-25 20:17:56.820110,29.430249
channel-750,684788,30346224,30346229,5,2025-02-25 20:17:38.708085,2025-02-25 20:17:44.179706,5.471621
channel-750,684789,30346253,30346264,11,2025-02-25 20:18:13.470240,2025-02-25 20:18:26.249769,12.779529
channel-750,684790,30346272,30346282,10,2025-02-25 20:18:36.322136,2025-02-25 20:18:54.778719,18.456583
channel-750,684791,30346277,30346303,26,2025-02-25 20:18:43.695491,2025-02-25 20:19:21.973653,38.278162
channel-750,684792,30346279,30346290,11,2025-02-25 20:18:50.238238,2025-02-25 20:19:04.895789,14.657551
channel-750,684793,30346282,30346291,9,2025-02-25 20:18:54.778719,2025-02-25 20:19:07.108554,12.329835
channel-750,684794,30346301,30346310,9,2025-02-25 20:19:19.801860,2025-02-25 20:19:31.129738,11.327878
channel-750,684795,30346314,30346326,12,2025-02-25 20:19:35.778831,2025-02-25 20:19:50.562822,14.783991
channel-750,684796,30346316,30346321,5,2025-02-25 20:19:38.060904,2025-02-25 20:19:44.927605,6.866701
channel-750,684797,30346318,30346331,13,2025-02-25 20:19:40.258698,2025-02-25 20:19:56.136206,15.877508
channel-750,684798,30346322,30346333,11,2025-02-25 20:19:46.050877,2025-02-25 20:19:58.349801,12.298924
channel-750,684799,30346322,30346336,14,2025-02-25 20:19:46.050877,2025-02-25 20:20:02.124136,16.073259
channel-750,684800,30346324,30346336,12,2025-02-25 20:19:48.272037,2025-02-25 20:20:02.124136,13.852099
channel-750,684801,30346327,30346340,13,2025-02-25 20:19:51.927963,2025-02-25 20:20:08.389781,16.461818
channel-750,684802,30346332,30346348,16,2025-02-25 20:19:57.236897,2025-02-25 20:20:17.253450,20.016553
channel-750,684803,30346332,30346336,4,2025-02-25 20:19:57.236897,2025-02-25 20:20:02.124136,4.887239
channel-750,684804,30346333,30346342,9,2025-02-25 20:19:58.349801,2025-02-25 20:20:10.613245,12.263444
channel-750,684805,30346335,30346351,16,2025-02-25 20:20:00.877310,2025-02-25 20:20:21.252075,20.374765
channel-750,684806,30346335,30346364,29,2025-02-25 20:20:00.877310,2025-02-25 20:20:44.224339,43.347029
channel-750,684807,30346341,30346352,11,2025-02-25 20:20:09.422184,2025-02-25 20:20:22.677813,13.255629
channel-750,684808,30346341,30346364,23,2025-02-25 20:20:09.422184,2025-02-25 20:20:44.224339,34.802155
channel-750,684809,30346341,30346348,7,2025-02-25 20:20:09.422184,2025-02-25 20:20:17.253450,7.831266
channel-750,684810,30346355,30346364,9,2025-02-25 20:20:26.113907,2025-02-25 20:20:44.224339,18.110432
channel-750,684811,30346360,30346368,8,2025-02-25 20:20:35.120520,2025-02-25 20:20:51.313411,16.192891
channel-750,684812,30346362,30346366,4,2025-02-25 20:20:41.776196,2025-02-25 20:20:47.627865,5.851669
channel-750,684813,30346366,30346376,10,2025-02-25 20:20:47.627865,2025-02-25 20:21:01.340465,13.7126
channel-750,684814,30346406,30346412,6,2025-02-25 20:21:39.516245,2025-02-25 20:21:47.293658,7.777413
channel-750,684815,30346407,30346427,20,2025-02-25 20:21:40.575541,2025-02-25 20:22:09.237797,28.662256
channel-750,684816,30346427,30346441,14,2025-02-25 20:22:09.237797,2025-02-25 20:22:26.760785,17.522988
channel-750,684817,30346435,30346448,13,2025-02-25 20:22:18.821452,2025-02-25 20:22:34.817963,15.996511
channel-750,684818,30346441,30346455,14,2025-02-25 20:22:26.760785,2025-02-25 20:22:45.358404,18.597619
channel-750,684819,30346442,30346448,6,2025-02-25 20:22:27.906627,2025-02-25 20:22:34.817963,6.911336
channel-750,684820,30346443,30346451,8,2025-02-25 20:22:29.033224,2025-02-25 20:22:39.752042,10.718818
channel-750,684821,30346445,30346459,14,2025-02-25 20:22:31.477922,2025-02-25 20:22:50.246646,18.768724
channel-750,684822,30346449,30346459,10,2025-02-25 20:22:35.955828,2025-02-25 20:22:50.246646,14.290818
channel-750,684823,30346460,30346466,6,2025-02-25 20:22:51.427505,2025-02-25 20:23:03.928381,12.500876
channel-750,684824,30346467,30346491,24,2025-02-25 20:23:04.984414,2025-02-25 20:23:35.940209,30.955795
channel-750,684825,30346474,30346489,15,2025-02-25 20:23:13.540912,2025-02-25 20:23:32.593782,19.05287
channel-750,684826,30346474,30346508,34,2025-02-25 20:23:13.540912,2025-02-25 20:23:56.929991,43.389079
channel-750,684827,30346498,30346511,13,2025-02-25 20:23:43.769747,2025-02-25 20:24:01.410308,17.640561
channel-750,684828,30346499,30346511,12,2025-02-25 20:23:44.844222,2025-02-25 20:24:01.410308,16.566086
channel-750,684829,30346501,30346511,10,2025-02-25 20:23:48.308248,2025-02-25 20:24:01.410308,13.10206
channel-750,684830,30346508,30346524,16,2025-02-25 20:23:56.929991,2025-02-25 20:24:17.453394,20.523403
channel-750,684831,30346511,30346515,4,2025-02-25 20:24:01.410308,2025-02-25 20:24:07.091108,5.6808
channel-750,684832,30346523,30346536,13,2025-02-25 20:24:16.354707,2025-02-25 20:24:32.477770,16.123063
channel-750,684833,30346524,30346538,14,2025-02-25 20:24:17.453394,2025-02-25 20:24:39.863258,22.409864
channel-750,684834,30346526,30346545,19,2025-02-25 20:24:20.638795,2025-02-25 20:24:48.990472,28.351677
channel-750,684835,30346533,30346543,10,2025-02-25 20:24:29.113770,2025-02-25 20:24:45.728430,16.61466
channel-750,684836,30346533,30346543,10,2025-02-25 20:24:29.113770,2025-02-25 20:24:45.728430,16.61466
channel-750,684837,30346548,30346560,12,2025-02-25 20:24:52.503783,2025-02-25 20:25:11.117777,18.613994
channel-750,684838,30346551,30346556,5,2025-02-25 20:24:56.218303,2025-02-25 20:25:05.648367,9.430064
channel-750,684839,30346563,30346574,11,2025-02-25 20:25:15.963798,2025-02-25 20:25:28.968900,13.005102
channel-750,684840,30346565,30346577,12,2025-02-25 20:25:18.149660,2025-02-25 20:25:32.297037,14.147377
channel-750,684841,30346568,30346578,10,2025-02-25 20:25:21.476029,2025-02-25 20:25:33.411173,11.935144
channel-750,684842,30346580,30346590,10,2025-02-25 20:25:35.653385,2025-02-25 20:25:47.841741,12.188356
channel-750,684843,30346584,30346617,33,2025-02-25 20:25:39.957776,2025-02-25 20:26:21.758484,41.800708
channel-750,684844,30346592,30346606,14,2025-02-25 20:25:50.322682,2025-02-25 20:26:07.033550,16.710868
channel-750,684845,30346604,30346615,11,2025-02-25 20:26:04.137652,2025-02-25 20:26:19.332359,15.194707
channel-750,684846,30346604,30346612,8,2025-02-25 20:26:04.137652,2025-02-25 20:26:15.881890,11.744238
channel-750,684847,30346605,30346619,14,2025-02-25 20:26:05.821688,2025-02-25 20:26:23.970654,18.148966
channel-750,684848,30346606,30346611,5,2025-02-25 20:26:07.033550,2025-02-25 20:26:14.787492,7.753942
channel-750,684849,30346618,30346628,10,2025-02-25 20:26:22.797462,2025-02-25 20:26:37.131126,14.333664
channel-750,684850,30346620,30346638,18,2025-02-25 20:26:25.073481,2025-02-25 20:26:49.525878,24.452397
channel-750,684851,30346622,30346638,16,2025-02-25 20:26:28.474839,2025-02-25 20:26:49.525878,21.051039
channel-750,684852,30346627,30346639,12,2025-02-25 20:26:35.960352,2025-02-25 20:26:50.644638,14.684286
channel-750,684853,30346634,30346641,7,2025-02-25 20:26:44.424728,2025-02-25 20:26:56.100849,11.676121
channel-750,684854,30346657,30346682,25,2025-02-25 20:27:16.360674,2025-02-25 20:27:46.897812,30.537138
channel-750,684855,30346666,30346670,4,2025-02-25 20:27:27.748678,2025-02-25 20:27:32.877504,5.128826
channel-750,684856,30346676,30346688,12,2025-02-25 20:27:39.928449,2025-02-25 20:27:53.791671,13.863222
channel-750,684857,30346704,30346709,5,2025-02-25 20:28:13.529689,2025-02-25 20:28:21.512400,7.982711
channel-750,684858,30346705,30346715,10,2025-02-25 20:28:15.641843,2025-02-25 20:28:30.593400,14.951557
channel-750,684859,30346713,30346723,10,2025-02-25 20:28:27.282971,2025-02-25 20:28:40.718783,13.435812
channel-750,684860,30346719,30346739,20,2025-02-25 20:28:35.153825,2025-02-25 20:29:01.632561,26.478736
channel-750,684861,30346744,30346755,11,2025-02-25 20:29:07.328418,2025-02-25 20:29:21.280655,13.952237
channel-750,684862,30346758,30346763,5,2025-02-25 20:29:24.610477,2025-02-25 20:29:30.308939,5.698462
channel-750,684863,30346760,30346779,19,2025-02-25 20:29:26.967499,2025-02-25 20:29:50.860778,23.893279
channel-750,684864,30346775,30346785,10,2025-02-25 20:29:46.176744,2025-02-25 20:29:57.941249,11.764505
channel-750,684865,30346778,30346800,22,2025-02-25 20:29:49.728241,2025-02-25 20:30:19.104319,29.376078
channel-750,684866,30346816,30346827,11,2025-02-25 20:30:38.126707,2025-02-25 20:30:53.485081,15.358374
channel-750,684867,30346833,30346859,26,2025-02-25 20:31:00.253946,2025-02-25 20:31:36.349405,36.095459
channel-750,684868,30346833,30346850,17,2025-02-25 20:31:00.253946,2025-02-25 20:31:26.042016,25.78807
channel-750,684869,30346890,30346913,23,2025-02-25 20:32:18.823287,2025-02-25 20:32:48.731035,29.907748
channel-750,684870,30346900,30346916,16,2025-02-25 20:32:33.775334,2025-02-25 20:32:52.084023,18.308689
channel-750,684871,30346902,30346924,22,2025-02-25 20:32:35.982045,2025-02-25 20:33:01.421128,25.439083
channel-750,684872,30346948,30346960,12,2025-02-25 20:33:32.767439,2025-02-25 20:33:46.847804,14.080365
channel-750,684873,30346952,30346963,11,2025-02-25 20:33:37.511721,2025-02-25 20:33:51.357302,13.845581
channel-750,684874,30346956,30346965,9,2025-02-25 20:33:42.379902,2025-02-25 20:33:54.582872,12.20297
channel-750,684875,30346961,30346981,20,2025-02-25 20:33:48.076496,2025-02-25 20:34:16.858558,28.782062
channel-750,684876,30346964,30346971,7,2025-02-25 20:33:53.502016,2025-02-25 20:34:05.231215,11.729199
channel-750,684877,30346982,30347000,18,2025-02-25 20:34:18.022841,2025-02-25 20:34:41.913207,23.890366
channel-750,684878,30346992,30347002,10,2025-02-25 20:34:30.151122,2025-02-25 20:34:44.265005,14.113883
channel-750,684879,30347011,30347023,12,2025-02-25 20:34:54.493638,2025-02-25 20:35:08.339249,13.845611
channel-750,684880,30347017,30347041,24,2025-02-25 20:35:01.319881,2025-02-25 20:35:32.887048,31.567167
channel-750,684881,30347017,30347027,10,2025-02-25 20:35:01.319881,2025-02-25 20:35:14.857287,13.537406
channel-750,684882,30347018,30347034,16,2025-02-25 20:35:02.513598,2025-02-25 20:35:23.728134,21.214536
channel-750,684883,30347039,30347045,6,2025-02-25 20:35:30.645942,2025-02-25 20:35:42.026134,11.380192
channel-750,684884,30347041,30347058,17,2025-02-25 20:35:32.887048,2025-02-25 20:35:59.044086,26.157038
channel-750,684885,30347041,30347055,14,2025-02-25 20:35:32.887048,2025-02-25 20:35:55.647001,22.759953
channel-750,684886,30347042,30347053,11,2025-02-25 20:35:37.552034,2025-02-25 20:35:51.633270,14.081236
channel-750,684887,30347055,30347065,10,2025-02-25 20:35:55.647001,2025-02-25 20:36:08.813384,13.166383
channel-750,684888,30347060,30347083,23,2025-02-25 20:36:01.364952,2025-02-25 20:36:29.940694,28.575742
channel-750,684889,30347092,30347098,6,2025-02-25 20:36:40.939626,2025-02-25 20:36:48.976737,8.037111
channel-750,684890,30347112,30347136,24,2025-02-25 20:37:05.757962,2025-02-25 20:37:34.806832,29.04887
channel-750,684891,30347120,30347128,8,2025-02-25 20:37:14.669832,2025-02-25 20:37:24.809696,10.139864
channel-750,684892,30347124,30347135,11,2025-02-25 20:37:19.369977,2025-02-25 20:37:33.629188,14.259211
channel-750,684893,30347144,30347162,18,2025-02-25 20:37:46.658380,2025-02-25 20:38:10.209085,23.550705
channel-750,684894,30347145,30347153,8,2025-02-25 20:37:47.822151,2025-02-25 20:37:59.244948,11.422797
channel-750,684895,30347151,30347177,26,2025-02-25 20:37:55.915427,2025-02-25 20:38:27.502159,31.586732
channel-750,684896,30347152,30347162,10,2025-02-25 20:37:57.111876,2025-02-25 20:38:10.209085,13.097209
channel-750,684897,30347152,30347166,14,2025-02-25 20:37:57.111876,2025-02-25 20:38:14.632187,17.520311
channel-750,684898,30347167,30347188,21,2025-02-25 20:38:15.905191,2025-02-25 20:38:43.355124,27.449933
channel-750,684899,30347190,30347203,13,2025-02-25 20:38:45.698780,2025-02-25 20:39:01.545934,15.847154
channel-750,684900,30347202,30347211,9,2025-02-25 20:39:00.257243,2025-02-25 20:39:11.536261,11.279018
channel-750,684901,30347228,30347250,22,2025-02-25 20:39:34.391271,2025-02-25 20:40:05.834694,31.443423
channel-750,684902,30347233,30347245,12,2025-02-25 20:39:40.125635,2025-02-25 20:39:59.210995,19.08536
channel-750,684903,30347234,30347237,3,2025-02-25 20:39:41.201288,2025-02-25 20:39:46.835384,5.634096
channel-750,684904,30347265,30347278,13,2025-02-25 20:40:25.323607,2025-02-25 20:40:42.765771,17.442164
channel-750,684905,30347269,30347272,3,2025-02-25 20:40:31.358155,2025-02-25 20:40:34.825067,3.466912
channel-750,684906,30347277,30347288,11,2025-02-25 20:40:41.579870,2025-02-25 20:40:55.809399,14.229529
channel-750,684907,30347283,30347318,35,2025-02-25 20:40:49.802848,2025-02-25 20:41:32.689975,42.887127
channel-750,684908,30347293,30347310,17,2025-02-25 20:41:01.993668,2025-02-25 20:41:21.616478,19.62281
channel-750,684909,30347331,30347342,11,2025-02-25 20:41:47.768858,2025-02-25 20:42:04.214630,16.445772
channel-750,684910,30347360,30347382,22,2025-02-25 20:42:26.135153,2025-02-25 20:42:54.963159,28.828006
channel-750,684911,30347392,30347396,4,2025-02-25 20:43:07.077796,2025-02-25 20:43:11.519633,4.441837
channel-750,684912,30347400,30347418,18,2025-02-25 20:43:18.865919,2025-02-25 20:43:40.972920,22.107001
channel-750,684913,30347411,30347437,26,2025-02-25 20:43:32.722081,2025-02-25 20:44:04.415175,31.693094
channel-750,684914,30347413,30347417,4,2025-02-25 20:43:35.095494,2025-02-25 20:43:39.569765,4.474271
channel-750,684915,30347420,30347424,4,2025-02-25 20:43:43.214696,2025-02-25 20:43:47.807545,4.592849
channel-750,684916,30347421,30347433,12,2025-02-25 20:43:44.356884,2025-02-25 20:43:59.945524,15.58864
channel-750,684917,30347427,30347443,16,2025-02-25 20:43:51.793094,2025-02-25 20:44:11.316140,19.523046
channel-750,684918,30347467,30347489,22,2025-02-25 20:44:46.086132,2025-02-25 20:45:15.609710,29.523578
channel-750,684919,30347467,30347481,14,2025-02-25 20:44:46.086132,2025-02-25 20:45:03.803300,17.717168
channel-750,684920,30347527,30347551,24,2025-02-25 20:46:02.193488,2025-02-25 20:46:30.832971,28.639483
channel-750,684921,30347589,30347611,22,2025-02-25 20:47:23.707107,2025-02-25 20:47:50.868653,27.161546
channel-750,684922,30347595,30347600,5,2025-02-25 20:47:30.971871,2025-02-25 20:47:36.545833,5.573962
channel-750,684923,30347600,30347605,5,2025-02-25 20:47:36.545833,2025-02-25 20:47:43.146086,6.600253
channel-750,684924,30347621,30347626,5,2025-02-25 20:48:03.762498,2025-02-25 20:48:09.721036,5.958538
channel-750,684925,30347639,30347644,5,2025-02-25 20:48:25.798044,2025-02-25 20:48:32.420808,6.622764
channel-750,684926,30347653,30347686,33,2025-02-25 20:48:43.762377,2025-02-25 20:49:29.562913,45.800536
channel-750,684927,30347693,30347700,7,2025-02-25 20:49:39.224397,2025-02-25 20:49:47.423336,8.198939
channel-750,684928,30347717,30347741,24,2025-02-25 20:50:07.666553,2025-02-25 20:50:36.964204,29.297651
channel-750,684929,30347738,30347742,4,2025-02-25 20:50:33.547902,2025-02-25 20:50:38.094652,4.54675
channel-750,684930,30347778,30347792,14,2025-02-25 20:51:23.409117,2025-02-25 20:51:41.496780,18.087663
channel-750,684931,30347785,30347806,21,2025-02-25 20:51:31.488917,2025-02-25 20:52:00.670221,29.181304
channel-750,684932,30347843,30347863,20,2025-02-25 20:52:47.547173,2025-02-25 20:53:13.337797,25.790624
channel-750,684933,30347887,30347893,6,2025-02-25 20:53:46.097098,2025-02-25 20:53:53.207385,7.110287
channel-750,684934,30347904,30347927,23,2025-02-25 20:54:08.803476,2025-02-25 20:54:38.317713,29.514237
channel-750,684935,30347980,30348013,33,2025-02-25 20:55:44.470072,2025-02-25 20:56:27.785652,43.31558
channel-750,684936,30348004,30348013,9,2025-02-25 20:56:13.496273,2025-02-25 20:56:27.785652,14.289379
channel-750,684937,30348036,30348060,24,2025-02-25 20:56:55.328917,2025-02-25 20:57:25.253449,29.924532
channel-750,684938,30348093,30348115,22,2025-02-25 20:58:10.578847,2025-02-25 20:58:41.454867,30.87602
channel-750,684939,30348152,30348175,23,2025-02-25 20:59:27.313839,2025-02-25 20:59:54.142702,26.828863
channel-750,684940,30348191,30348196,5,2025-02-25 21:00:14.764536,2025-02-25 21:00:20.426413,5.661877
channel-750,684941,30348197,30348208,11,2025-02-25 21:00:21.531491,2025-02-25 21:00:36.572548,15.041057
channel-750,684942,30348235,30348259,24,2025-02-25 21:01:09.900586,2025-02-25 21:01:40.541656,30.64107
channel-750,684943,30348295,30348316,21,2025-02-25 21:02:32.742656,2025-02-25 21:02:57.983336,25.24068
channel-750,684944,30348340,30348349,9,2025-02-25 21:03:27.998596,2025-02-25 21:03:39.819771,11.821175
channel-750,684945,30348349,30348373,24,2025-02-25 21:03:39.819771,2025-02-25 21:04:10.706628,30.886857
channel-750,684946,30348397,30348420,23,2025-02-25 21:04:43.272593,2025-02-25 21:05:14.966504,31.693911
channel-750,684947,30348411,30348421,10,2025-02-25 21:05:03.254069,2025-02-25 21:05:16.668686,13.414617
channel-750,684948,30348452,30348474,22,2025-02-25 21:05:57.563918,2025-02-25 21:06:24.441556,26.877638
channel-750,684949,30348517,30348537,20,2025-02-25 21:07:19.309299,2025-02-25 21:07:45.976269,26.66697
channel-750,684950,30348522,30348532,10,2025-02-25 21:07:25.868309,2025-02-25 21:07:39.139809,13.2715
channel-750,684951,30348573,30348592,19,2025-02-25 21:08:31.033127,2025-02-25 21:08:57.205786,26.172659
channel-750,684952,30348606,30348608,2,2025-02-25 21:09:13.719193,2025-02-25 21:09:16.585543,2.86635
channel-750,684953,30348608,30348625,17,2025-02-25 21:09:16.585543,2025-02-25 21:09:41.346646,24.761103
channel-750,684954,30348619,30348628,9,2025-02-25 21:09:33.110363,2025-02-25 21:09:44.737424,11.627061
channel-750,684955,30348622,30348627,5,2025-02-25 21:09:36.791102,2025-02-25 21:09:43.628648,6.837546
channel-750,684956,30348632,30348659,27,2025-02-25 21:09:49.563790,2025-02-25 21:10:26.321197,36.757407
channel-750,684957,30348647,30348668,21,2025-02-25 21:10:09.450414,2025-02-25 21:10:37.028090,27.577676
channel-750,684958,30348647,30348655,8,2025-02-25 21:10:09.450414,2025-02-25 21:10:20.376605,10.926191
channel-750,684959,30348696,30348721,25,2025-02-25 21:11:12.272319,2025-02-25 21:11:47.382231,35.109912
channel-750,684960,30348746,30348758,12,2025-02-25 21:12:19.238474,2025-02-25 21:12:34.723061,15.484587
channel-750,684961,30348755,30348776,21,2025-02-25 21:12:30.192714,2025-02-25 21:12:59.386101,29.193387
channel-750,684962,30348815,30348826,11,2025-02-25 21:13:48.197825,2025-02-25 21:14:01.953574,13.755749
channel-750,684963,30348822,30348847,25,2025-02-25 21:13:57.323367,2025-02-25 21:14:29.374778,32.051411
channel-750,684964,30348865,30348869,4,2025-02-25 21:14:54.354208,2025-02-25 21:14:59.518603,5.164395
channel-750,684965,30348878,30348900,22,2025-02-25 21:15:11.891556,2025-02-25 21:15:38.971987,27.080431
channel-750,684966,30348906,30348911,5,2025-02-25 21:15:49.613512,2025-02-25 21:15:55.258812,5.6453
channel-750,684967,30348958,30348977,19,2025-02-25 21:16:52.228782,2025-02-25 21:17:18.715403,26.486621
channel-750,684968,30349019,30349041,22,2025-02-25 21:18:11.564165,2025-02-25 21:18:41.455683,29.891518
channel-750,684969,30349029,30349034,5,2025-02-25 21:18:24.167620,2025-02-25 21:18:30.699519,6.531899
channel-750,684970,30349083,30349108,25,2025-02-25 21:19:34.351622,2025-02-25 21:20:04.604605,30.252983
channel-750,684971,30349086,30349090,4,2025-02-25 21:19:37.735222,2025-02-25 21:19:43.619669,5.884447
channel-750,684972,30349137,30349181,44,2025-02-25 21:20:44.769021,2025-02-25 21:21:38.941857,54.172836
channel-750,684973,30349140,30349144,4,2025-02-25 21:20:48.140559,2025-02-25 21:20:52.477004,4.336445
channel-750,684974,30349154,30349175,21,2025-02-25 21:21:05.066780,2025-02-25 21:21:30.966063,25.899283
channel-750,684975,30349203,30349223,20,2025-02-25 21:22:08.552129,2025-02-25 21:22:36.619887,28.067758
channel-750,684976,30349264,30349287,23,2025-02-25 21:23:26.288988,2025-02-25 21:23:53.313294,27.024306
channel-750,684977,30349324,30349346,22,2025-02-25 21:24:43.725109,2025-02-25 21:25:11.739336,28.014227
channel-750,684978,30349340,30349347,7,2025-02-25 21:25:03.756666,2025-02-25 21:25:12.794964,9.038298
channel-750,684979,30349381,30349408,27,2025-02-25 21:25:56.840362,2025-02-25 21:26:36.239399,39.399037
channel-750,684980,30349421,30349436,15,2025-02-25 21:26:51.402592,2025-02-25 21:27:10.699672,19.29708
channel-750,684981,30349432,30349436,4,2025-02-25 21:27:04.876736,2025-02-25 21:27:10.699672,5.822936
channel-750,684982,30349444,30349463,19,2025-02-25 21:27:20.724247,2025-02-25 21:27:45.370888,24.646641
channel-750,684983,30349452,30349464,12,2025-02-25 21:27:30.646545,2025-02-25 21:27:46.630396,15.983851
channel-750,684984,30349506,30349526,20,2025-02-25 21:28:38.035125,2025-02-25 21:29:08.240740,30.205615
channel-750,684985,30349565,30349584,19,2025-02-25 21:29:56.482580,2025-02-25 21:30:19.277715,22.795135
channel-750,684986,30349630,30349651,21,2025-02-25 21:31:16.449445,2025-02-25 21:31:45.518283,29.068838
channel-750,684987,30349691,30349716,25,2025-02-25 21:32:35.667641,2025-02-25 21:33:04.832379,29.164738
channel-750,684988,30349716,30349732,16,2025-02-25 21:33:04.832379,2025-02-25 21:33:30.734759,25.90238
channel-750,684989,30349752,30349773,21,2025-02-25 21:33:54.661385,2025-02-25 21:34:20.516533,25.855148
channel-750,684990,30349808,30349827,19,2025-02-25 21:35:02.920050,2025-02-25 21:35:29.152675,26.232625
channel-750,684991,30349819,30349825,6,2025-02-25 21:35:19.693284,2025-02-25 21:35:26.966979,7.273695
channel-750,684992,30349879,30349902,23,2025-02-25 21:36:36.220738,2025-02-25 21:37:06.077101,29.856363
channel-750,684993,30349940,30349960,20,2025-02-25 21:37:54.620890,2025-02-25 21:38:26.303584,31.682694
channel-750,684994,30349987,30349991,4,2025-02-25 21:38:59.152560,2025-02-25 21:39:04.150429,4.997869
channel-750,684995,30349995,30350020,25,2025-02-25 21:39:10.226852,2025-02-25 21:39:39.031540,28.804688
channel-750,684996,30350073,30350101,28,2025-02-25 21:40:45.348808,2025-02-25 21:41:21.548570,36.199762
channel-750,684997,30350183,30350196,13,2025-02-25 21:43:07.539940,2025-02-25 21:43:23.329263,15.789323
channel-750,684998,30350229,30350234,5,2025-02-25 21:44:04.945026,2025-02-25 21:44:10.411083,5.466057
channel-750,684999,30350232,30350246,14,2025-02-25 21:44:08.208567,2025-02-25 21:44:23.984135,15.775568
channel-750,685000,30350270,30350292,22,2025-02-25 21:44:56.358950,2025-02-25 21:45:24.544904,28.185954
channel-750,685001,30350300,30350313,13,2025-02-25 21:45:33.615172,2025-02-25 21:45:51.440829,17.825657
channel-750,685002,30350313,30350342,29,2025-02-25 21:45:51.440829,2025-02-25 21:46:32.927192,41.486363
channel-750,685003,30350360,30350385,25,2025-02-25 21:46:55.009004,2025-02-25 21:47:26.779184,31.77018
channel-750,685004,30350385,30350411,26,2025-02-25 21:47:26.779184,2025-02-25 21:47:58.920920,32.141736
channel-750,685005,30350403,30350434,31,2025-02-25 21:47:48.554130,2025-02-25 21:48:29.584391,41.030261
channel-750,685006,30350419,30350439,20,2025-02-25 21:48:09.585236,2025-02-25 21:48:35.518125,25.932889
channel-750,685007,30350438,30350442,4,2025-02-25 21:48:34.422446,2025-02-25 21:48:39.343943,4.921497
channel-750,685008,30350445,30350455,10,2025-02-25 21:48:42.767748,2025-02-25 21:48:54.973220,12.205472
channel-750,685009,30350516,30350533,17,2025-02-25 21:50:17.905011,2025-02-25 21:50:38.240291,20.33528
channel-750,685010,30350590,30350621,31,2025-02-25 21:51:53.956429,2025-02-25 21:52:33.014069,39.05764
channel-750,685011,30350638,30350667,29,2025-02-25 21:52:52.532853,2025-02-25 21:53:28.424674,35.891821
channel-750,685012,30350668,30350674,6,2025-02-25 21:53:29.538380,2025-02-25 21:53:36.619977,7.081597
channel-750,685013,30350680,30350708,28,2025-02-25 21:53:45.624293,2025-02-25 21:54:21.937133,36.31284
channel-750,685014,30350705,30350714,9,2025-02-25 21:54:17.681111,2025-02-25 21:54:29.315652,11.634541
channel-750,685015,30350713,30350729,16,2025-02-25 21:54:28.162886,2025-02-25 21:54:46.202553,18.039667
channel-750,685016,30350716,30350740,24,2025-02-25 21:54:31.591165,2025-02-25 21:54:59.477867,27.886702
channel-750,685017,30350748,30350759,11,2025-02-25 21:55:09.489599,2025-02-25 21:55:24.655564,15.165965
channel-750,685018,30350762,30350785,23,2025-02-25 21:55:28.089022,2025-02-25 21:56:03.142834,35.053812
channel-750,685019,30350797,30350828,31,2025-02-25 21:56:18.514096,2025-02-25 21:56:56.894463,38.380367
channel-750,685020,30350832,30350844,12,2025-02-25 21:57:02.702620,2025-02-25 21:57:17.239181,14.536561
channel-750,685021,30350838,30350861,23,2025-02-25 21:57:09.435691,2025-02-25 21:57:41.131959,31.696268
channel-750,685022,30350843,30350849,6,2025-02-25 21:57:16.107089,2025-02-25 21:57:23.092691,6.985602
channel-750,685023,30350861,30350866,5,2025-02-25 21:57:41.131959,2025-02-25 21:57:46.776978,5.645019
channel-750,685024,30350869,30350879,10,2025-02-25 21:57:50.498787,2025-02-25 21:58:02.285989,11.787202
channel-750,685025,30350877,30350905,28,2025-02-25 21:57:59.980144,2025-02-25 21:58:37.383852,37.403708
channel-750,685026,30350905,30350919,14,2025-02-25 21:58:37.383852,2025-02-25 21:58:54.132434,16.748582
channel-750,685027,30350911,30350916,5,2025-02-25 21:58:44.959152,2025-02-25 21:58:50.753072,5.79392
channel-750,685028,30350912,30350925,13,2025-02-25 21:58:46.223393,2025-02-25 21:59:01.008459,14.785066
channel-750,685029,30350916,30350938,22,2025-02-25 21:58:50.753072,2025-02-25 21:59:16.286996,25.533924
channel-750,685030,30350947,30350955,8,2025-02-25 21:59:31.748272,2025-02-25 21:59:40.842968,9.094696
channel-750,685031,30350959,30350983,24,2025-02-25 21:59:46.496073,2025-02-25 22:00:17.497023,31.00095
channel-750,685032,30350981,30350986,5,2025-02-25 22:00:12.027515,2025-02-25 22:00:20.910083,8.882568
channel-750,685033,30350987,30350992,5,2025-02-25 22:00:22.051529,2025-02-25 22:00:28.722865,6.671336
channel-750,685034,30351012,30351026,14,2025-02-25 22:00:54.918669,2025-02-25 22:01:13.222005,18.303336
channel-750,685035,30351015,30351030,15,2025-02-25 22:00:58.135763,2025-02-25 22:01:17.664331,19.528568
channel-750,685036,30351019,30351042,23,2025-02-25 22:01:03.587785,2025-02-25 22:01:34.462263,30.874478
channel-750,685037,30351046,30351050,4,2025-02-25 22:01:39.534744,2025-02-25 22:01:45.257200,5.722456
channel-750,685038,30351065,30351087,22,2025-02-25 22:02:02.697882,2025-02-25 22:02:29.616251,26.918369
channel-750,685039,30351080,30351084,4,2025-02-25 22:02:21.184680,2025-02-25 22:02:25.729271,4.544591
channel-750,685040,30351111,30351133,22,2025-02-25 22:02:59.925744,2025-02-25 22:03:29.970563,30.044819
channel-750,685041,30351113,30351121,8,2025-02-25 22:03:05.378576,2025-02-25 22:03:16.308609,10.930033
channel-750,685042,30351155,30351174,19,2025-02-25 22:03:58.149877,2025-02-25 22:04:23.509286,25.359409
channel-750,685043,30351173,30351186,13,2025-02-25 22:04:22.455474,2025-02-25 22:04:38.674691,16.219217
channel-750,685044,30351190,30351199,9,2025-02-25 22:04:43.371703,2025-02-25 22:04:55.308332,11.936629
channel-750,685045,30351194,30351216,22,2025-02-25 22:04:48.275699,2025-02-25 22:05:17.855260,29.579561
channel-750,685046,30351196,30351204,8,2025-02-25 22:04:51.718196,2025-02-25 22:05:03.226552,11.508356
channel-750,685047,30351204,30351215,11,2025-02-25 22:05:03.226552,2025-02-25 22:05:16.753804,13.527252
channel-750,685048,30351232,30351255,23,2025-02-25 22:05:38.556520,2025-02-25 22:06:07.817499,29.260979
channel-750,685049,30351239,30351255,16,2025-02-25 22:05:48.195981,2025-02-25 22:06:07.817499,19.621518
channel-750,685050,30351245,30351255,10,2025-02-25 22:05:56.176106,2025-02-25 22:06:07.817499,11.641393
channel-750,685051,30351248,30351259,11,2025-02-25 22:05:59.687080,2025-02-25 22:06:13.288898,13.601818
channel-750,685052,30351261,30351275,14,2025-02-25 22:06:15.682006,2025-02-25 22:06:33.127652,17.445646
channel-750,685053,30351266,30351277,11,2025-02-25 22:06:22.503289,2025-02-25 22:06:35.510156,13.006867
channel-750,685054,30351271,30351281,10,2025-02-25 22:06:28.791902,2025-02-25 22:06:40.432113,11.640211
channel-750,685055,30351274,30351296,22,2025-02-25 22:06:32.007797,2025-02-25 22:07:01.060654,29.052857
channel-750,685056,30351294,30351307,13,2025-02-25 22:06:58.758653,2025-02-25 22:07:14.169775,15.411122
channel-750,685057,30351315,30351335,20,2025-02-25 22:07:23.540517,2025-02-25 22:07:52.600582,29.060065
channel-750,685058,30351319,30351328,9,2025-02-25 22:07:29.078032,2025-02-25 22:07:41.667016,12.588984
channel-750,685059,30351325,30351335,10,2025-02-25 22:07:37.315110,2025-02-25 22:07:52.600582,15.285472
channel-750,685060,30351336,30351347,11,2025-02-25 22:07:53.731346,2025-02-25 22:08:07.158182,13.426836
channel-750,685061,30351354,30351368,14,2025-02-25 22:08:18.399807,2025-02-25 22:08:36.374579,17.974772
channel-750,685062,30351356,30351377,21,2025-02-25 22:08:21.813141,2025-02-25 22:08:48.578653,26.765512
channel-750,685063,30351359,30351364,5,2025-02-25 22:08:25.239181,2025-02-25 22:08:31.059888,5.820707
channel-750,685064,30351362,30351366,4,2025-02-25 22:08:28.742184,2025-02-25 22:08:33.970824,5.22864
channel-750,685065,30351378,30351407,29,2025-02-25 22:08:49.680877,2025-02-25 22:09:28.449133,38.768256
channel-750,685066,30351381,30351390,9,2025-02-25 22:08:54.490615,2025-02-25 22:09:07.700923,13.210308
channel-750,685067,30351398,30351408,10,2025-02-25 22:09:17.497666,2025-02-25 22:09:29.618498,12.120832
channel-750,685068,30351403,30351427,24,2025-02-25 22:09:23.968398,2025-02-25 22:09:52.227551,28.259153
channel-750,685069,30351404,30351410,6,2025-02-25 22:09:25.083692,2025-02-25 22:09:31.587112,6.50342
channel-750,685070,30351445,30351466,21,2025-02-25 22:10:16.043475,2025-02-25 22:10:44.124606,28.081131
channel-750,685071,30351455,30351465,10,2025-02-25 22:10:28.138813,2025-02-25 22:10:42.256241,14.117428
channel-750,685072,30351474,30351489,15,2025-02-25 22:10:54.107875,2025-02-25 22:11:12.779872,18.671997
channel-750,685073,30351474,30351480,6,2025-02-25 22:10:54.107875,2025-02-25 22:11:02.365268,8.257393
channel-750,685074,30351480,30351491,11,2025-02-25 22:11:02.365268,2025-02-25 22:11:15.124058,12.75879
channel-750,685075,30351480,30351485,5,2025-02-25 22:11:02.365268,2025-02-25 22:11:08.152659,5.787391
channel-750,685076,30351483,30351498,15,2025-02-25 22:11:05.997396,2025-02-25 22:11:23.659115,17.661719
channel-750,685077,30351485,30351520,35,2025-02-25 22:11:08.152659,2025-02-25 22:11:50.836555,42.683896
channel-750,685078,30351511,30351522,11,2025-02-25 22:11:39.505939,2025-02-25 22:11:53.053278,13.547339
channel-750,685079,30351529,30351547,18,2025-02-25 22:12:02.337082,2025-02-25 22:12:26.367222,24.03014
channel-750,685080,30351567,30351589,22,2025-02-25 22:12:54.041331,2025-02-25 22:13:21.651402,27.610071
channel-750,685081,30351607,30351629,22,2025-02-25 22:13:47.072530,2025-02-25 22:14:13.874697,26.802167
channel-750,685082,30351653,30351679,26,2025-02-25 22:14:45.560916,2025-02-25 22:15:18.978279,33.417363
channel-750,685083,30351666,30351686,20,2025-02-25 22:15:03.032343,2025-02-25 22:15:26.927555,23.895212
channel-750,685084,30351671,30351676,5,2025-02-25 22:15:09.816951,2025-02-25 22:15:15.600194,5.783243
channel-750,685085,30351692,30351718,26,2025-02-25 22:15:34.986524,2025-02-25 22:16:07.594864,32.60834
channel-750,685086,30351726,30351731,5,2025-02-25 22:16:20.850131,2025-02-25 22:16:27.108042,6.257911
channel-750,685087,30351743,30351752,9,2025-02-25 22:16:41.343615,2025-02-25 22:16:52.234700,10.891085
channel-750,685088,30351755,30351777,22,2025-02-25 22:16:56.555731,2025-02-25 22:17:25.611440,29.055709
channel-750,685089,30351804,30351827,23,2025-02-25 22:18:02.962125,2025-02-25 22:18:35.672559,32.710434
channel-750,685090,30351809,30351830,21,2025-02-25 22:18:09.489261,2025-02-25 22:18:38.917246,29.427985
channel-750,685091,30351809,30351817,8,2025-02-25 22:18:09.489261,2025-02-25 22:18:21.267840,11.778579
channel-750,685092,30351833,30351846,13,2025-02-25 22:18:42.233606,2025-02-25 22:18:57.344398,15.110792
channel-750,685093,30351863,30351871,8,2025-02-25 22:19:19.132812,2025-02-25 22:19:29.307884,10.175072
channel-750,685094,30351912,30351917,5,2025-02-25 22:20:24.315724,2025-02-25 22:20:29.799658,5.483934
channel-750,685095,30351956,30351965,9,2025-02-25 22:21:16.793261,2025-02-25 22:21:27.998138,11.204877
channel-750,685096,30351957,30351967,10,2025-02-25 22:21:17.906620,2025-02-25 22:21:31.423383,13.516763
channel-750,685097,30352003,30352025,22,2025-02-25 22:22:18.472346,2025-02-25 22:22:50.430186,31.95784
channel-750,685098,30352016,30352021,5,2025-02-25 22:22:39.289052,2025-02-25 22:22:44.983722,5.69467
channel-750,685099,30352051,30352069,18,2025-02-25 22:23:19.951391,2025-02-25 22:23:43.571607,23.620216
channel-750,685100,30352054,30352060,6,2025-02-25 22:23:24.382981,2025-02-25 22:23:31.955455,7.572474
channel-750,685101,30352092,30352116,24,2025-02-25 22:24:12.068995,2025-02-25 22:24:41.539498,29.470503
channel-750,685102,30352100,30352117,17,2025-02-25 22:24:22.211695,2025-02-25 22:24:42.657911,20.446216
channel-750,685103,30352133,30352149,16,2025-02-25 22:25:03.718903,2025-02-25 22:25:24.087679,20.368776
channel-750,685104,30352135,30352154,19,2025-02-25 22:25:07.059440,2025-02-25 22:25:33.174302,26.114862
channel-750,685105,30352179,30352199,20,2025-02-25 22:26:02.642729,2025-02-25 22:26:29.210860,26.568131
channel-750,685106,30352220,30352240,20,2025-02-25 22:26:58.279606,2025-02-25 22:27:22.768031,24.488425
channel-750,685107,30352263,30352285,22,2025-02-25 22:27:50.522758,2025-02-25 22:28:18.308492,27.785734
channel-750,685108,30352306,30352326,20,2025-02-25 22:28:45.800637,2025-02-25 22:29:13.568671,27.768034
channel-750,685109,30352314,30352318,4,2025-02-25 22:28:56.245166,2025-02-25 22:29:02.864858,6.619692
channel-750,685110,30352349,30352371,22,2025-02-25 22:29:41.007017,2025-02-25 22:30:07.908371,26.901354
channel-750,685111,30352374,30352393,19,2025-02-25 22:30:11.486817,2025-02-25 22:30:35.560427,24.07361
channel-750,685112,30352397,30352420,23,2025-02-25 22:30:39.887570,2025-02-25 22:31:15.366709,35.479139
channel-750,685113,30352398,30352402,4,2025-02-25 22:30:41.031408,2025-02-25 22:30:46.874193,5.842785
channel-750,685114,30352434,30352458,24,2025-02-25 22:31:31.629588,2025-02-25 22:32:04.117924,32.488336
channel-750,685115,30352438,30352459,21,2025-02-25 22:31:37.772693,2025-02-25 22:32:05.333217,27.560524
channel-750,685116,30352477,30352500,23,2025-02-25 22:32:25.738019,2025-02-25 22:32:56.285492,30.547473
channel-750,685117,30352479,30352488,9,2025-02-25 22:32:27.935149,2025-02-25 22:32:39.687567,11.752418
channel-750,685118,30352481,30352485,4,2025-02-25 22:32:29.999850,2025-02-25 22:32:35.194693,5.194843
channel-750,685119,30352514,30352540,26,2025-02-25 22:33:13.960898,2025-02-25 22:33:45.745527,31.784629
channel-750,685120,30352519,30352536,17,2025-02-25 22:33:21.045146,2025-02-25 22:33:41.450341,20.405195
channel-750,685121,30352558,30352577,19,2025-02-25 22:34:07.315892,2025-02-25 22:34:30.291879,22.975987
channel-750,685122,30352594,30352609,15,2025-02-25 22:34:53.971516,2025-02-25 22:35:12.674693,18.703177
channel-750,685123,30352598,30352603,5,2025-02-25 22:34:59.523438,2025-02-25 22:35:05.710161,6.186723
channel-750,685124,30352605,30352625,20,2025-02-25 22:35:07.969912,2025-02-25 22:35:33.898362,25.92845
channel-750,685125,30352654,30352676,22,2025-02-25 22:36:13.638391,2025-02-25 22:36:40.503836,26.865445
channel-750,685126,30352667,30352694,27,2025-02-25 22:36:28.641986,2025-02-25 22:37:04.043777,35.401791
channel-750,685127,30352683,30352689,6,2025-02-25 22:36:50.273906,2025-02-25 22:36:58.397621,8.123715
channel-750,685128,30352687,30352704,17,2025-02-25 22:36:56.018638,2025-02-25 22:37:16.441002,20.422364
channel-750,685129,30352731,30352744,13,2025-02-25 22:37:52.017200,2025-02-25 22:38:07.619361,15.602161
channel-750,685130,30352785,30352794,9,2025-02-25 22:38:59.722510,2025-02-25 22:39:10.397454,10.674944
channel-750,685131,30352789,30352794,5,2025-02-25 22:39:04.432000,2025-02-25 22:39:10.397454,5.965454
channel-750,685132,30352830,30352844,14,2025-02-25 22:39:57.993318,2025-02-25 22:40:20.121116,22.127798
channel-750,685133,30352954,30352966,12,2025-02-25 22:42:39.533201,2025-02-25 22:42:53.325784,13.792583
channel-750,685134,30353082,30353100,18,2025-02-25 22:45:22.625054,2025-02-25 22:45:44.796214,22.17116
channel-750,685135,30353347,30353352,5,2025-02-25 22:51:02.880723,2025-02-25 22:51:08.572611,5.691888
channel-750,685136,30353515,30353519,4,2025-02-25 22:54:41.085819,2025-02-25 22:54:45.562718,4.476899
channel-750,685137,30353544,30353548,4,2025-02-25 22:55:17.405896,2025-02-25 22:55:23.033569,5.627673
channel-750,685138,30353548,30353568,20,2025-02-25 22:55:23.033569,2025-02-25 22:55:47.359774,24.326205
channel-750,685139,30353597,30353619,22,2025-02-25 22:56:25.500590,2025-02-25 22:56:53.111627,27.611037
channel-750,685140,30353605,30353623,18,2025-02-25 22:56:35.414619,2025-02-25 22:56:57.757293,22.342674
channel-750,685141,30353616,30353626,10,2025-02-25 22:56:49.743014,2025-02-25 22:57:01.601728,11.858714
channel-750,685142,30353644,30353659,15,2025-02-25 22:57:24.690984,2025-02-25 22:57:42.063505,17.372521
channel-750,685143,30353646,30353652,6,2025-02-25 22:57:27.063557,2025-02-25 22:57:33.912053,6.848496
channel-750,685144,30353659,30353664,5,2025-02-25 22:57:42.063505,2025-02-25 22:57:51.169292,9.105787
channel-750,685145,30353780,30353784,4,2025-02-25 23:00:17.610338,2025-02-25 23:00:25.077586,7.467248
channel-750,685146,30353784,30353788,4,2025-02-25 23:00:25.077586,2025-02-25 23:00:31.748421,6.670835
channel-750,685147,30353868,30353873,5,2025-02-25 23:02:09.298104,2025-02-25 23:02:14.688162,5.390058
channel-750,685148,30353962,30353983,21,2025-02-25 23:04:13.434427,2025-02-25 23:04:39.642549,26.208122
channel-750,685149,30354025,30354052,27,2025-02-25 23:05:30.200820,2025-02-25 23:06:07.152402,36.951582
channel-750,685150,30354082,30354105,23,2025-02-25 23:06:47.715657,2025-02-25 23:07:14.648872,26.933215
channel-750,685151,30354139,30354149,10,2025-02-25 23:08:02.295848,2025-02-25 23:08:14.400176,12.104328
channel-750,685152,30354142,30354154,12,2025-02-25 23:08:06.588838,2025-02-25 23:08:20.218461,13.629623
channel-750,685153,30354142,30354171,29,2025-02-25 23:08:06.588838,2025-02-25 23:08:41.609957,35.021119
channel-750,685154,30354146,30354165,19,2025-02-25 23:08:11.194950,2025-02-25 23:08:34.885417,23.690467
channel-750,685155,30354146,30354151,5,2025-02-25 23:08:11.194950,2025-02-25 23:08:16.811396,5.616446
channel-750,685156,30354201,30354223,22,2025-02-25 23:09:20.454658,2025-02-25 23:09:49.830376,29.375718
channel-750,685157,30354281,30354301,20,2025-02-25 23:11:04.632319,2025-02-25 23:11:30.343332,25.711013
channel-750,685158,30354330,30354351,21,2025-02-25 23:12:10.280058,2025-02-25 23:12:35.801581,25.521523
channel-750,685159,30354395,30354420,25,2025-02-25 23:13:31.912512,2025-02-25 23:14:03.033624,31.121112
channel-750,685160,30354451,30354469,18,2025-02-25 23:14:41.370814,2025-02-25 23:15:05.042292,23.671478
channel-750,685161,30354520,30354543,23,2025-02-25 23:16:11.717653,2025-02-25 23:16:39.143794,27.426141
channel-750,685162,30354589,30354613,24,2025-02-25 23:17:38.875777,2025-02-25 23:18:09.842391,30.966614
channel-750,685163,30354650,30354671,21,2025-02-25 23:18:55.584521,2025-02-25 23:19:22.948885,27.364364
channel-750,685164,30354657,30354671,14,2025-02-25 23:19:07.244585,2025-02-25 23:19:22.948885,15.7043
channel-750,685165,30354700,30354722,22,2025-02-25 23:20:04.236063,2025-02-25 23:20:30.405359,26.169296
channel-750,685166,30354750,30354766,16,2025-02-25 23:21:04.577449,2025-02-25 23:21:26.680765,22.103316
channel-750,685167,30354767,30354789,22,2025-02-25 23:21:27.804294,2025-02-25 23:21:55.010407,27.206113
channel-750,685168,30354820,30354846,26,2025-02-25 23:22:34.224937,2025-02-25 23:23:08.439030,34.214093
channel-750,685169,30354875,30354887,12,2025-02-25 23:23:44.299760,2025-02-25 23:24:00.183045,15.883285
channel-750,685170,30354876,30354897,21,2025-02-25 23:23:45.772559,2025-02-25 23:24:13.883179,28.11062
channel-750,685171,30354914,30354918,4,2025-02-25 23:24:36.440296,2025-02-25 23:24:42.097323,5.657027
channel-750,685172,30354936,30354955,19,2025-02-25 23:25:05.558958,2025-02-25 23:25:31.335609,25.776651
channel-750,685173,30354953,30354958,5,2025-02-25 23:25:28.841403,2025-02-25 23:25:34.800125,5.958722
channel-750,685174,30355007,30355019,12,2025-02-25 23:26:38.080712,2025-02-25 23:26:53.531315,15.450603
channel-750,685175,30355010,30355034,24,2025-02-25 23:26:42.271444,2025-02-25 23:27:11.005143,28.733699
channel-750,685176,30355069,30355089,20,2025-02-25 23:27:54.960425,2025-02-25 23:28:26.209278,31.248853
channel-750,685177,30355106,30355114,8,2025-02-25 23:28:46.776571,2025-02-25 23:29:01.046522,14.269951
channel-750,685178,30355127,30355150,23,2025-02-25 23:29:16.237778,2025-02-25 23:29:45.838071,29.600293
channel-750,685179,30355135,30355150,15,2025-02-25 23:29:25.370325,2025-02-25 23:29:45.838071,20.467746
channel-750,685180,30355190,30355217,27,2025-02-25 23:30:36.852405,2025-02-25 23:31:12.079925,35.22752
channel-750,685181,30355257,30355281,24,2025-02-25 23:32:01.544712,2025-02-25 23:32:32.989407,31.444695
channel-750,685182,30355293,30355305,12,2025-02-25 23:32:48.344785,2025-02-25 23:33:03.114813,14.770028
channel-750,685183,30355309,30355313,4,2025-02-25 23:33:08.408077,2025-02-25 23:33:13.870213,5.462136
channel-750,685184,30355313,30355327,14,2025-02-25 23:33:13.870213,2025-02-25 23:33:34.266175,20.395962
channel-750,685185,30355324,30355345,21,2025-02-25 23:33:30.661192,2025-02-25 23:33:58.755246,28.094054
channel-750,685186,30355374,30355397,23,2025-02-25 23:34:34.392586,2025-02-25 23:35:03.433284,29.040698
channel-750,685187,30355431,30355457,26,2025-02-25 23:35:47.110475,2025-02-25 23:36:18.940188,31.829713
channel-750,685188,30355504,30355525,21,2025-02-25 23:37:15.768061,2025-02-25 23:37:44.811678,29.043617
channel-750,685189,30355521,30355531,10,2025-02-25 23:37:39.392105,2025-02-25 23:37:55.959661,16.567556
channel-750,685190,30355579,30355603,24,2025-02-25 23:38:55.548433,2025-02-25 23:39:24.240069,28.691636
channel-750,685191,30355612,30355624,12,2025-02-25 23:39:36.597411,2025-02-25 23:39:51.527586,14.930175
channel-750,685192,30355636,30355652,16,2025-02-25 23:40:06.711455,2025-02-25 23:40:29.503064,22.791609
channel-750,685193,30355708,30355728,20,2025-02-25 23:41:41.457985,2025-02-25 23:42:10.888692,29.430707
channel-750,685194,30355727,30355737,10,2025-02-25 23:42:09.788459,2025-02-25 23:42:22.258720,12.470261
channel-750,685195,30355728,30355737,9,2025-02-25 23:42:10.888692,2025-02-25 23:42:22.258720,11.370028
channel-750,685196,30355760,30355772,12,2025-02-25 23:42:49.870065,2025-02-25 23:43:05.602068,15.732003
channel-750,685197,30355766,30355789,23,2025-02-25 23:42:58.255244,2025-02-25 23:43:27.872523,29.617279
channel-750,685198,30355787,30355792,5,2025-02-25 23:43:25.603970,2025-02-25 23:43:31.262408,5.658438
channel-750,685199,30355835,30355846,11,2025-02-25 23:44:27.363711,2025-02-25 23:44:40.040081,12.67637
channel-750,685200,30355862,30355884,22,2025-02-25 23:45:00.537541,2025-02-25 23:45:28.668958,28.131417
channel-750,685201,30355864,30355888,24,2025-02-25 23:45:04.494340,2025-02-25 23:45:34.181353,29.687013
channel-750,685202,30355930,30356019,89,2025-02-25 23:46:25.113294,2025-02-25 23:48:23.221587,118.108293
channel-750,685203,30355934,30355957,23,2025-02-25 23:46:31.645750,2025-02-25 23:47:04.592980,32.94723
channel-750,685204,30355938,30355944,6,2025-02-25 23:46:39.518548,2025-02-25 23:46:46.295143,6.776595
channel-750,685205,30355997,30356018,21,2025-02-25 23:47:53.519870,2025-02-25 23:48:22.043073,28.523203
channel-750,685206,30356035,30356056,21,2025-02-25 23:48:43.700079,2025-02-25 23:49:09.706803,26.006724
channel-750,685207,30356061,30356085,24,2025-02-25 23:49:15.301149,2025-02-25 23:49:45.179452,29.878303
channel-750,685208,30356092,30356096,4,2025-02-25 23:49:52.820737,2025-02-25 23:49:57.997383,5.176646
channel-750,685209,30356111,30356117,6,2025-02-25 23:50:17.100484,2025-02-25 23:50:25.570673,8.470189
channel-750,685210,30356119,30356141,22,2025-02-25 23:50:27.799110,2025-02-25 23:50:56.193005,28.393895
channel-750,685211,30356125,30356133,8,2025-02-25 23:50:34.757776,2025-02-25 23:50:45.601269,10.843493
channel-750,685212,30356127,30356135,8,2025-02-25 23:50:37.097802,2025-02-25 23:50:47.975615,10.877813
channel-750,685213,30356143,30356147,4,2025-02-25 23:50:58.624489,2025-02-25 23:51:08.914297,10.289808
channel-750,685214,30356187,30356206,19,2025-02-25 23:51:57.858319,2025-02-25 23:52:22.878620,25.020301
channel-750,685215,30356210,30356220,10,2025-02-25 23:52:28.788851,2025-02-25 23:52:40.495944,11.707093
channel-750,685216,30356264,30356272,8,2025-02-25 23:53:34.498603,2025-02-25 23:53:44.587734,10.089131
channel-750,685217,30356327,30356331,4,2025-02-25 23:54:58.910262,2025-02-25 23:55:03.511366,4.601104
channel-750,685218,30356412,30356417,5,2025-02-25 23:56:49.944381,2025-02-25 23:56:55.740585,5.796204
channel-750,685219,30356524,30356533,9,2025-02-25 23:59:11.322479,2025-02-25 23:59:22.741129,11.41865
channel-750,685220,30356571,30356577,6,2025-02-26 00:00:13.044444,2025-02-26 00:00:21.785302,8.740858
channel-750,685221,30356573,30356577,4,2025-02-26 00:00:16.323075,2025-02-26 00:00:21.785302,5.462227
channel-750,685222,30356577,30356582,5,2025-02-26 00:00:21.785302,2025-02-26 00:00:28.771672,6.98637
channel-750,685223,30356584,30356588,4,2025-02-26 00:00:31.029280,2025-02-26 00:00:36.459871,5.430591
channel-750,685224,30356597,30356602,5,2025-02-26 00:00:46.876580,2025-02-26 00:00:52.535206,5.658626
channel-750,685225,30356601,30356604,3,2025-02-26 00:00:51.304042,2025-02-26 00:00:56.331971,5.027929
channel-750,685226,30356616,30356621,5,2025-02-26 00:01:11.670055,2025-02-26 00:01:17.490460,5.820405
channel-750,685227,30356618,30356634,16,2025-02-26 00:01:13.873840,2025-02-26 00:01:35.249152,21.375312
channel-750,685228,30356622,30356626,4,2025-02-26 00:01:19.288611,2025-02-26 00:01:23.726975,4.438364
channel-750,685229,30356628,30356632,4,2025-02-26 00:01:27.257393,2025-02-26 00:01:31.862894,4.605501
channel-750,685230,30356680,30356686,6,2025-02-26 00:02:33.209120,2025-02-26 00:02:41.055776,7.846656
channel-750,685231,30356687,30356692,5,2025-02-26 00:02:42.145300,2025-02-26 00:02:48.852382,6.707082
channel-750,685232,30356704,30356709,5,2025-02-26 00:03:04.240892,2025-02-26 00:03:10.112266,5.871374
channel-750,685233,30356720,30356725,5,2025-02-26 00:03:25.441492,2025-02-26 00:03:33.615712,8.17422
channel-750,685234,30356736,30356741,5,2025-02-26 00:03:46.357532,2025-02-26 00:03:52.347738,5.990206
channel-750,685235,30356743,30356751,8,2025-02-26 00:03:54.582308,2025-02-26 00:04:03.943471,9.361163
channel-750,685236,30356758,30356763,5,2025-02-26 00:04:12.994589,2025-02-26 00:04:20.444753,7.450164
channel-750,685237,30356805,30356810,5,2025-02-26 00:05:16.648370,2025-02-26 00:05:22.604087,5.955717
channel-750,685238,30356808,30356822,14,2025-02-26 00:05:19.985124,2025-02-26 00:05:39.379825,19.394701
channel-750,685239,30356876,30356880,4,2025-02-26 00:06:46.172846,2025-02-26 00:06:51.086593,4.913747
channel-750,685240,30356881,30356888,7,2025-02-26 00:06:53.218388,2025-02-26 00:07:01.944380,8.725992
channel-750,685241,30357190,30357194,4,2025-02-26 00:13:31.387863,2025-02-26 00:13:35.950517,4.562654
channel-750,685242,30357302,30357319,17,2025-02-26 00:15:54.633898,2025-02-26 00:16:16.047603,21.413705
channel-750,685243,30357325,30357343,18,2025-02-26 00:16:24.786024,2025-02-26 00:16:47.162248,22.376224
channel-750,685244,30357327,30357344,17,2025-02-26 00:16:27.143302,2025-02-26 00:16:48.388185,21.244883
channel-750,685245,30357414,30357426,12,2025-02-26 00:18:21.737917,2025-02-26 00:18:36.685626,14.947709
channel-750,685246,30357442,30357446,4,2025-02-26 00:18:55.707147,2025-02-26 00:19:02.042809,6.335662
channel-750,685247,30357463,30357474,11,2025-02-26 00:19:23.698801,2025-02-26 00:19:36.933001,13.2342
channel-750,685248,30357502,30357593,91,2025-02-26 00:20:13.267289,2025-02-26 00:22:12.936285,119.668996
channel-750,685249,30357558,30357572,14,2025-02-26 00:21:24.887330,2025-02-26 00:21:42.293379,17.406049
channel-750,685250,30357608,30357613,5,2025-02-26 00:22:35.763960,2025-02-26 00:22:41.579633,5.815673
channel-750,685251,30357644,30357661,17,2025-02-26 00:23:20.266929,2025-02-26 00:23:40.819877,20.552948
channel-750,685252,30357669,30357683,14,2025-02-26 00:23:49.904564,2025-02-26 00:24:08.853658,18.949094
channel-750,685253,30358039,30358057,18,2025-02-26 00:31:48.801588,2025-02-26 00:32:09.898089,21.096501
channel-750,685254,30358065,30358072,7,2025-02-26 00:32:18.949870,2025-02-26 00:32:28.662289,9.712419
channel-750,685255,30358104,30358114,10,2025-02-26 00:33:09.552262,2025-02-26 00:33:24.153318,14.601056
channel-750,685256,30358104,30358115,11,2025-02-26 00:33:09.552262,2025-02-26 00:33:25.422344,15.870082
channel-750,685257,30358146,30358152,6,2025-02-26 00:34:03.869259,2025-02-26 00:34:12.266543,8.397284
channel-750,685258,30358181,30358196,15,2025-02-26 00:34:48.308882,2025-02-26 00:35:08.226448,19.917566
channel-750,685259,30358297,30358308,11,2025-02-26 00:37:18.037324,2025-02-26 00:37:32.180987,14.143663
channel-750,685260,30358360,30358364,4,2025-02-26 00:38:36.488114,2025-02-26 00:38:44.893608,8.405494
channel-750,685261,30358435,30358441,6,2025-02-26 00:40:16.282301,2025-02-26 00:40:24.605927,8.323626
channel-750,685262,30358455,30358460,5,2025-02-26 00:40:44.204802,2025-02-26 00:40:51.026679,6.821877
channel-750,685263,30358456,30358460,4,2025-02-26 00:40:45.366013,2025-02-26 00:40:51.026679,5.660666
channel-750,685264,30358469,30358490,21,2025-02-26 00:41:02.015002,2025-02-26 00:41:27.050899,25.035897
channel-750,685265,30358940,30358949,9,2025-02-26 00:51:07.995250,2025-02-26 00:51:20.202936,12.207686
channel-750,685266,30358963,30358975,12,2025-02-26 00:51:36.723183,2025-02-26 00:51:52.930983,16.2078
channel-750,685267,30359225,30359228,3,2025-02-26 00:57:15.389594,2025-02-26 00:57:20.236354,4.84676
channel-750,685268,30359362,30359367,5,2025-02-26 01:00:15.148045,2025-02-26 01:00:21.295358,6.147313
channel-750,685269,30359440,30359445,5,2025-02-26 01:01:54.683881,2025-02-26 01:02:01.329770,6.645889
channel-750,685270,30359449,30359454,5,2025-02-26 01:02:06.516190,2025-02-26 01:02:11.993283,5.477093
channel-750,685271,30359518,30359522,4,2025-02-26 01:03:36.010712,2025-02-26 01:03:42.673857,6.663145
channel-750,685272,30359558,30359566,8,2025-02-26 01:04:27.499087,2025-02-26 01:04:38.814564,11.315477
channel-750,685273,30359599,30359603,4,2025-02-26 01:05:20.410648,2025-02-26 01:05:24.696809,4.286161
channel-750,685274,30359896,30359901,5,2025-02-26 01:11:51.487470,2025-02-26 01:11:57.045106,5.557636
channel-750,685275,30360009,30360018,9,2025-02-26 01:14:18.329418,2025-02-26 01:14:30.893662,12.564244
channel-750,685276,30360219,30360224,5,2025-02-26 01:18:49.595275,2025-02-26 01:18:55.357718,5.762443
channel-750,685277,30360242,30360246,4,2025-02-26 01:19:20.211678,2025-02-26 01:19:25.607141,5.395463
channel-750,685278,30360250,30360258,8,2025-02-26 01:19:30.096828,2025-02-26 01:19:40.460708,10.36388
channel-750,685279,30360277,30360282,5,2025-02-26 01:20:05.455128,2025-02-26 01:20:11.263394,5.808266
channel-750,685280,30360311,30360316,5,2025-02-26 01:20:50.441552,2025-02-26 01:20:57.106629,6.665077
channel-750,685281,30360361,30360366,5,2025-02-26 01:21:54.880994,2025-02-26 01:22:00.428015,5.547021
channel-750,685282,30360397,30360401,4,2025-02-26 01:22:40.056110,2025-02-26 01:22:45.737813,5.681703
channel-750,685283,30360433,30360437,4,2025-02-26 01:23:24.196259,2025-02-26 01:23:29.827870,5.631611
channel-750,685284,30360465,30360471,6,2025-02-26 01:24:09.499635,2025-02-26 01:24:17.119534,7.619899
channel-750,685285,30360499,30360503,4,2025-02-26 01:24:54.992424,2025-02-26 01:25:00.483061,5.490637
channel-750,685286,30360534,30360538,4,2025-02-26 01:25:40.559409,2025-02-26 01:25:45.976579,5.41717
channel-750,685287,30360570,30360575,5,2025-02-26 01:26:24.376407,2025-02-26 01:26:29.914086,5.537679
channel-750,685288,30360605,30360609,4,2025-02-26 01:27:08.691489,2025-02-26 01:27:13.155590,4.464101
channel-750,685289,30360640,30360644,4,2025-02-26 01:27:53.675310,2025-02-26 01:27:58.108993,4.433683
channel-750,685290,30360675,30360679,4,2025-02-26 01:28:38.138803,2025-02-26 01:28:42.778488,4.639685
channel-750,685291,30360707,30360712,5,2025-02-26 01:29:23.924495,2025-02-26 01:29:29.602333,5.677838
channel-750,685292,30360745,30360749,4,2025-02-26 01:30:08.845255,2025-02-26 01:30:13.701832,4.856577
channel-750,685293,30360777,30360780,3,2025-02-26 01:30:54.036416,2025-02-26 01:30:58.755006,4.71859
channel-750,685294,30360815,30360820,5,2025-02-26 01:31:39.471118,2025-02-26 01:31:46.096972,6.625854
channel-750,685295,30360822,30360839,17,2025-02-26 01:31:49.593616,2025-02-26 01:32:13.308689,23.715073
channel-750,685296,30360836,30360854,18,2025-02-26 01:32:09.852856,2025-02-26 01:32:30.550256,20.6974
channel-750,685297,30360983,30360987,4,2025-02-26 01:35:20.938798,2025-02-26 01:35:25.786099,4.847301
channel-750,685298,30361110,30361121,11,2025-02-26 01:38:05.671722,2025-02-26 01:38:18.671362,12.99964
channel-750,685299,30361467,30361471,4,2025-02-26 01:45:41.479045,2025-02-26 01:45:49.612156,8.133111
channel-750,685304,30361817,30361823,6,2025-02-26 01:53:11.252910,2025-02-26 01:53:19.262517,8.009607
channel-750,685305,30361847,30361853,6,2025-02-26 01:53:49.329295,2025-02-26 01:53:56.173677,6.844382
channel-750,685306,30361900,30361910,10,2025-02-26 01:54:56.013276,2025-02-26 01:55:11.443336,15.43006
channel-750,685307,30361931,30361943,12,2025-02-26 01:55:38.329414,2025-02-26 01:55:53.247777,14.918363
channel-750,685308,30361989,30361999,10,2025-02-26 01:56:54.659184,2025-02-26 01:57:05.984424,11.32524
channel-750,685309,30362080,30362087,7,2025-02-26 01:58:48.815862,2025-02-26 01:58:56.485931,7.670069
channel-750,685310,30362149,30362155,6,2025-02-26 02:00:16.527546,2025-02-26 02:00:23.287850,6.760304
channel-750,685311,30362240,30362253,13,2025-02-26 02:02:10.088443,2025-02-26 02:02:31.156178,21.067735
channel-750,685312,30362264,30362269,5,2025-02-26 02:02:46.226739,2025-02-26 02:02:53.129930,6.903191
channel-750,685313,30362303,30362308,5,2025-02-26 02:03:31.678154,2025-02-26 02:03:37.465498,5.787344
channel-750,685314,30362307,30362311,4,2025-02-26 02:03:36.344743,2025-02-26 02:03:41.976589,5.631846
channel-750,685315,30362602,30362643,41,2025-02-26 02:09:54.469883,2025-02-26 02:10:44.486872,50.016989
channel-750,685316,30362821,30362835,14,2025-02-26 02:14:32.895570,2025-02-26 02:14:49.126853,16.231283
channel-750,685317,30362832,30362844,12,2025-02-26 02:14:45.867389,2025-02-26 02:15:01.833792,15.966403
channel-750,685318,30362874,30362892,18,2025-02-26 02:15:40.054727,2025-02-26 02:16:01.552754,21.498027
channel-750,685319,30362891,30362895,4,2025-02-26 02:15:59.284509,2025-02-26 02:16:04.923434,5.638925
channel-750,685320,30362899,30362907,8,2025-02-26 02:16:10.707907,2025-02-26 02:16:19.867286,9.159379
channel-750,685321,30362902,30362916,14,2025-02-26 02:16:14.144637,2025-02-26 02:16:30.520545,16.375908
channel-750,685322,30362934,30362945,11,2025-02-26 02:16:54.643141,2025-02-26 02:17:10.042409,15.399268
channel-750,685323,30362980,30362994,14,2025-02-26 02:17:55.632509,2025-02-26 02:18:14.491205,18.858696
channel-750,685324,30363068,30363079,11,2025-02-26 02:19:46.405370,2025-02-26 02:19:59.983107,13.577737
channel-750,685325,30363136,30363146,10,2025-02-26 02:21:13.338437,2025-02-26 02:21:24.749512,11.411075
channel-750,685326,30363162,30363176,14,2025-02-26 02:21:43.912745,2025-02-26 02:22:01.941122,18.028377
channel-750,685327,30363164,30363173,9,2025-02-26 02:21:46.205944,2025-02-26 02:21:58.611429,12.405485
channel-750,685328,30363182,30363186,4,2025-02-26 02:22:10.226448,2025-02-26 02:22:18.946588,8.72014
channel-750,685329,30363209,30363219,10,2025-02-26 02:22:51.279719,2025-02-26 02:23:04.813610,13.533891
channel-750,685330,30363272,30363284,12,2025-02-26 02:24:08.675254,2025-02-26 02:24:28.185427,19.510173
channel-750,685331,30363323,30363341,18,2025-02-26 02:25:14.349892,2025-02-26 02:25:36.647528,22.297636
channel-750,685332,30363381,30363393,12,2025-02-26 02:26:28.958300,2025-02-26 02:26:44.547804,15.589504
channel-750,685333,30363390,30363398,8,2025-02-26 02:26:41.257489,2025-02-26 02:26:50.282084,9.024595
channel-750,685334,30363561,30363572,11,2025-02-26 02:30:16.773786,2025-02-26 02:30:31.529849,14.756063
channel-750,685335,30363595,30363605,10,2025-02-26 02:30:58.078843,2025-02-26 02:31:13.785194,15.706351
channel-750,685336,30363637,30363649,12,2025-02-26 02:31:55.041645,2025-02-26 02:32:09.737246,14.695601
channel-750,685337,30363703,30363712,9,2025-02-26 02:33:19.650234,2025-02-26 02:33:32.116499,12.466265
channel-750,685338,30363772,30363785,13,2025-02-26 02:34:49.352721,2025-02-26 02:35:04.419505,15.066784
channel-750,685339,30363819,30363835,16,2025-02-26 02:35:50.076010,2025-02-26 02:36:09.276143,19.200133
channel-750,685340,30363941,30363953,12,2025-02-26 02:38:22.325359,2025-02-26 02:38:35.966137,13.640778
channel-750,685341,30364062,30364083,21,2025-02-26 02:40:58.129446,2025-02-26 02:41:30.000233,31.870787
channel-750,685342,30364065,30364081,16,2025-02-26 02:41:06.107624,2025-02-26 02:41:27.505814,21.39819
channel-750,685343,30364086,30364100,14,2025-02-26 02:41:33.312371,2025-02-26 02:41:50.620295,17.307924
channel-750,685344,30364092,30364101,9,2025-02-26 02:41:40.235325,2025-02-26 02:41:51.874907,11.639582
channel-750,685345,30364127,30364144,17,2025-02-26 02:42:22.707238,2025-02-26 02:42:42.993157,20.285919
channel-750,685346,30364264,30364285,21,2025-02-26 02:45:17.004472,2025-02-26 02:45:41.259812,24.25534
channel-750,685347,30364379,30364388,9,2025-02-26 02:47:42.604468,2025-02-26 02:47:54.107267,11.502799
channel-750,685348,30364470,30364486,16,2025-02-26 02:49:38.704860,2025-02-26 02:49:59.352162,20.647302
channel-750,685349,30364515,30364524,9,2025-02-26 02:50:39.759837,2025-02-26 02:50:50.338532,10.578695
channel-750,685350,30364564,30364575,11,2025-02-26 02:51:39.394614,2025-02-26 02:51:53.877619,14.483005
channel-750,685351,30364600,30364610,10,2025-02-26 02:52:27.874621,2025-02-26 02:52:40.701900,12.827279
channel-750,685352,30364626,30364637,11,2025-02-26 02:53:00.283688,2025-02-26 02:53:13.774064,13.490376
channel-750,685353,30364629,30364640,11,2025-02-26 02:53:04.882793,2025-02-26 02:53:21.808340,16.925547
channel-750,685354,30364638,30364654,16,2025-02-26 02:53:15.036486,2025-02-26 02:53:38.092350,23.055864
channel-750,685355,30364668,30364673,5,2025-02-26 02:53:59.479168,2025-02-26 02:54:07.604620,8.125452
channel-750,685356,30364719,30364735,16,2025-02-26 02:55:03.301336,2025-02-26 02:55:23.405333,20.103997
channel-750,685357,30364734,30364747,13,2025-02-26 02:55:22.171452,2025-02-26 02:55:39.338683,17.167231
channel-750,685358,30364785,30364794,9,2025-02-26 02:56:28.974781,2025-02-26 02:56:42.287334,13.312553
channel-750,685359,30364794,30364810,16,2025-02-26 02:56:42.287334,2025-02-26 02:57:00.703323,18.415989
channel-750,685360,30364828,30364839,11,2025-02-26 02:57:24.073311,2025-02-26 02:57:40.143687,16.070376
channel-750,685361,30364845,30364856,11,2025-02-26 02:57:48.451243,2025-02-26 02:58:04.700563,16.24932
channel-750,685362,30364845,30364856,11,2025-02-26 02:57:48.451243,2025-02-26 02:58:04.700563,16.24932
channel-750,685363,30364866,30364881,15,2025-02-26 02:58:16.555600,2025-02-26 02:58:35.911383,19.355783
channel-750,685364,30364904,30364914,10,2025-02-26 02:59:03.482601,2025-02-26 02:59:15.557703,12.075102
channel-750,685365,30364951,30364965,14,2025-02-26 03:00:06.806776,2025-02-26 03:00:23.095572,16.288796
channel-750,685366,30364984,30364999,15,2025-02-26 03:00:47.171082,2025-02-26 03:01:06.994131,19.823049
channel-750,685367,30365006,30365018,12,2025-02-26 03:01:15.222318,2025-02-26 03:01:31.659910,16.437592
channel-750,685368,30365012,30365027,15,2025-02-26 03:01:24.847372,2025-02-26 03:01:41.843977,16.996605
channel-750,685369,30365039,30365070,31,2025-02-26 03:01:56.664786,2025-02-26 03:02:38.364056,41.69927
channel-750,685370,30365039,30365050,11,2025-02-26 03:01:56.664786,2025-02-26 03:02:12.543633,15.878847
channel-750,685371,30365056,30365067,11,2025-02-26 03:02:19.593909,2025-02-26 03:02:34.808130,15.214221
channel-750,685372,30365062,30365074,12,2025-02-26 03:02:28.682178,2025-02-26 03:02:43.116718,14.43454
channel-750,685373,30365080,30365093,13,2025-02-26 03:02:49.829035,2025-02-26 03:03:06.908838,17.079803
channel-750,685374,30365082,30365094,12,2025-02-26 03:02:52.095318,2025-02-26 03:03:09.584367,17.489049
channel-750,685375,30365084,30365096,12,2025-02-26 03:02:54.321939,2025-02-26 03:03:13.215317,18.893378
channel-750,685376,30365090,30365105,15,2025-02-26 03:03:02.402703,2025-02-26 03:03:24.758413,22.35571
channel-750,685377,30365101,30365125,24,2025-02-26 03:03:20.353819,2025-02-26 03:03:49.602566,29.248747
channel-750,685378,30365102,30365112,10,2025-02-26 03:03:21.503475,2025-02-26 03:03:33.791366,12.287891
channel-750,685379,30365109,30365122,13,2025-02-26 03:03:30.518262,2025-02-26 03:03:46.312258,15.793996
channel-750,685380,30365117,30365131,14,2025-02-26 03:03:39.515577,2025-02-26 03:03:57.611169,18.095592
channel-750,685381,30365132,30365149,17,2025-02-26 03:03:59.026816,2025-02-26 03:04:19.790115,20.763299
channel-750,685382,30365141,30365153,12,2025-02-26 03:04:09.525474,2025-02-26 03:04:24.606300,15.080826
channel-750,685383,30365156,30365171,15,2025-02-26 03:04:29.405483,2025-02-26 03:04:46.346701,16.941218
channel-750,685384,30365170,30365192,22,2025-02-26 03:04:45.276477,2025-02-26 03:05:17.237648,31.961171
channel-750,685385,30365174,30365185,11,2025-02-26 03:04:49.969739,2025-02-26 03:05:05.211208,15.241469
channel-750,685386,30365181,30365188,7,2025-02-26 03:04:59.740563,2025-02-26 03:05:12.947582,13.207019
channel-750,685387,30365205,30365217,12,2025-02-26 03:05:33.576370,2025-02-26 03:05:50.183133,16.606763
channel-750,685388,30365213,30365231,18,2025-02-26 03:05:44.418044,2025-02-26 03:06:06.384888,21.966844
channel-750,685389,30365224,30365252,28,2025-02-26 03:05:58.201278,2025-02-26 03:06:32.857522,34.656244
channel-750,685390,30365238,30365243,5,2025-02-26 03:06:14.532697,2025-02-26 03:06:20.527013,5.994316
channel-750,685391,30365238,30365252,14,2025-02-26 03:06:14.532697,2025-02-26 03:06:32.857522,18.324825
channel-750,685392,30365250,30365262,12,2025-02-26 03:06:30.579336,2025-02-26 03:06:49.512975,18.933639
channel-750,685393,30365263,30365271,8,2025-02-26 03:06:50.759358,2025-02-26 03:07:02.613173,11.853815
channel-750,685394,30365291,30365317,26,2025-02-26 03:07:25.063302,2025-02-26 03:07:57.341941,32.278639
channel-750,685395,30365352,30365376,24,2025-02-26 03:08:40.623398,2025-02-26 03:09:12.229179,31.605781
channel-750,685396,30365412,30365433,21,2025-02-26 03:09:55.667661,2025-02-26 03:10:20.917056,25.249395
channel-750,685397,30365466,30365493,27,2025-02-26 03:11:03.856053,2025-02-26 03:11:41.287617,37.431564
channel-750,685398,30365520,30365541,21,2025-02-26 03:12:13.237538,2025-02-26 03:12:40.274901,27.037363
channel-750,685399,30365586,30365609,23,2025-02-26 03:13:36.086436,2025-02-26 03:14:03.700739,27.614303
channel-750,685400,30365641,30365665,24,2025-02-26 03:14:46.855604,2025-02-26 03:15:16.676306,29.820702
channel-750,685401,30365687,30365692,5,2025-02-26 03:15:48.765372,2025-02-26 03:15:54.569011,5.803639
channel-750,685402,30365701,30365724,23,2025-02-26 03:16:06.488257,2025-02-26 03:16:33.785024,27.296767
channel-750,685403,30365741,30365750,9,2025-02-26 03:16:54.968452,2025-02-26 03:17:06.653812,11.68536
channel-750,685404,30365743,30365755,12,2025-02-26 03:16:57.127980,2025-02-26 03:17:13.420880,16.2929
channel-750,685405,30365761,30365784,23,2025-02-26 03:17:20.639618,2025-02-26 03:17:48.916923,28.277305
channel-750,685406,30365805,30365822,17,2025-02-26 03:18:18.208205,2025-02-26 03:18:38.930683,20.722478
channel-750,685407,30365812,30365836,24,2025-02-26 03:18:27.276991,2025-02-26 03:18:56.328137,29.051146
channel-750,685408,30365835,30365857,22,2025-02-26 03:18:55.099241,2025-02-26 03:19:22.476825,27.377584
channel-750,685409,30365838,30365869,31,2025-02-26 03:18:59.594448,2025-02-26 03:19:36.246401,36.651953
channel-750,685410,30365876,30365902,26,2025-02-26 03:19:48.796549,2025-02-26 03:20:23.783092,34.986543
channel-750,685411,30365888,30365902,14,2025-02-26 03:20:06.915728,2025-02-26 03:20:23.783092,16.867364
channel-750,685412,30365932,30365957,25,2025-02-26 03:21:00.996655,2025-02-26 03:21:30.879072,29.882417
channel-750,685413,30365943,30365959,16,2025-02-26 03:21:14.872112,2025-02-26 03:21:33.353399,18.481287
channel-750,685414,30365957,30365961,4,2025-02-26 03:21:30.879072,2025-02-26 03:21:37.173006,6.293934
channel-750,685415,30365972,30365986,14,2025-02-26 03:21:49.921707,2025-02-26 03:22:08.928077,19.00637
channel-750,685416,30365995,30366021,26,2025-02-26 03:22:19.682754,2025-02-26 03:22:51.601464,31.91871
channel-750,685417,30366009,30366024,15,2025-02-26 03:22:37.924827,2025-02-26 03:22:55.018353,17.093526
channel-750,685418,30366056,30366078,22,2025-02-26 03:23:37.982030,2025-02-26 03:24:06.296730,28.3147
channel-750,685419,30366065,30366071,6,2025-02-26 03:23:49.119665,2025-02-26 03:23:56.116036,6.996371
channel-750,685420,30366090,30366104,14,2025-02-26 03:24:23.343967,2025-02-26 03:24:40.601541,17.257574
channel-750,685421,30366122,30366146,24,2025-02-26 03:25:03.016673,2025-02-26 03:25:33.188613,30.17194
channel-750,685422,30366165,30366175,10,2025-02-26 03:25:56.596671,2025-02-26 03:26:09.289662,12.692991
channel-750,685423,30366182,30366199,17,2025-02-26 03:26:18.315396,2025-02-26 03:26:41.910196,23.5948
channel-750,685424,30366183,30366195,12,2025-02-26 03:26:19.520830,2025-02-26 03:26:37.378250,17.85742
channel-750,685425,30366191,30366214,23,2025-02-26 03:26:31.008348,2025-02-26 03:27:00.280140,29.271792
channel-750,685426,30366212,30366218,6,2025-02-26 03:26:56.882185,2025-02-26 03:27:06.550063,9.667878
channel-750,685427,30366261,30366282,21,2025-02-26 03:27:58.034804,2025-02-26 03:28:23.637361,25.602557
channel-750,685428,30366263,30366280,17,2025-02-26 03:28:01.569096,2025-02-26 03:28:21.247877,19.678781
channel-750,685429,30366294,30366311,17,2025-02-26 03:28:41.380859,2025-02-26 03:29:06.305211,24.924352
channel-750,685430,30366297,30366305,8,2025-02-26 03:28:44.807733,2025-02-26 03:28:58.460573,13.65284
channel-750,685431,30366321,30366342,21,2025-02-26 03:29:19.350212,2025-02-26 03:29:46.825872,27.47566
channel-750,685432,30366339,30366345,6,2025-02-26 03:29:42.442524,2025-02-26 03:29:50.182702,7.740178
channel-750,685433,30366401,30366426,25,2025-02-26 03:30:59.680798,2025-02-26 03:31:30.523877,30.843079
channel-750,685434,30366418,30366422,4,2025-02-26 03:31:20.101530,2025-02-26 03:31:24.708409,4.606879
channel-750,685435,30366426,30366439,13,2025-02-26 03:31:30.523877,2025-02-26 03:31:47.773744,17.249867
channel-750,685436,30366469,30366489,20,2025-02-26 03:32:24.343858,2025-02-26 03:32:48.583370,24.239512
channel-750,685437,30366521,30366539,18,2025-02-26 03:33:32.792552,2025-02-26 03:33:54.612152,21.8196
channel-750,685438,30366532,30366554,22,2025-02-26 03:33:45.734325,2025-02-26 03:34:13.063463,27.329138
channel-750,685439,30366560,30366575,15,2025-02-26 03:34:22.989600,2025-02-26 03:34:44.565078,21.575478
channel-750,685440,30366590,30366615,25,2025-02-26 03:35:01.740693,2025-02-26 03:35:31.608917,29.868224
channel-750,685441,30366601,30366617,16,2025-02-26 03:35:14.489747,2025-02-26 03:35:35.062423,20.572676
channel-750,685442,30366602,30366619,17,2025-02-26 03:35:16.751477,2025-02-26 03:35:37.382626,20.631149
channel-750,685443,30366646,30366655,9,2025-02-26 03:36:10.439737,2025-02-26 03:36:23.048727,12.60899
channel-750,685444,30366654,30366668,14,2025-02-26 03:36:21.919998,2025-02-26 03:36:43.171307,21.251309
channel-750,685445,30366672,30366698,26,2025-02-26 03:36:47.577969,2025-02-26 03:37:19.312178,31.734209
channel-750,685446,30366700,30366708,8,2025-02-26 03:37:21.501829,2025-02-26 03:37:33.942849,12.44102
channel-750,685447,30366733,30366758,25,2025-02-26 03:38:06.436779,2025-02-26 03:38:41.597996,35.161217
channel-750,685448,30366737,30366759,22,2025-02-26 03:38:14.389465,2025-02-26 03:38:42.671105,28.28164
channel-750,685449,30366760,30366775,15,2025-02-26 03:38:43.781344,2025-02-26 03:39:01.103053,17.321709
channel-750,685450,30366774,30366788,14,2025-02-26 03:39:00.038149,2025-02-26 03:39:17.375385,17.337236
channel-750,685451,30366791,30366801,10,2025-02-26 03:39:20.584286,2025-02-26 03:39:33.397237,12.812951
channel-750,685452,30366794,30366815,21,2025-02-26 03:39:24.170157,2025-02-26 03:39:51.604095,27.433938
channel-750,685453,30366814,30366828,14,2025-02-26 03:39:50.208766,2025-02-26 03:40:07.849068,17.640302
channel-750,685454,30366844,30366858,14,2025-02-26 03:40:28.578041,2025-02-26 03:40:46.093715,17.515674
channel-750,685455,30366844,30366869,25,2025-02-26 03:40:28.578041,2025-02-26 03:40:59.213109,30.635068
channel-750,685456,30366848,30366863,15,2025-02-26 03:40:33.237767,2025-02-26 03:40:51.469923,18.232156
channel-750,685457,30366895,30366907,12,2025-02-26 03:41:31.417525,2025-02-26 03:41:44.914657,13.497132
channel-750,685458,30366929,30366939,10,2025-02-26 03:42:18.578089,2025-02-26 03:42:32.634574,14.056485
channel-750,685459,30366967,30366990,23,2025-02-26 03:43:08.470704,2025-02-26 03:43:36.810856,28.340152
channel-750,685460,30366994,30367010,16,2025-02-26 03:43:41.308616,2025-02-26 03:44:04.908567,23.599951
channel-750,685461,30367017,30367022,5,2025-02-26 03:44:14.946393,2025-02-26 03:44:20.664971,5.718578
channel-750,685462,30367021,30367040,19,2025-02-26 03:44:19.382557,2025-02-26 03:44:43.379757,23.9972
channel-750,685463,30367032,30367050,18,2025-02-26 03:44:32.170311,2025-02-26 03:44:55.191995,23.021684
channel-750,685464,30367032,30367042,10,2025-02-26 03:44:32.170311,2025-02-26 03:44:45.574002,13.403691
channel-750,685465,30367078,30367099,21,2025-02-26 03:45:33.709715,2025-02-26 03:46:00.482307,26.772592
channel-750,685466,30367090,30367099,9,2025-02-26 03:45:48.420442,2025-02-26 03:46:00.482307,12.061865
channel-750,685467,30367107,30367119,12,2025-02-26 03:46:09.794067,2025-02-26 03:46:27.852670,18.058603
channel-750,685468,30367147,30367158,11,2025-02-26 03:47:02.686486,2025-02-26 03:47:17.677001,14.990515
channel-750,685469,30367148,30367171,23,2025-02-26 03:47:05.296176,2025-02-26 03:47:34.307459,29.011283
channel-750,685470,30367149,30367171,22,2025-02-26 03:47:06.409298,2025-02-26 03:47:34.307459,27.898161
channel-750,685471,30367216,30367241,25,2025-02-26 03:48:30.528778,2025-02-26 03:49:02.632712,32.103934
channel-750,685472,30367230,30367235,5,2025-02-26 03:48:50.109311,2025-02-26 03:48:55.867864,5.758553
channel-750,685473,30367261,30367280,19,2025-02-26 03:49:31.986532,2025-02-26 03:49:57.034506,25.047974
channel-750,685474,30367271,30367293,22,2025-02-26 03:49:44.828477,2025-02-26 03:50:12.448302,27.619825
channel-750,685475,30367327,30367346,19,2025-02-26 03:50:54.057416,2025-02-26 03:51:21.288165,27.230749
channel-750,685476,30367388,30367413,25,2025-02-26 03:52:12.207167,2025-02-26 03:52:41.764973,29.557806
channel-750,685477,30367430,30367440,10,2025-02-26 03:53:08.073988,2025-02-26 03:53:20.199720,12.125732
channel-750,685478,30367439,30367460,21,2025-02-26 03:53:18.887692,2025-02-26 03:53:43.966040,25.078348
channel-750,685479,30367442,30367465,23,2025-02-26 03:53:23.655265,2025-02-26 03:53:49.822648,26.167383
channel-750,685480,30367496,30367523,27,2025-02-26 03:54:29.934448,2025-02-26 03:55:06.981492,37.047044
channel-750,685481,30367506,30367524,18,2025-02-26 03:54:42.095613,2025-02-26 03:55:08.147303,26.05169
channel-750,685482,30367558,30367581,23,2025-02-26 03:55:53.180352,2025-02-26 03:56:20.668813,27.488461
channel-750,685483,30367622,30367643,21,2025-02-26 03:57:18.796224,2025-02-26 03:57:44.477386,25.681162
channel-750,685484,30367683,30367707,24,2025-02-26 03:58:33.678070,2025-02-26 03:59:03.603947,29.925877
channel-750,685485,30367738,30367745,7,2025-02-26 03:59:42.932262,2025-02-26 03:59:55.127570,12.195308
channel-750,685486,30367740,30367763,23,2025-02-26 03:59:48.359940,2025-02-26 04:00:17.189763,28.829823
channel-750,685487,30367762,30367779,17,2025-02-26 04:00:16.042562,2025-02-26 04:00:36.987842,20.94528
channel-750,685488,30367789,30367801,12,2025-02-26 04:00:47.887410,2025-02-26 04:01:03.116630,15.22922
channel-750,685489,30367805,30367827,22,2025-02-26 04:01:07.731231,2025-02-26 04:01:38.403372,30.672141
channel-750,685490,30367841,30367848,7,2025-02-26 04:01:54.445403,2025-02-26 04:02:02.458500,8.013097
channel-750,685491,30367858,30367871,13,2025-02-26 04:02:15.349288,2025-02-26 04:02:32.580635,17.231347
channel-750,685492,30367865,30367899,34,2025-02-26 04:02:25.009426,2025-02-26 04:03:06.970494,41.961068
channel-750,685493,30367907,30367927,20,2025-02-26 04:03:18.352890,2025-02-26 04:03:42.787208,24.434318
channel-750,685494,30367923,30367945,22,2025-02-26 04:03:37.020004,2025-02-26 04:04:12.934094,35.91409
channel-750,685495,30367964,30367980,16,2025-02-26 04:04:39.581838,2025-02-26 04:04:57.661408,18.07957
channel-750,685496,30367973,30367998,25,2025-02-26 04:04:49.666722,2025-02-26 04:05:20.166548,30.499826
channel-750,685497,30368032,30368060,28,2025-02-26 04:06:01.062002,2025-02-26 04:06:41.338747,40.276745
channel-750,685498,30368037,30368058,21,2025-02-26 04:06:13.104304,2025-02-26 04:06:39.183776,26.079472
channel-750,685499,30368100,30368129,29,2025-02-26 04:07:29.790454,2025-02-26 04:08:07.054143,37.263689
channel-750,685500,30368104,30368121,17,2025-02-26 04:07:34.265138,2025-02-26 04:07:57.216118,22.95098
channel-750,685501,30368171,30368196,25,2025-02-26 04:09:02.722196,2025-02-26 04:09:34.856136,32.13394
channel-750,685502,30368175,30368189,14,2025-02-26 04:09:07.242756,2025-02-26 04:09:24.476165,17.233409
channel-750,685503,30368182,30368198,16,2025-02-26 04:09:16.180587,2025-02-26 04:09:37.182320,21.001733
channel-750,685504,30368187,30368198,11,2025-02-26 04:09:21.792378,2025-02-26 04:09:37.182320,15.389942
channel-750,685505,30368208,30368218,10,2025-02-26 04:09:50.269601,2025-02-26 04:10:01.805530,11.535929
channel-750,685506,30368230,30368253,23,2025-02-26 04:10:16.605215,2025-02-26 04:10:46.139906,29.534691
channel-750,685507,30368290,30368296,6,2025-02-26 04:11:29.356815,2025-02-26 04:11:40.584725,11.22791
channel-750,685508,30368297,30368321,24,2025-02-26 04:11:41.896567,2025-02-26 04:12:11.672113,29.775546
channel-750,685509,30368342,30368350,8,2025-02-26 04:12:40.341712,2025-02-26 04:12:50.614862,10.27315
channel-750,685510,30368354,30368374,20,2025-02-26 04:12:56.276546,2025-02-26 04:13:23.443503,27.166957
channel-750,685511,30368361,30368366,5,2025-02-26 04:13:04.386771,2025-02-26 04:13:13.292867,8.906096
channel-750,685512,30368395,30368400,5,2025-02-26 04:13:50.746504,2025-02-26 04:13:56.220172,5.473668
channel-750,685513,30368410,30368418,8,2025-02-26 04:14:07.535177,2025-02-26 04:14:16.799661,9.264484
channel-750,685514,30368416,30368437,21,2025-02-26 04:14:14.363649,2025-02-26 04:14:41.491854,27.128205
channel-750,685515,30368463,30368477,14,2025-02-26 04:15:15.658664,2025-02-26 04:15:31.418612,15.759948
channel-750,685516,30368471,30368493,22,2025-02-26 04:15:24.986131,2025-02-26 04:15:52.321810,27.335679
channel-750,685517,30368519,30368524,5,2025-02-26 04:16:24.690992,2025-02-26 04:16:30.415484,5.724492
channel-750,685518,30368541,30368560,19,2025-02-26 04:16:50.746845,2025-02-26 04:17:19.915691,29.168846
channel-750,685519,30368598,30368618,20,2025-02-26 04:18:05.466524,2025-02-26 04:18:31.664762,26.198238
channel-750,685520,30368653,30368671,18,2025-02-26 04:19:14.944852,2025-02-26 04:19:40.398078,25.453226
channel-750,685521,30368673,30368678,5,2025-02-26 04:19:42.626573,2025-02-26 04:19:49.276339,6.649766
channel-750,685522,30368718,30368739,21,2025-02-26 04:20:37.563222,2025-02-26 04:21:06.281093,28.717871
channel-750,685523,30368785,30368803,18,2025-02-26 04:22:02.262963,2025-02-26 04:22:28.186364,25.923401
channel-750,685524,30368838,30368857,19,2025-02-26 04:23:13.553907,2025-02-26 04:23:35.729134,22.175227
channel-750,685525,30368841,30368866,25,2025-02-26 04:23:16.939001,2025-02-26 04:23:45.798433,28.859432
channel-750,685526,30368902,30368923,21,2025-02-26 04:24:33.724076,2025-02-26 04:24:59.100474,25.376398
channel-750,685527,30368948,30368953,5,2025-02-26 04:25:28.573583,2025-02-26 04:25:34.166585,5.593002
channel-750,685528,30368961,30368985,24,2025-02-26 04:25:44.402941,2025-02-26 04:26:19.511302,35.108361
channel-750,685529,30368979,30368985,6,2025-02-26 04:26:07.770246,2025-02-26 04:26:19.511302,11.741056
channel-750,685530,30368995,30369009,14,2025-02-26 04:26:32.560776,2025-02-26 04:26:50.438687,17.877911
channel-750,685531,30369011,30369031,20,2025-02-26 04:26:52.831064,2025-02-26 04:27:17.815529,24.984465
channel-750,685532,30369014,30369019,5,2025-02-26 04:26:57.478939,2025-02-26 04:27:03.250374,5.771435
channel-750,685533,30369024,30369050,26,2025-02-26 04:27:09.914447,2025-02-26 04:27:39.352354,29.437907
channel-750,685534,30369087,30369108,21,2025-02-26 04:28:26.271858,2025-02-26 04:28:53.148359,26.876501
channel-750,685535,30369110,30369114,4,2025-02-26 04:28:55.341670,2025-02-26 04:29:00.314461,4.972791
channel-750,685536,30369136,30369151,15,2025-02-26 04:29:29.425940,2025-02-26 04:29:47.700606,18.274666
channel-750,685537,30369140,30369160,20,2025-02-26 04:29:34.181143,2025-02-26 04:30:01.328451,27.147308
channel-750,685538,30369169,30369173,4,2025-02-26 04:30:11.782043,2025-02-26 04:30:16.507160,4.725117
channel-750,685539,30369200,30369211,11,2025-02-26 04:30:52.892070,2025-02-26 04:31:07.209634,14.317564
channel-750,685540,30369202,30369224,22,2025-02-26 04:30:55.119086,2025-02-26 04:31:24.027034,28.907948
channel-750,685541,30369254,30369278,24,2025-02-26 04:32:06.006154,2025-02-26 04:32:34.600299,28.594145
channel-750,685542,30369260,30369272,12,2025-02-26 04:32:12.745967,2025-02-26 04:32:27.735674,14.989707
channel-750,685543,30369310,30369331,21,2025-02-26 04:33:13.919229,2025-02-26 04:33:42.899209,28.97998
channel-750,685544,30369316,30369326,10,2025-02-26 04:33:20.909365,2025-02-26 04:33:33.959966,13.050601
channel-750,685545,30369338,30369343,5,2025-02-26 04:33:51.189786,2025-02-26 04:33:56.797511,5.607725
channel-750,685546,30369354,30369359,5,2025-02-26 04:34:11.228242,2025-02-26 04:34:17.035187,5.806945
channel-750,685547,30369381,30369402,21,2025-02-26 04:34:42.507315,2025-02-26 04:35:07.400375,24.89306
channel-750,685548,30369432,30369454,22,2025-02-26 04:35:54.283880,2025-02-26 04:36:20.581489,26.297609
channel-750,685549,30369478,30369483,5,2025-02-26 04:36:49.125500,2025-02-26 04:36:54.704592,5.579092
channel-750,685550,30369498,30369521,23,2025-02-26 04:37:14.371003,2025-02-26 04:37:43.880617,29.509614
channel-750,685551,30369523,30369540,17,2025-02-26 04:37:46.157853,2025-02-26 04:38:07.083963,20.92611
channel-750,685552,30369553,30369578,25,2025-02-26 04:38:23.210562,2025-02-26 04:38:53.483228,30.272666
channel-750,685553,30369584,30369587,3,2025-02-26 04:39:00.251922,2025-02-26 04:39:07.986984,7.735062
channel-750,685554,30369615,30369638,23,2025-02-26 04:39:46.164213,2025-02-26 04:40:15.502940,29.338727
channel-750,685555,30369676,30369685,9,2025-02-26 04:41:01.720530,2025-02-26 04:41:14.274868,12.554338
channel-750,685556,30369682,30369704,22,2025-02-26 04:41:09.540449,2025-02-26 04:41:38.980063,29.439614
channel-750,685557,30369752,30369777,25,2025-02-26 04:42:39.327233,2025-02-26 04:43:09.487748,30.160515
channel-750,685558,30369814,30369833,19,2025-02-26 04:43:54.180820,2025-02-26 04:44:20.501695,26.320875
channel-750,685559,30369828,30369840,12,2025-02-26 04:44:13.569606,2025-02-26 04:44:29.340673,15.771067
channel-750,685560,30369863,30369888,25,2025-02-26 04:44:58.098405,2025-02-26 04:45:30.437425,32.33902
channel-750,685561,30369875,30369892,17,2025-02-26 04:45:14.029491,2025-02-26 04:45:34.783829,20.754338
channel-750,685562,30369900,30369914,14,2025-02-26 04:45:44.174274,2025-02-26 04:46:02.049998,17.875724
channel-750,685563,30369942,30369966,24,2025-02-26 04:46:39.904008,2025-02-26 04:47:08.473911,28.569903
channel-750,685564,30370003,30370023,20,2025-02-26 04:47:53.500712,2025-02-26 04:48:22.492630,28.991918
channel-750,685565,30370110,30370119,9,2025-02-26 04:50:17.195473,2025-02-26 04:50:29.293743,12.09827
channel-750,685566,30370110,30370134,24,2025-02-26 04:50:17.195473,2025-02-26 04:50:48.618242,31.422769
channel-750,685567,30370122,30370136,14,2025-02-26 04:50:33.721522,2025-02-26 04:50:51.033825,17.312303
channel-750,685568,30370157,30370168,11,2025-02-26 04:51:16.344254,2025-02-26 04:51:31.163515,14.819261
channel-750,685569,30370192,30370201,9,2025-02-26 04:52:00.652216,2025-02-26 04:52:13.504193,12.851977
channel-750,685570,30370356,30370369,13,2025-02-26 04:55:26.779925,2025-02-26 04:55:45.084195,18.30427
channel-750,685571,30370475,30370484,9,2025-02-26 04:57:59.221447,2025-02-26 04:58:10.846012,11.624565
channel-750,685572,30370510,30370515,5,2025-02-26 04:58:46.568661,2025-02-26 04:58:52.327845,5.759184
channel-750,685573,30370647,30370652,5,2025-02-26 05:01:41.252339,2025-02-26 05:01:48.175353,6.923014
channel-750,685574,30370684,30370701,17,2025-02-26 05:02:27.318705,2025-02-26 05:02:49.044598,21.725893
channel-750,685575,30370688,30370693,5,2025-02-26 05:02:31.911853,2025-02-26 05:02:37.553287,5.641434
channel-750,685576,30370726,30370732,6,2025-02-26 05:03:20.762022,2025-02-26 05:03:27.471829,6.709807
channel-750,685577,30370762,30370767,5,2025-02-26 05:04:04.935818,2025-02-26 05:04:10.811236,5.875418
channel-750,685578,30370946,30370951,5,2025-02-26 05:08:00.435167,2025-02-26 05:08:06.329390,5.894223
channel-750,685579,30370971,30370977,6,2025-02-26 05:08:34.267253,2025-02-26 05:08:41.320876,7.053623
channel-750,685580,30371034,30371039,5,2025-02-26 05:09:51.834951,2025-02-26 05:09:57.371118,5.536167
channel-750,685581,30371043,30371048,5,2025-02-26 05:10:02.079247,2025-02-26 05:10:08.957488,6.878241
channel-750,685582,30371060,30371079,19,2025-02-26 05:10:27.059215,2025-02-26 05:10:52.475931,25.416716
channel-750,685583,30371116,30371121,5,2025-02-26 05:11:41.495791,2025-02-26 05:11:48.195643,6.699852
channel-750,685584,30371151,30371159,8,2025-02-26 05:12:29.470635,2025-02-26 05:12:38.885082,9.414447
channel-750,685585,30371172,30371177,5,2025-02-26 05:12:53.707943,2025-02-26 05:13:00.425706,6.717763
channel-750,685586,30371247,30371256,9,2025-02-26 05:14:28.507755,2025-02-26 05:14:38.832452,10.324697
channel-750,685587,30371314,30371319,5,2025-02-26 05:15:56.328998,2025-02-26 05:16:03.649719,7.320721
channel-750,685588,30371493,30371497,4,2025-02-26 05:19:45.770499,2025-02-26 05:19:50.433189,4.66269
channel-750,685589,30371675,30371680,5,2025-02-26 05:23:41.483337,2025-02-26 05:23:46.813672,5.330335
channel-750,685590,30371828,30371832,4,2025-02-26 05:26:56.511991,2025-02-26 05:27:05.248601,8.73661
channel-750,685591,30372148,30372168,20,2025-02-26 05:33:48.923503,2025-02-26 05:34:12.103425,23.179922
channel-750,685592,30372208,30372227,19,2025-02-26 05:35:05.269552,2025-02-26 05:35:28.588594,23.319042
channel-750,685593,30372233,30372245,12,2025-02-26 05:35:35.558150,2025-02-26 05:35:51.494607,15.936457
channel-750,685594,30372387,30372409,22,2025-02-26 05:38:52.111336,2025-02-26 05:39:19.314308,27.202972
channel-750,685595,30372544,30372561,17,2025-02-26 05:42:13.239849,2025-02-26 05:42:33.871894,20.632045
channel-750,685596,30372661,30372665,4,2025-02-26 05:44:40.707228,2025-02-26 05:44:45.383492,4.676264
channel-750,685597,30372689,30372695,6,2025-02-26 05:45:17.102826,2025-02-26 05:45:24.235173,7.132347
channel-750,685598,30372785,30372789,4,2025-02-26 05:47:24.753695,2025-02-26 05:47:29.523975,4.77028
channel-750,685599,30372907,30372924,17,2025-02-26 05:49:56.075962,2025-02-26 05:50:21.308964,25.233002
channel-750,685600,30372951,30372956,5,2025-02-26 05:50:54.808929,2025-02-26 05:51:00.357783,5.548854
channel-750,685601,30373094,30373100,6,2025-02-26 05:53:56.030270,2025-02-26 05:54:02.886108,6.855838
channel-750,685602,30373166,30373170,4,2025-02-26 05:55:29.091210,2025-02-26 05:55:33.573293,4.482083
channel-750,685603,30373283,30373289,6,2025-02-26 05:57:52.915669,2025-02-26 05:58:02.288517,9.372848
channel-750,685604,30373294,30373308,14,2025-02-26 05:58:08.904181,2025-02-26 05:58:29.085363,20.181182
channel-750,685605,30373301,30373318,17,2025-02-26 05:58:20.986313,2025-02-26 05:58:41.821340,20.835027
channel-750,685606,30373318,30373329,11,2025-02-26 05:58:41.821340,2025-02-26 05:58:55.554575,13.733235
channel-750,685607,30373351,30373356,5,2025-02-26 05:59:25.294253,2025-02-26 05:59:31.170269,5.876016
channel-750,685608,30373378,30373383,5,2025-02-26 05:59:57.582342,2025-02-26 06:00:03.591597,6.009255
channel-750,685609,30373389,30373394,5,2025-02-26 06:00:14.518462,2025-02-26 06:00:22.189023,7.670561
channel-750,685610,30373553,30373557,4,2025-02-26 06:03:50.961692,2025-02-26 06:03:55.449082,4.48739
channel-750,685611,30373612,30373617,5,2025-02-26 06:05:11.085533,2025-02-26 06:05:17.217229,6.131696
channel-750,685612,30373652,30373665,13,2025-02-26 06:06:00.200689,2025-02-26 06:06:15.595183,15.394494
channel-750,685613,30373740,30373747,7,2025-02-26 06:07:51.984740,2025-02-26 06:07:59.876008,7.891268
channel-750,685614,30373795,30373809,14,2025-02-26 06:09:06.505272,2025-02-26 06:09:23.555363,17.050091
channel-750,685615,30373882,30373888,6,2025-02-26 06:10:56.373371,2025-02-26 06:11:03.330269,6.956898
channel-750,685616,30373884,30373889,5,2025-02-26 06:10:58.967482,2025-02-26 06:11:04.371733,5.404251
channel-750,685617,30373951,30373955,4,2025-02-26 06:12:23.743636,2025-02-26 06:12:28.268921,4.525285
channel-750,685618,30374076,30374080,4,2025-02-26 06:15:04.071163,2025-02-26 06:15:10.121912,6.050749
channel-750,685619,30374246,30374251,5,2025-02-26 06:18:39.243671,2025-02-26 06:18:47.342290,8.098619
channel-750,685620,30374279,30374290,11,2025-02-26 06:19:21.951825,2025-02-26 06:19:35.322485,13.37066
channel-750,685621,30374315,30374327,12,2025-02-26 06:20:07.665453,2025-02-26 06:20:21.153592,13.488139
channel-750,685622,30374369,30374373,4,2025-02-26 06:21:18.516626,2025-02-26 06:21:26.563921,8.047295
channel-750,685623,30374373,30374381,8,2025-02-26 06:21:26.563921,2025-02-26 06:21:36.611135,10.047214
channel-750,685624,30374443,30374447,4,2025-02-26 06:22:52.360218,2025-02-26 06:22:56.834864,4.474646
channel-750,685625,30374617,30374627,10,2025-02-26 06:26:35.387076,2025-02-26 06:26:47.039832,11.652756
channel-750,685626,30374650,30374663,13,2025-02-26 06:27:15.606133,2025-02-26 06:27:33.814508,18.208375
channel-750,685627,30374671,30374724,53,2025-02-26 06:27:43.961060,2025-02-26 06:28:52.134576,68.173516
channel-750,685628,30374682,30374699,17,2025-02-26 06:27:58.001702,2025-02-26 06:28:22.404300,24.402598
channel-750,685629,30374684,30374699,15,2025-02-26 06:28:01.815204,2025-02-26 06:28:22.404300,20.589096
channel-750,685630,30374686,30374691,5,2025-02-26 06:28:05.215388,2025-02-26 06:28:12.036252,6.820864
channel-750,685631,30374693,30374705,12,2025-02-26 06:28:14.588729,2025-02-26 06:28:29.251535,14.662806
channel-750,685632,30374710,30374725,15,2025-02-26 06:28:35.227297,2025-02-26 06:28:53.522303,18.295006
channel-750,685633,30374714,30374726,12,2025-02-26 06:28:39.788461,2025-02-26 06:28:54.568061,14.7796
channel-750,685634,30374737,30374751,14,2025-02-26 06:29:08.457494,2025-02-26 06:29:25.970624,17.51313
channel-750,685635,30374739,30374751,12,2025-02-26 06:29:10.689294,2025-02-26 06:29:25.970624,15.28133
channel-750,685636,30374762,30374779,17,2025-02-26 06:29:38.606424,2025-02-26 06:29:59.768283,21.161859
channel-750,685637,30374770,30374787,17,2025-02-26 06:29:49.372476,2025-02-26 06:30:13.139091,23.766615
channel-750,685638,30374781,30374792,11,2025-02-26 06:30:01.960649,2025-02-26 06:30:20.134619,18.17397
channel-750,685639,30374786,30374797,11,2025-02-26 06:30:11.886929,2025-02-26 06:30:27.754808,15.867879
channel-750,685640,30374817,30374841,24,2025-02-26 06:30:50.725684,2025-02-26 06:31:20.454595,29.728911
channel-750,685641,30374820,30374834,14,2025-02-26 06:30:54.146897,2025-02-26 06:31:10.415929,16.269032
channel-750,685642,30374822,30374834,12,2025-02-26 06:30:56.343998,2025-02-26 06:31:10.415929,14.071931
channel-750,685643,30374850,30374865,15,2025-02-26 06:31:32.210282,2025-02-26 06:31:51.643377,19.433095
channel-750,685644,30374893,30374898,5,2025-02-26 06:32:26.402038,2025-02-26 06:32:33.212697,6.810659
channel-750,685645,30374939,30374951,12,2025-02-26 06:33:24.176842,2025-02-26 06:33:42.857799,18.680957
channel-750,685646,30374942,30374947,5,2025-02-26 06:33:31.778655,2025-02-26 06:33:37.257840,5.479185
channel-750,685647,30374983,30374996,13,2025-02-26 06:34:20.268450,2025-02-26 06:34:40.845945,20.577495
channel-750,685648,30374984,30374986,2,2025-02-26 06:34:21.448081,2025-02-26 06:34:24.942889,3.494808
channel-750,685649,30375095,30375117,22,2025-02-26 06:36:45.733813,2025-02-26 06:37:15.108011,29.374198
channel-750,685650,30375148,30375169,21,2025-02-26 06:37:53.161100,2025-02-26 06:38:17.232662,24.071562
channel-750,685651,30375191,30375193,2,2025-02-26 06:38:44.307970,2025-02-26 06:38:46.462923,2.154953
channel-750,685652,30375204,30375226,22,2025-02-26 06:39:03.808024,2025-02-26 06:39:31.036695,27.228671
channel-750,685653,30375259,30375281,22,2025-02-26 06:40:10.809107,2025-02-26 06:40:38.839567,28.03046
channel-750,685654,30375319,30375340,21,2025-02-26 06:41:28.230638,2025-02-26 06:41:55.338270,27.107632
channel-750,685655,30375387,30375392,5,2025-02-26 06:42:54.093989,2025-02-26 06:43:00.918958,6.824969
channel-750,685656,30375389,30375412,23,2025-02-26 06:42:57.490795,2025-02-26 06:43:25.615194,28.124399
channel-750,685657,30375442,30375463,21,2025-02-26 06:44:08.005073,2025-02-26 06:44:37.624380,29.619307
channel-750,685658,30375449,30375453,4,2025-02-26 06:44:16.109090,2025-02-26 06:44:20.890618,4.781528
channel-750,685659,30375503,30375534,31,2025-02-26 06:45:27.653519,2025-02-26 06:46:06.277279,38.62376
channel-750,685660,30375505,30375517,12,2025-02-26 06:45:30.013350,2025-02-26 06:45:45.754711,15.741361
channel-750,685661,30375563,30375587,24,2025-02-26 06:46:44.485070,2025-02-26 06:47:15.443023,30.957953
channel-750,685662,30375617,30375640,23,2025-02-26 06:47:56.898025,2025-02-26 06:48:24.384642,27.486617
channel-750,685663,30375624,30375635,11,2025-02-26 06:48:05.038513,2025-02-26 06:48:18.914401,13.875888
channel-750,685664,30375637,30375646,9,2025-02-26 06:48:21.069498,2025-02-26 06:48:33.702859,12.633361
channel-750,685665,30375662,30375671,9,2025-02-26 06:48:54.090314,2025-02-26 06:49:06.336084,12.24577
channel-750,685666,30375666,30375690,24,2025-02-26 06:48:58.546639,2025-02-26 06:49:28.364777,29.818138
channel-750,685667,30375705,30375715,10,2025-02-26 06:49:45.626362,2025-02-26 06:49:58.396971,12.770609
channel-750,685668,30375732,30375755,23,2025-02-26 06:50:19.699099,2025-02-26 06:50:46.979167,27.280068
channel-750,685669,30375740,30375760,20,2025-02-26 06:50:28.843882,2025-02-26 06:50:54.332160,25.488278
channel-750,685670,30375745,30375759,14,2025-02-26 06:50:35.650758,2025-02-26 06:50:53.222442,17.571684
channel-750,685671,30375767,30375780,13,2025-02-26 06:51:04.292832,2025-02-26 06:51:19.312041,15.019209
channel-750,685672,30375769,30375787,18,2025-02-26 06:51:06.473920,2025-02-26 06:51:28.300140,21.82622
channel-750,685673,30375782,30375793,11,2025-02-26 06:51:21.463476,2025-02-26 06:51:35.386401,13.922925
channel-750,685674,30375790,30375806,16,2025-02-26 06:51:31.928505,2025-02-26 06:51:55.806007,23.877502
channel-750,685675,30375798,30375817,19,2025-02-26 06:51:41.916177,2025-02-26 06:52:11.424008,29.507831
channel-750,685676,30375807,30375824,17,2025-02-26 06:51:57.175932,2025-02-26 06:52:19.548604,22.372672
channel-750,685677,30375816,30375828,12,2025-02-26 06:52:07.069164,2025-02-26 06:52:23.885909,16.816745
channel-750,685678,30375824,30375836,12,2025-02-26 06:52:19.548604,2025-02-26 06:52:32.839870,13.291266
channel-750,685679,30375851,30375872,21,2025-02-26 06:52:53.399452,2025-02-26 06:53:19.814684,26.415232
channel-750,685680,30375887,30375900,13,2025-02-26 06:53:37.397912,2025-02-26 06:53:55.200819,17.802907
channel-750,685681,30375910,30375935,25,2025-02-26 06:54:07.655389,2025-02-26 06:54:38.810376,31.154987
channel-750,685682,30375946,30375960,14,2025-02-26 06:54:51.418982,2025-02-26 06:55:09.643778,18.224796
channel-750,685683,30375971,30375990,19,2025-02-26 06:55:22.004754,2025-02-26 06:55:48.245351,26.240597
channel-750,685684,30375981,30375995,14,2025-02-26 06:55:36.499622,2025-02-26 06:55:54.263169,17.763547
channel-750,685685,30375997,30376007,10,2025-02-26 06:55:56.490734,2025-02-26 06:56:09.182498,12.691764
channel-750,685686,30376023,30376034,11,2025-02-26 06:56:29.554725,2025-02-26 06:56:45.331838,15.777113
channel-750,685687,30376031,30376054,23,2025-02-26 06:56:41.873805,2025-02-26 06:57:10.170981,28.297176
channel-750,685688,30376038,30376051,13,2025-02-26 06:56:49.865917,2025-02-26 06:57:06.872834,17.006917
channel-750,685689,30376043,30376054,11,2025-02-26 06:56:55.585989,2025-02-26 06:57:10.170981,14.584992
channel-750,685690,30376064,30376077,13,2025-02-26 06:57:27.751284,2025-02-26 06:57:44.061045,16.309761
channel-750,685691,30376075,30376087,12,2025-02-26 06:57:41.567875,2025-02-26 06:57:57.307903,15.740028
channel-750,685692,30376085,30376110,25,2025-02-26 06:57:54.999206,2025-02-26 06:58:26.077515,31.078309
channel-750,685693,30376157,30376186,29,2025-02-26 06:59:23.167566,2025-02-26 06:59:58.612477,35.444911
channel-750,685694,30376167,30376180,13,2025-02-26 06:59:35.043190,2025-02-26 06:59:52.034866,16.991676
channel-750,685695,30376170,30376187,17,2025-02-26 06:59:39.374811,2025-02-26 06:59:59.791428,20.416617
channel-750,685696,30376171,30376186,15,2025-02-26 06:59:40.628874,2025-02-26 06:59:58.612477,17.983603
channel-750,685697,30376214,30376230,16,2025-02-26 07:00:34.659338,2025-02-26 07:00:54.305501,19.646163
channel-750,685698,30376217,30376230,13,2025-02-26 07:00:38.079210,2025-02-26 07:00:54.305501,16.226291
channel-750,685699,30376233,30376254,21,2025-02-26 07:00:57.690129,2025-02-26 07:01:29.403211,31.713082
channel-750,685700,30376292,30376321,29,2025-02-26 07:02:16.807781,2025-02-26 07:02:55.706492,38.898711
channel-750,685701,30376300,30376311,11,2025-02-26 07:02:26.582039,2025-02-26 07:02:40.084994,13.502955
channel-750,685702,30376357,30376393,36,2025-02-26 07:03:41.157087,2025-02-26 07:04:26.033715,44.876628
channel-750,685703,30376379,30376401,22,2025-02-26 07:04:07.751573,2025-02-26 07:04:35.313903,27.56233
channel-750,685704,30376422,30376443,21,2025-02-26 07:05:05.206779,2025-02-26 07:05:33.695874,28.489095
channel-750,685705,30376473,30376487,14,2025-02-26 07:06:10.631562,2025-02-26 07:06:29.294173,18.662611
channel-750,685706,30376488,30376510,22,2025-02-26 07:06:30.396800,2025-02-26 07:06:59.239713,28.842913
channel-750,685707,30376494,30376498,4,2025-02-26 07:06:37.297004,2025-02-26 07:06:44.490800,7.193796
channel-750,685708,30376518,30376538,20,2025-02-26 07:07:08.410758,2025-02-26 07:07:33.679379,25.268621
channel-750,685709,30376550,30376573,23,2025-02-26 07:07:49.948556,2025-02-26 07:08:16.348585,26.400029
channel-750,685710,30376581,30376599,18,2025-02-26 07:08:28.386792,2025-02-26 07:08:49.505533,21.118741
channel-750,685711,30376611,30376632,21,2025-02-26 07:09:04.818333,2025-02-26 07:09:30.681794,25.863461
channel-750,685712,30376620,30376624,4,2025-02-26 07:09:14.863950,2025-02-26 07:09:21.496829,6.632879
channel-750,685713,30376621,30376625,4,2025-02-26 07:09:15.927442,2025-02-26 07:09:22.835486,6.908044
channel-750,685714,30376625,30376638,13,2025-02-26 07:09:22.835486,2025-02-26 07:09:37.672870,14.837384
channel-750,685715,30376661,30376665,4,2025-02-26 07:10:08.028825,2025-02-26 07:10:13.012793,4.983968
channel-750,685716,30376664,30376678,14,2025-02-26 07:10:11.780438,2025-02-26 07:10:31.717194,19.936756
channel-750,685717,30376672,30376705,33,2025-02-26 07:10:23.551091,2025-02-26 07:11:06.516341,42.96525
channel-750,685718,30376748,30376770,22,2025-02-26 07:12:04.509844,2025-02-26 07:12:31.428984,26.91914
channel-750,685719,30376785,30376799,14,2025-02-26 07:12:49.829985,2025-02-26 07:13:07.275022,17.445037
channel-750,685720,30376789,30376805,16,2025-02-26 07:12:54.556171,2025-02-26 07:13:14.243203,19.687032
channel-750,685721,30376818,30376822,4,2025-02-26 07:13:29.647191,2025-02-26 07:13:35.308248,5.661057
channel-750,685722,30376822,30376852,30,2025-02-26 07:13:35.308248,2025-02-26 07:14:15.537274,40.229026
channel-750,685723,30376824,30376839,15,2025-02-26 07:13:37.501556,2025-02-26 07:13:55.609215,18.107659
channel-750,685724,30376855,30376865,10,2025-02-26 07:14:22.101440,2025-02-26 07:14:35.083367,12.981927
channel-750,685725,30376862,30376878,16,2025-02-26 07:14:31.071151,2025-02-26 07:14:50.946619,19.875468
channel-750,685726,30376864,30376874,10,2025-02-26 07:14:33.614828,2025-02-26 07:14:46.371999,12.757171
channel-750,685727,30376865,30376878,13,2025-02-26 07:14:35.083367,2025-02-26 07:14:50.946619,15.863252
channel-750,685728,30376897,30376928,31,2025-02-26 07:15:12.991363,2025-02-26 07:15:53.048238,40.056875
channel-750,685729,30376910,30376921,11,2025-02-26 07:15:28.739430,2025-02-26 07:15:43.267279,14.527849
channel-750,685730,30376911,30376921,10,2025-02-26 07:15:29.815748,2025-02-26 07:15:43.267279,13.451531
channel-750,685731,30376920,30376925,5,2025-02-26 07:15:42.045654,2025-02-26 07:15:47.997477,5.951823
channel-750,685732,30376935,30376954,19,2025-02-26 07:16:02.523476,2025-02-26 07:16:25.018758,22.495282
channel-750,685733,30376946,30376970,24,2025-02-26 07:16:14.966770,2025-02-26 07:16:44.745650,29.77888
channel-750,685734,30376988,30376993,5,2025-02-26 07:17:06.160604,2025-02-26 07:17:13.100494,6.93989
channel-750,685735,30376998,30377009,11,2025-02-26 07:17:18.840939,2025-02-26 07:17:32.150242,13.309303
channel-750,685736,30377030,30377040,10,2025-02-26 07:17:59.101821,2025-02-26 07:18:13.645746,14.543925
channel-750,685737,30377051,30377061,10,2025-02-26 07:18:27.957725,2025-02-26 07:18:40.770903,12.813178
channel-750,685738,30377060,30377081,21,2025-02-26 07:18:38.460235,2025-02-26 07:19:08.840982,30.380747
channel-750,685739,30377100,30377124,24,2025-02-26 07:19:32.303385,2025-02-26 07:20:01.839706,29.536321
channel-750,685740,30377152,30377175,23,2025-02-26 07:20:36.113763,2025-02-26 07:21:06.421803,30.30804
channel-750,685741,30377188,30377207,19,2025-02-26 07:21:22.766719,2025-02-26 07:21:45.334583,22.567864
channel-750,685742,30377199,30377222,23,2025-02-26 07:21:34.881435,2025-02-26 07:22:02.666104,27.784669
channel-750,685743,30377210,30377221,11,2025-02-26 07:21:48.598679,2025-02-26 07:22:01.546203,12.947524
channel-750,685744,30377243,30377263,20,2025-02-26 07:22:28.728332,2025-02-26 07:22:59.182243,30.453911
channel-750,685745,30377287,30377309,22,2025-02-26 07:23:28.165887,2025-02-26 07:23:56.416589,28.250702
channel-750,685746,30377335,30377352,17,2025-02-26 07:24:27.121273,2025-02-26 07:24:48.888465,21.767192
channel-750,685747,30377434,30377457,23,2025-02-26 07:26:34.976395,2025-02-26 07:27:04.622936,29.646541
channel-750,685748,30377460,30377478,18,2025-02-26 07:27:09.022760,2025-02-26 07:27:34.185578,25.162818
channel-750,685749,30377479,30377500,21,2025-02-26 07:27:36.272035,2025-02-26 07:28:03.150254,26.878219
channel-750,685750,30377526,30377551,25,2025-02-26 07:28:32.634504,2025-02-26 07:29:07.535170,34.900666
channel-750,685751,30377571,30377592,21,2025-02-26 07:29:31.332431,2025-02-26 07:29:58.933950,27.601519
channel-750,685752,30377596,30377618,22,2025-02-26 07:30:03.706613,2025-02-26 07:30:29.557296,25.850683
channel-750,685753,30377623,30377649,26,2025-02-26 07:30:37.844945,2025-02-26 07:31:09.114274,31.269329
channel-750,685754,30377646,30377650,4,2025-02-26 07:31:05.656939,2025-02-26 07:31:10.508432,4.851493
channel-750,685755,30377758,30377762,4,2025-02-26 07:33:26.957714,2025-02-26 07:33:32.417034,5.45932
channel-750,685756,30377770,30377783,13,2025-02-26 07:33:42.837100,2025-02-26 07:33:59.939428,17.102328
channel-750,685757,30377912,30377934,22,2025-02-26 07:36:46.451670,2025-02-26 07:37:14.894936,28.443266
channel-750,685758,30378007,30378022,15,2025-02-26 07:38:45.253388,2025-02-26 07:39:04.267055,19.013667
channel-750,685759,30378066,30378070,4,2025-02-26 07:40:01.044853,2025-02-26 07:40:05.517880,4.473027
channel-750,685760,30378073,30378090,17,2025-02-26 07:40:10.167614,2025-02-26 07:40:31.945232,21.777618
channel-750,685761,30378210,30378221,11,2025-02-26 07:43:08.455449,2025-02-26 07:43:26.316240,17.860791
channel-750,685762,30378321,30378335,14,2025-02-26 07:45:34.862882,2025-02-26 07:45:52.040752,17.17787
channel-750,685763,30378366,30378393,27,2025-02-26 07:46:30.949232,2025-02-26 07:47:02.525879,31.576647
channel-750,685764,30378375,30378400,25,2025-02-26 07:46:41.216280,2025-02-26 07:47:13.380109,32.163829
channel-750,685765,30378439,30378452,13,2025-02-26 07:48:01.403829,2025-02-26 07:48:16.148505,14.744676
channel-750,685766,30378536,30378554,18,2025-02-26 07:50:09.019317,2025-02-26 07:50:32.631989,23.612672
channel-750,685767,30378597,30378609,12,2025-02-26 07:51:27.106282,2025-02-26 07:51:44.328646,17.222364
channel-750,685768,30378635,30378650,15,2025-02-26 07:52:14.330643,2025-02-26 07:52:33.724121,19.393478
channel-750,685769,30378640,30378650,10,2025-02-26 07:52:20.832761,2025-02-26 07:52:33.724121,12.89136
channel-750,685770,30378666,30378686,20,2025-02-26 07:52:55.765434,2025-02-26 07:53:18.909349,23.143915
channel-750,685771,30378719,30378724,5,2025-02-26 07:54:03.633483,2025-02-26 07:54:09.313165,5.679682
channel-750,685772,30378748,30378753,5,2025-02-26 07:54:40.270921,2025-02-26 07:54:46.824269,6.553348
channel-750,685773,30378848,30378870,22,2025-02-26 07:56:45.142983,2025-02-26 07:57:14.119997,28.977014
channel-750,685774,30378861,30378873,12,2025-02-26 07:57:02.445259,2025-02-26 07:57:17.397149,14.95189
channel-750,685775,30378862,30378873,11,2025-02-26 07:57:03.666745,2025-02-26 07:57:17.397149,13.730404
channel-750,685776,30378888,30378909,21,2025-02-26 07:57:35.139165,2025-02-26 07:58:01.699260,26.560095
channel-750,685777,30378892,30378906,14,2025-02-26 07:57:42.173621,2025-02-26 07:57:58.363595,16.189974
channel-750,685778,30378917,30378935,18,2025-02-26 07:58:16.975714,2025-02-26 07:58:40.975764,24.00005
channel-750,685779,30378969,30378986,17,2025-02-26 07:59:23.309278,2025-02-26 07:59:43.999628,20.69035
channel-750,685780,30378977,30378982,5,2025-02-26 07:59:32.708782,2025-02-26 07:59:39.389828,6.681046
channel-750,685781,30379007,30379012,5,2025-02-26 08:00:14.635525,2025-02-26 08:00:20.237967,5.602442
channel-750,685782,30379011,30379016,5,2025-02-26 08:00:19.125855,2025-02-26 08:00:24.730647,5.604792
channel-750,685783,30379028,30379034,6,2025-02-26 08:00:38.761544,2025-02-26 08:00:46.983550,8.222006
channel-750,685784,30379050,30379062,12,2025-02-26 08:01:06.750546,2025-02-26 08:01:20.587772,13.837226
channel-750,685785,30379097,30379115,18,2025-02-26 08:02:06.359264,2025-02-26 08:02:28.340617,21.981353
channel-750,685786,30379132,30379143,11,2025-02-26 08:02:51.997919,2025-02-26 08:03:04.305780,12.307861
channel-750,685787,30379163,30379168,5,2025-02-26 08:03:32.308684,2025-02-26 08:03:39.139734,6.83105
channel-750,685788,30379238,30379261,23,2025-02-26 08:05:09.344101,2025-02-26 08:05:38.045311,28.70121
channel-750,685789,30379364,30379373,9,2025-02-26 08:07:49.017248,2025-02-26 08:08:00.408457,11.391209
channel-750,685790,30379367,30379389,22,2025-02-26 08:07:52.603438,2025-02-26 08:08:19.949149,27.345711
channel-750,685791,30379411,30379416,5,2025-02-26 08:08:46.539310,2025-02-26 08:08:53.279920,6.74061
channel-750,685792,30379488,30379494,6,2025-02-26 08:10:28.860711,2025-02-26 08:10:35.652780,6.792069
channel-750,685793,30379489,30379511,22,2025-02-26 08:10:29.917330,2025-02-26 08:10:57.398994,27.481664
channel-750,685794,30379546,30379550,4,2025-02-26 08:11:43.115624,2025-02-26 08:11:51.167224,8.0516
channel-750,685795,30379549,30379559,10,2025-02-26 08:11:49.804899,2025-02-26 08:12:02.136633,12.331734
channel-750,685796,30379582,30379587,5,2025-02-26 08:12:30.059985,2025-02-26 08:12:35.622383,5.562398
channel-750,685797,30379629,30379648,19,2025-02-26 08:13:31.321758,2025-02-26 08:13:54.750122,23.428364
channel-750,685798,30379640,30379663,23,2025-02-26 08:13:45.084987,2025-02-26 08:14:13.136010,28.051023
channel-750,685799,30379664,30379682,18,2025-02-26 08:14:14.402290,2025-02-26 08:14:35.741608,21.339318
channel-750,685800,30379776,30379795,19,2025-02-26 08:16:39.537126,2025-02-26 08:17:03.423964,23.886838
channel-750,685801,30379847,30379851,4,2025-02-26 08:18:08.036799,2025-02-26 08:18:13.619248,5.582449
channel-750,685802,30379851,30379860,9,2025-02-26 08:18:13.619248,2025-02-26 08:18:25.871311,12.252063
channel-750,685803,30379926,30379948,22,2025-02-26 08:19:45.519383,2025-02-26 08:20:14.516961,28.997578
channel-750,685804,30379963,30379971,8,2025-02-26 08:20:37.320134,2025-02-26 08:20:47.696602,10.376468
