channel_id,sequence,send_height,ack_height,block_delay,send_time,ack_time,time_delay_sec
channel-0,4035524,30190020,30190026,6,2025-02-23 10:42:54.424619,2025-02-23 10:43:01.542649,7.11803
channel-0,4035525,30190050,30190061,11,2025-02-23 10:43:35.102038,2025-02-23 10:43:47.744567,12.642529
channel-0,4035526,30190065,30190073,8,2025-02-23 10:43:52.392870,2025-02-23 10:44:06.299379,13.906509
channel-0,4035527,30190111,30190123,12,2025-02-23 10:44:56.014325,2025-02-23 10:45:09.712518,13.698193
channel-0,4035528,30190140,30190152,12,2025-02-23 10:45:32.147675,2025-02-23 10:45:46.317986,14.170311
channel-0,4035529,30190500,30190512,12,2025-02-23 10:53:17.282602,2025-02-23 10:53:32.865460,15.582858
channel-0,4035530,30190745,30190752,7,2025-02-23 10:58:31.989208,2025-02-23 10:58:41.543864,9.554656
channel-0,4035531,30190824,30190836,12,2025-02-23 11:00:14.984690,2025-02-23 11:00:29.713620,14.72893
channel-0,4035532,30190873,30190884,11,2025-02-23 11:01:22.438856,2025-02-23 11:01:35.842028,13.403172
channel-0,4035533,30191107,30191120,13,2025-02-23 11:06:28.162064,2025-02-23 11:06:46.365306,18.203242
channel-0,4035534,30191139,30191151,12,2025-02-23 11:07:08.340644,2025-02-23 11:07:25.214569,16.873925
channel-0,4035535,30191276,30191282,6,2025-02-23 11:10:03.195996,2025-02-23 11:10:16.720394,13.524398
channel-0,4035536,30191337,30191348,11,2025-02-23 11:11:24.701140,2025-02-23 11:11:37.932858,13.231718
channel-0,4035537,30191343,30191399,56,2025-02-23 11:11:31.448427,2025-02-23 11:12:45.727276,74.278849
channel-0,4035538,30191362,30191374,12,2025-02-23 11:11:58.145058,2025-02-23 11:12:14.963460,16.818402
channel-0,4035539,30191363,30191374,11,2025-02-23 11:11:59.375197,2025-02-23 11:12:14.963460,15.588263
channel-0,4035540,30191363,30191374,11,2025-02-23 11:11:59.375197,2025-02-23 11:12:14.963460,15.588263
channel-0,4035541,30191364,30191374,10,2025-02-23 11:12:02.100751,2025-02-23 11:12:14.963460,12.862709
channel-0,4035542,30191430,30191442,12,2025-02-23 11:13:25.367810,2025-02-23 11:13:40.307566,14.939756
channel-0,4035543,30191484,30191499,15,2025-02-23 11:14:36.718233,2025-02-23 11:14:55.619733,18.9015
channel-0,4035544,30191639,30191649,10,2025-02-23 11:17:53.763828,2025-02-23 11:18:05.273076,11.509248
channel-0,4035545,30191698,30191711,13,2025-02-23 11:19:11.244747,2025-02-23 11:19:26.580876,15.336129
channel-0,4035546,30191710,30191717,7,2025-02-23 11:19:25.323394,2025-02-23 11:19:37.550814,12.22742
channel-0,4035547,30191711,30191717,6,2025-02-23 11:19:26.580876,2025-02-23 11:19:37.550814,10.969938
channel-0,4035548,30191790,30191814,24,2025-02-23 11:21:08.368203,2025-02-23 11:21:39.685080,31.316877
channel-0,4035549,30191792,30191818,26,2025-02-23 11:21:11.367696,2025-02-23 11:21:44.572398,33.204702
channel-0,4035550,30191861,30191888,27,2025-02-23 11:22:40.911616,2025-02-23 11:23:14.624289,33.712673
channel-0,4035551,30191944,30191955,11,2025-02-23 11:24:38.396540,2025-02-23 11:24:52.213850,13.81731
channel-0,4035552,30191963,30191972,9,2025-02-23 11:25:03.535752,2025-02-23 11:25:16.338665,12.802913
channel-0,4035553,30191968,30191977,9,2025-02-23 11:25:10.028998,2025-02-23 11:25:22.351809,12.322811
channel-0,4035554,30192014,30192027,13,2025-02-23 11:26:07.992052,2025-02-23 11:26:22.977703,14.985651
channel-0,4035555,30192078,30192089,11,2025-02-23 11:27:31.347158,2025-02-23 11:27:44.594537,13.247379
channel-0,4035556,30192138,30192149,11,2025-02-23 11:28:50.300568,2025-02-23 11:29:05.169544,14.868976
channel-0,4035557,30192148,30192159,11,2025-02-23 11:29:02.903466,2025-02-23 11:29:23.136673,20.233207
channel-0,4035558,30192196,30192204,8,2025-02-23 11:30:08.784856,2025-02-23 11:30:19.041959,10.257103
channel-0,4035559,30192272,30192281,9,2025-02-23 11:31:46.304145,2025-02-23 11:31:57.894464,11.590319
channel-0,4035560,30192368,30192380,12,2025-02-23 11:33:51.025508,2025-02-23 11:34:05.942154,14.916646
channel-0,4035561,30192439,30192450,11,2025-02-23 11:35:24.288352,2025-02-23 11:35:38.224455,13.936103
channel-0,4035562,30192453,30192464,11,2025-02-23 11:35:41.487534,2025-02-23 11:35:56.148126,14.660592
channel-0,4035563,30192474,30192483,9,2025-02-23 11:36:10.015079,2025-02-23 11:36:20.141050,10.125971
channel-0,4035564,30192533,30192546,13,2025-02-23 11:37:27.378900,2025-02-23 11:37:44.229351,16.850451
channel-0,4035565,30192582,30192591,9,2025-02-23 11:38:30.348081,2025-02-23 11:38:40.806522,10.458441
channel-0,4035566,30192612,30192625,13,2025-02-23 11:39:10.266216,2025-02-23 11:39:24.908657,14.642441
channel-0,4035567,30192635,30192644,9,2025-02-23 11:39:37.194917,2025-02-23 11:39:48.363148,11.168231
channel-0,4035568,30192663,30192671,8,2025-02-23 11:40:12.965267,2025-02-23 11:40:24.127875,11.162608
channel-0,4035569,30192696,30192707,11,2025-02-23 11:40:55.684896,2025-02-23 11:41:09.130783,13.445887
channel-0,4035570,30192725,30192734,9,2025-02-23 11:41:35.656266,2025-02-23 11:41:47.518738,11.862472
channel-0,4035571,30192742,30192753,11,2025-02-23 11:41:58.259943,2025-02-23 11:42:12.789793,14.52985
channel-0,4035572,30192771,30192781,10,2025-02-23 11:42:36.277791,2025-02-23 11:42:49.537793,13.260002
channel-0,4035573,30192789,30192801,12,2025-02-23 11:43:00.087115,2025-02-23 11:43:15.357007,15.269892
channel-0,4035574,30192883,30192890,7,2025-02-23 11:44:57.450137,2025-02-23 11:45:07.517511,10.067374
channel-0,4035575,30192888,30192901,13,2025-02-23 11:45:03.106854,2025-02-23 11:45:20.079984,16.97313
channel-0,4035576,30192914,30192924,10,2025-02-23 11:45:36.936987,2025-02-23 11:45:50.346389,13.409402
channel-0,4035577,30192946,30192954,8,2025-02-23 11:46:20.723192,2025-02-23 11:46:33.052206,12.329014
channel-0,4035578,30192971,30192978,7,2025-02-23 11:46:55.896406,2025-02-23 11:47:05.201620,9.305214
channel-0,4035579,30193030,30193060,30,2025-02-23 11:48:12.149504,2025-02-23 11:48:48.224271,36.074767
channel-0,4035580,30193135,30193143,8,2025-02-23 11:50:26.366326,2025-02-23 11:50:36.195204,9.828878
channel-0,4035581,30193184,30193192,8,2025-02-23 11:51:30.177522,2025-02-23 11:51:41.267672,11.09015
channel-0,4035582,30193197,30193210,13,2025-02-23 11:51:48.046786,2025-02-23 11:52:02.999421,14.952635
channel-0,4035583,30193219,30193230,11,2025-02-23 11:52:16.783081,2025-02-23 11:52:30.670562,13.887481
channel-0,4035584,30193232,30193244,12,2025-02-23 11:52:33.005313,2025-02-23 11:52:48.593615,15.588302
channel-0,4035585,30193266,30193275,9,2025-02-23 11:53:13.769642,2025-02-23 11:53:25.841613,12.071971
channel-0,4035586,30193269,30193280,11,2025-02-23 11:53:18.331514,2025-02-23 11:53:33.233758,14.902244
channel-0,4035587,30193278,30193290,12,2025-02-23 11:53:31.043774,2025-02-23 11:53:46.695557,15.651783
channel-0,4035588,30193349,30193359,10,2025-02-23 11:55:05.083798,2025-02-23 11:55:18.605644,13.521846
channel-0,4035589,30193373,30193382,9,2025-02-23 11:55:36.511476,2025-02-23 11:55:48.572229,12.060753
channel-0,4035590,30193521,30193530,9,2025-02-23 11:58:42.289088,2025-02-23 11:58:53.207505,10.918417
channel-0,4035591,30193555,30193580,25,2025-02-23 11:59:29.495701,2025-02-23 12:00:03.144660,33.648959
channel-0,4035592,30193570,30193580,10,2025-02-23 11:59:51.090869,2025-02-23 12:00:03.144660,12.053791
channel-0,4035593,30193589,30193599,10,2025-02-23 12:00:14.326456,2025-02-23 12:00:27.007896,12.68144
channel-0,4035594,30193593,30193603,10,2025-02-23 12:00:19.892697,2025-02-23 12:00:34.020265,14.127568
channel-0,4035595,30193720,30193731,11,2025-02-23 12:03:05.269940,2025-02-23 12:03:18.432645,13.162705
channel-0,4035596,30193748,30193758,10,2025-02-23 12:03:38.528764,2025-02-23 12:03:53.004156,14.475392
channel-0,4035597,30193748,30193758,10,2025-02-23 12:03:38.528764,2025-02-23 12:03:53.004156,14.475392
channel-0,4035598,30193758,30193766,8,2025-02-23 12:03:53.004156,2025-02-23 12:04:05.380164,12.376008
channel-0,4035599,30193770,30193780,10,2025-02-23 12:04:09.876162,2025-02-23 12:04:23.913396,14.037234
channel-0,4035600,30193770,30193796,26,2025-02-23 12:04:09.876162,2025-02-23 12:04:43.297941,33.421779
channel-0,4035601,30193821,30193829,8,2025-02-23 12:05:15.258991,2025-02-23 12:05:25.789405,10.530414
channel-0,4035602,30193857,30193868,11,2025-02-23 12:06:01.137910,2025-02-23 12:06:14.702042,13.564132
channel-0,4035603,30193890,30193901,11,2025-02-23 12:06:43.837910,2025-02-23 12:06:57.475433,13.637523
channel-0,4035604,30194054,30194067,13,2025-02-23 12:10:15.108770,2025-02-23 12:10:30.024094,14.915324
channel-0,4035605,30194096,30194106,10,2025-02-23 12:11:07.849037,2025-02-23 12:11:21.720551,13.871514
channel-0,4035606,30194103,30194115,12,2025-02-23 12:11:18.109289,2025-02-23 12:11:34.101240,15.991951
channel-0,4035607,30194129,30194138,9,2025-02-23 12:11:50.008511,2025-02-23 12:12:05.007020,14.998509
channel-0,4035608,30194272,30194296,24,2025-02-23 12:14:56.377692,2025-02-23 12:15:27.829075,31.451383
channel-0,4035609,30194504,30194517,13,2025-02-23 12:19:58.076021,2025-02-23 12:20:13.219004,15.142983
channel-0,4035610,30194607,30194631,24,2025-02-23 12:22:11.140023,2025-02-23 12:22:44.157715,33.017692
channel-0,4035611,30194670,30194682,12,2025-02-23 12:23:35.434811,2025-02-23 12:23:48.858429,13.423618
channel-0,4035612,30194698,30194732,34,2025-02-23 12:24:09.201130,2025-02-23 12:24:52.454313,43.253183
channel-0,4035613,30194750,30194758,8,2025-02-23 12:25:15.546754,2025-02-23 12:25:25.819579,10.272825
channel-0,4035614,30194810,30194833,23,2025-02-23 12:26:34.857305,2025-02-23 12:27:04.596310,29.739005
channel-0,4035615,30194822,30194833,11,2025-02-23 12:26:50.640227,2025-02-23 12:27:04.596310,13.956083
channel-0,4035616,30194837,30194848,11,2025-02-23 12:27:09.156236,2025-02-23 12:27:22.814669,13.658433
channel-0,4035617,30194851,30194861,10,2025-02-23 12:27:26.400325,2025-02-23 12:27:40.362321,13.961996
channel-0,4035618,30194852,30194861,9,2025-02-23 12:27:28.528262,2025-02-23 12:27:40.362321,11.834059
channel-0,4035619,30195000,30195008,8,2025-02-23 12:30:36.744105,2025-02-23 12:30:53.440393,16.696288
channel-0,4035620,30195036,30195047,11,2025-02-23 12:31:32.723920,2025-02-23 12:31:45.247458,12.523538
channel-0,4035621,30195135,30195146,11,2025-02-23 12:33:37.296138,2025-02-23 12:33:51.414634,14.118496
channel-0,4035622,30195147,30195169,22,2025-02-23 12:33:53.811517,2025-02-23 12:34:21.776920,27.965403
channel-0,4035623,30195200,30195226,26,2025-02-23 12:35:04.630775,2025-02-23 12:35:40.290027,35.659252
channel-0,4035624,30195324,30195333,9,2025-02-23 12:37:42.812087,2025-02-23 12:37:53.671408,10.859321
channel-0,4035625,30195348,30195361,13,2025-02-23 12:38:14.560739,2025-02-23 12:38:30.847985,16.287246
channel-0,4035626,30195396,30195416,20,2025-02-23 12:39:15.504836,2025-02-23 12:39:39.955063,24.450227
channel-0,4035627,30195398,30195409,11,2025-02-23 12:39:17.751742,2025-02-23 12:39:31.455399,13.703657
channel-0,4035628,30195431,30195439,8,2025-02-23 12:40:01.056697,2025-02-23 12:40:12.031462,10.974765
channel-0,4035629,30195579,30195591,12,2025-02-23 12:43:13.246994,2025-02-23 12:43:28.711763,15.464769
channel-0,4035630,30195602,30195610,8,2025-02-23 12:43:42.140949,2025-02-23 12:43:55.573690,13.432741
channel-0,4035631,30195606,30195612,6,2025-02-23 12:43:49.252632,2025-02-23 12:43:58.177394,8.924762
channel-0,4035632,30195638,30195647,9,2025-02-23 12:44:32.985955,2025-02-23 12:44:43.783631,10.797676
channel-0,4035633,30195646,30195653,7,2025-02-23 12:44:42.688123,2025-02-23 12:44:51.524393,8.83627
channel-0,4035634,30195681,30195690,9,2025-02-23 12:45:27.755543,2025-02-23 12:45:39.740553,11.98501
channel-0,4035635,30195698,30195708,10,2025-02-23 12:45:50.483409,2025-02-23 12:46:02.168213,11.684804
channel-0,4035636,30195782,30195805,23,2025-02-23 12:47:41.867005,2025-02-23 12:48:10.831667,28.964662
channel-0,4035637,30195808,30195819,11,2025-02-23 12:48:14.487166,2025-02-23 12:48:28.936552,14.449386
channel-0,4035638,30195824,30195835,11,2025-02-23 12:48:35.640859,2025-02-23 12:48:52.922237,17.281378
channel-0,4035639,30195841,30195849,8,2025-02-23 12:49:00.299825,2025-02-23 12:49:09.576653,9.276828
channel-0,4035640,30195877,30195888,11,2025-02-23 12:49:46.181312,2025-02-23 12:49:58.704474,12.523162
channel-0,4035641,30195888,30195898,10,2025-02-23 12:49:58.704474,2025-02-23 12:50:11.441568,12.737094
channel-0,4035642,30196008,30196017,9,2025-02-23 12:52:33.813226,2025-02-23 12:52:45.063342,11.250116
channel-0,4035643,30196101,30196112,11,2025-02-23 12:54:35.538556,2025-02-23 12:54:49.311531,13.772975
channel-0,4035644,30196111,30196121,10,2025-02-23 12:54:47.828272,2025-02-23 12:55:01.077200,13.248928
channel-0,4035645,30196159,30196169,10,2025-02-23 12:55:48.591836,2025-02-23 12:56:02.545747,13.953911
channel-0,4035646,30196183,30196192,9,2025-02-23 12:56:23.982837,2025-02-23 12:56:34.708430,10.725593
channel-0,4035647,30196190,30196202,12,2025-02-23 12:56:32.353301,2025-02-23 12:56:46.033999,13.680698
channel-0,4035648,30196196,30196207,11,2025-02-23 12:56:39.191667,2025-02-23 12:56:52.864526,13.672859
channel-0,4035649,30196224,30196234,10,2025-02-23 12:57:16.986129,2025-02-23 12:57:28.522584,11.536455
channel-0,4035650,30196248,30196255,7,2025-02-23 12:57:45.227645,2025-02-23 12:57:54.120417,8.892772
channel-0,4035651,30196269,30196279,10,2025-02-23 12:58:15.807628,2025-02-23 12:58:28.924273,13.116645
channel-0,4035652,30196272,30196284,12,2025-02-23 12:58:19.647219,2025-02-23 12:58:35.115584,15.468365
channel-0,4035653,30196275,30196284,9,2025-02-23 12:58:23.110902,2025-02-23 12:58:35.115584,12.004682
channel-0,4035654,30196291,30196301,10,2025-02-23 12:58:43.340046,2025-02-23 12:58:56.557492,13.217446
channel-0,4035655,30196336,30196346,10,2025-02-23 12:59:42.438746,2025-02-23 12:59:54.396276,11.95753
channel-0,4035656,30196341,30196351,10,2025-02-23 12:59:48.515150,2025-02-23 12:59:59.966430,11.45128
channel-0,4035657,30196411,30196419,8,2025-02-23 13:01:18.395231,2025-02-23 13:01:28.669252,10.274021
channel-0,4035658,30196416,30196429,13,2025-02-23 13:01:24.600717,2025-02-23 13:01:41.505737,16.90502
channel-0,4035659,30196466,30196474,8,2025-02-23 13:02:31.123412,2025-02-23 13:02:43.140357,12.016945
channel-0,4035660,30196503,30196513,10,2025-02-23 13:03:20.812255,2025-02-23 13:03:33.163883,12.351628
channel-0,4035661,30196594,30196606,12,2025-02-23 13:05:18.564015,2025-02-23 13:05:34.779041,16.215026
channel-0,4035662,30196650,30196662,12,2025-02-23 13:06:32.599127,2025-02-23 13:06:47.652755,15.053628
channel-0,4035663,30196669,30196679,10,2025-02-23 13:06:55.728281,2025-02-23 13:07:11.320727,15.592446
channel-0,4035664,30196684,30196693,9,2025-02-23 13:07:18.013582,2025-02-23 13:07:29.825836,11.812254
channel-0,4035665,30196724,30196731,7,2025-02-23 13:08:07.536936,2025-02-23 13:08:19.530626,11.99369
channel-0,4035666,30196731,30196738,7,2025-02-23 13:08:19.530626,2025-02-23 13:08:27.543575,8.012949
channel-0,4035667,30196753,30196766,13,2025-02-23 13:08:48.199667,2025-02-23 13:09:03.071372,14.871705
channel-0,4035668,30196807,30196816,9,2025-02-23 13:09:54.934190,2025-02-23 13:10:08.153315,13.219125
channel-0,4035669,30196814,30196825,11,2025-02-23 13:10:04.759041,2025-02-23 13:10:21.563225,16.804184
channel-0,4035670,30196818,30196830,12,2025-02-23 13:10:13.164999,2025-02-23 13:10:27.875209,14.71021
channel-0,4035671,30196961,30196968,7,2025-02-23 13:13:16.857769,2025-02-23 13:13:27.308870,10.451101
channel-0,4035672,30196976,30196987,11,2025-02-23 13:13:36.697424,2025-02-23 13:13:51.788086,15.090662
channel-0,4035673,30196978,30196987,9,2025-02-23 13:13:39.599876,2025-02-23 13:13:51.788086,12.18821
channel-0,4035674,30197021,30197032,11,2025-02-23 13:14:34.364011,2025-02-23 13:14:48.975452,14.611441
channel-0,4035675,30197063,30197079,16,2025-02-23 13:15:28.592264,2025-02-23 13:15:49.622376,21.030112
channel-0,4035676,30197077,30197083,6,2025-02-23 13:15:46.828904,2025-02-23 13:15:58.636265,11.807361
channel-0,4035677,30197122,30197134,12,2025-02-23 13:16:52.128978,2025-02-23 13:17:07.693558,15.56458
channel-0,4035678,30197132,30197144,12,2025-02-23 13:17:05.326080,2025-02-23 13:17:20.154521,14.828441
channel-0,4035679,30197137,30197148,11,2025-02-23 13:17:11.203247,2025-02-23 13:17:25.417351,14.214104
channel-0,4035680,30197168,30197178,10,2025-02-23 13:17:50.434840,2025-02-23 13:18:04.113578,13.678738
channel-0,4035681,30197202,30197211,9,2025-02-23 13:18:32.645634,2025-02-23 13:18:43.707249,11.061615
channel-0,4035682,30197269,30197279,10,2025-02-23 13:19:58.139445,2025-02-23 13:20:10.672766,12.533321
channel-0,4035683,30197292,30197302,10,2025-02-23 13:20:32.128440,2025-02-23 13:20:44.751499,12.623059
channel-0,4035684,30197302,30197311,9,2025-02-23 13:20:44.751499,2025-02-23 13:20:55.581349,10.82985
channel-0,4035685,30197329,30197339,10,2025-02-23 13:21:18.966192,2025-02-23 13:21:33.097524,14.131332
channel-0,4035686,30197357,30197370,13,2025-02-23 13:21:55.407167,2025-02-23 13:22:11.169850,15.762683
channel-0,4035687,30197407,30197418,11,2025-02-23 13:22:59.358519,2025-02-23 13:23:13.616616,14.258097
channel-0,4035688,30197425,30197436,11,2025-02-23 13:23:23.751510,2025-02-23 13:23:36.356982,12.605472
channel-0,4035689,30197437,30197450,13,2025-02-23 13:23:37.467517,2025-02-23 13:23:54.011241,16.543724
channel-0,4035690,30197458,30197466,8,2025-02-23 13:24:03.752160,2025-02-23 13:24:14.995651,11.243491
channel-0,4035691,30197586,30197594,8,2025-02-23 13:26:52.006291,2025-02-23 13:27:00.939975,8.933684
channel-0,4035692,30197591,30197600,9,2025-02-23 13:26:57.551459,2025-02-23 13:27:09.330942,11.779483
channel-0,4035693,30197695,30197711,16,2025-02-23 13:29:08.619790,2025-02-23 13:29:27.838795,19.219005
channel-0,4035694,30197778,30197788,10,2025-02-23 13:31:01.189782,2025-02-23 13:31:13.521443,12.331661
channel-0,4035695,30197851,30197862,11,2025-02-23 13:32:34.005422,2025-02-23 13:32:49.331878,15.326456
channel-0,4035696,30197908,30197920,12,2025-02-23 13:33:47.159694,2025-02-23 13:34:06.005421,18.845727
channel-0,4035697,30197934,30197942,8,2025-02-23 13:34:22.512661,2025-02-23 13:34:31.584229,9.071568
channel-0,4035698,30198113,30198121,8,2025-02-23 13:38:11.121074,2025-02-23 13:38:21.719891,10.598817
channel-0,4035699,30198113,30198121,8,2025-02-23 13:38:11.121074,2025-02-23 13:38:21.719891,10.598817
channel-0,4035700,30198120,30198129,9,2025-02-23 13:38:20.634275,2025-02-23 13:38:34.711278,14.077003
channel-0,4035701,30198282,30198291,9,2025-02-23 13:41:52.070273,2025-02-23 13:42:04.561207,12.490934
channel-0,4035702,30198292,30198306,14,2025-02-23 13:42:05.756618,2025-02-23 13:42:23.335151,17.578533
channel-0,4035703,30198476,30198482,6,2025-02-23 13:46:02.391789,2025-02-23 13:46:11.804939,9.41315
channel-0,4035704,30198482,30198493,11,2025-02-23 13:46:11.804939,2025-02-23 13:46:24.851554,13.046615
channel-0,4035705,30198619,30198632,13,2025-02-23 13:49:07.391516,2025-02-23 13:49:23.571413,16.179897
channel-0,4035706,30198659,30198668,9,2025-02-23 13:49:59.614377,2025-02-23 13:50:10.480365,10.865988
channel-0,4035707,30198745,30198755,10,2025-02-23 13:51:51.842367,2025-02-23 13:52:03.610540,11.768173
channel-0,4035708,30198807,30198815,8,2025-02-23 13:53:11.134245,2025-02-23 13:53:25.457599,14.323354
channel-0,4035709,30198813,30198825,12,2025-02-23 13:53:23.239649,2025-02-23 13:53:37.329172,14.089523
channel-0,4035710,30198829,30198845,16,2025-02-23 13:53:42.314738,2025-02-23 13:54:02.776190,20.461452
channel-0,4035711,30198830,30198845,15,2025-02-23 13:53:43.446500,2025-02-23 13:54:02.776190,19.32969
channel-0,4035712,30198895,30198905,10,2025-02-23 13:55:07.346470,2025-02-23 13:55:19.820278,12.473808
channel-0,4035713,30198933,30198946,13,2025-02-23 13:55:53.824969,2025-02-23 13:56:09.112469,15.2875
channel-0,4035714,30198951,30198960,9,2025-02-23 13:56:17.009926,2025-02-23 13:56:32.693340,15.683414
channel-0,4035715,30198993,30199006,13,2025-02-23 13:57:15.683091,2025-02-23 13:57:32.408364,16.725273
channel-0,4035716,30199005,30199014,9,2025-02-23 13:57:31.184453,2025-02-23 13:57:42.768832,11.584379
channel-0,4035717,30199024,30199045,21,2025-02-23 13:57:55.409950,2025-02-23 13:58:19.607200,24.19725
channel-0,4035718,30199046,30199054,8,2025-02-23 13:58:20.708738,2025-02-23 13:58:30.900361,10.191623
channel-0,4035719,30199069,30199078,9,2025-02-23 13:58:53.093164,2025-02-23 13:59:03.536642,10.443478
channel-0,4035720,30199085,30199096,11,2025-02-23 13:59:11.616617,2025-02-23 13:59:25.778481,14.161864
channel-0,4035721,30199153,30199159,6,2025-02-23 14:00:41.643529,2025-02-23 14:00:52.702612,11.059083
channel-0,4035722,30199237,30199247,10,2025-02-23 14:02:27.261865,2025-02-23 14:02:46.017900,18.756035
channel-0,4035723,30199352,30199362,10,2025-02-23 14:05:00.527863,2025-02-23 14:05:11.936224,11.408361
channel-0,4035724,30199413,30199420,7,2025-02-23 14:06:19.296677,2025-02-23 14:06:28.927458,9.630781
channel-0,4035725,30199601,30199612,11,2025-02-23 14:10:27.980346,2025-02-23 14:10:42.127792,14.147446
channel-0,4035726,30199712,30199725,13,2025-02-23 14:12:47.176681,2025-02-23 14:13:02.839644,15.662963
channel-0,4035727,30199768,30199779,11,2025-02-23 14:13:59.316027,2025-02-23 14:14:15.995950,16.679923
channel-0,4035728,30199784,30199794,10,2025-02-23 14:14:21.958257,2025-02-23 14:14:37.885451,15.927194
channel-0,4035729,30199811,30199824,13,2025-02-23 14:14:59.192747,2025-02-23 14:15:14.097383,14.904636
channel-0,4035730,30199827,30199838,11,2025-02-23 14:15:18.506068,2025-02-23 14:15:31.902378,13.39631
channel-0,4035731,30199877,30199889,12,2025-02-23 14:16:22.726583,2025-02-23 14:16:36.438979,13.712396
channel-0,4035732,30199921,30199929,8,2025-02-23 14:17:16.362525,2025-02-23 14:17:30.938529,14.576004
channel-0,4035733,30199924,30199930,6,2025-02-23 14:17:20.783837,2025-02-23 14:17:32.019730,11.235893
channel-0,4035734,30199998,30200011,13,2025-02-23 14:19:00.360947,2025-02-23 14:19:15.733645,15.372698
channel-0,4035735,30200079,30200089,10,2025-02-23 14:20:45.968356,2025-02-23 14:20:58.403518,12.435162
channel-0,4035736,30200151,30200161,10,2025-02-23 14:22:16.244659,2025-02-23 14:22:27.420026,11.175367
channel-0,4035737,30200201,30200209,8,2025-02-23 14:23:23.206766,2025-02-23 14:23:33.788943,10.582177
channel-0,4035738,30200399,30200408,9,2025-02-23 14:27:36.122598,2025-02-23 14:27:51.355064,15.232466
channel-0,4035739,30200509,30200518,9,2025-02-23 14:29:57.842860,2025-02-23 14:30:09.026549,11.183689
channel-0,4035740,30200593,30200603,10,2025-02-23 14:31:45.001303,2025-02-23 14:31:57.687132,12.685829
channel-0,4035741,30200675,30200688,13,2025-02-23 14:33:32.925893,2025-02-23 14:33:49.739961,16.814068
channel-0,4035742,30200685,30200696,11,2025-02-23 14:33:46.324677,2025-02-23 14:34:00.563411,14.238734
channel-0,4035743,30200703,30200710,7,2025-02-23 14:34:08.446019,2025-02-23 14:34:17.626809,9.18079
channel-0,4035744,30200747,30200755,8,2025-02-23 14:35:08.927457,2025-02-23 14:35:18.530102,9.602645
channel-0,4035745,30200748,30200772,24,2025-02-23 14:35:10.152002,2025-02-23 14:35:39.539569,29.387567
channel-0,4035746,30200778,30200787,9,2025-02-23 14:35:47.369509,2025-02-23 14:35:58.398701,11.029192
channel-0,4035747,30200782,30200791,9,2025-02-23 14:35:52.412851,2025-02-23 14:36:03.055017,10.642166
channel-0,4035748,30200918,30200928,10,2025-02-23 14:38:51.358456,2025-02-23 14:39:03.174603,11.816147
channel-0,4035749,30200919,30200928,9,2025-02-23 14:38:52.616206,2025-02-23 14:39:03.174603,10.558397
channel-0,4035750,30200920,30200933,13,2025-02-23 14:38:54.195796,2025-02-23 14:39:09.992365,15.796569
channel-0,4035751,30201000,30201009,9,2025-02-23 14:40:36.806505,2025-02-23 14:40:47.120755,10.31425
channel-0,4035752,30201018,30201027,9,2025-02-23 14:40:59.668475,2025-02-23 14:41:11.404308,11.735833
channel-0,4035753,30201026,30201033,7,2025-02-23 14:41:10.136168,2025-02-23 14:41:23.951777,13.815609
channel-0,4035754,30201059,30201072,13,2025-02-23 14:41:56.918604,2025-02-23 14:42:12.030925,15.112321
channel-0,4035755,30201062,30201072,10,2025-02-23 14:42:00.462024,2025-02-23 14:42:12.030925,11.568901
channel-0,4035756,30201071,30201082,11,2025-02-23 14:42:10.933996,2025-02-23 14:42:24.865743,13.931747
channel-0,4035757,30201112,30201125,13,2025-02-23 14:43:03.012629,2025-02-23 14:43:18.211193,15.198564
channel-0,4035758,30201186,30201197,11,2025-02-23 14:44:37.133310,2025-02-23 14:44:49.872849,12.739539
channel-0,4035759,30201205,30201216,11,2025-02-23 14:45:00.213212,2025-02-23 14:45:13.568045,13.354833
channel-0,4035760,30201279,30201292,13,2025-02-23 14:46:38.218522,2025-02-23 14:46:53.677488,15.458966
channel-0,4035761,30201282,30201292,10,2025-02-23 14:46:41.637792,2025-02-23 14:46:53.677488,12.039696
channel-0,4035762,30201296,30201307,11,2025-02-23 14:46:58.374526,2025-02-23 14:47:11.088315,12.713789
channel-0,4035763,30201344,30201353,9,2025-02-23 14:47:58.945815,2025-02-23 14:48:10.359121,11.413306
channel-0,4035764,30201471,30201482,11,2025-02-23 14:50:45.526105,2025-02-23 14:50:58.424568,12.898463
channel-0,4035765,30201496,30201515,19,2025-02-23 14:51:16.644956,2025-02-23 14:51:41.558538,24.913582
channel-0,4035766,30201499,30201512,13,2025-02-23 14:51:20.103724,2025-02-23 14:51:35.472238,15.368514
channel-0,4035767,30201591,30201604,13,2025-02-23 14:53:21.178975,2025-02-23 14:53:35.960863,14.781888
channel-0,4035768,30201592,30201604,12,2025-02-23 14:53:22.296023,2025-02-23 14:53:35.960863,13.66484
channel-0,4035769,30201691,30201703,12,2025-02-23 14:55:29.819943,2025-02-23 14:55:43.490812,13.670869
channel-0,4035770,30201752,30201774,22,2025-02-23 14:56:47.294392,2025-02-23 14:57:17.290459,29.996067
channel-0,4035771,30201770,30201779,9,2025-02-23 14:57:11.690628,2025-02-23 14:57:23.178209,11.487581
channel-0,4035772,30201773,30201785,12,2025-02-23 14:57:15.985494,2025-02-23 14:57:30.129286,14.143792
channel-0,4035773,30201789,30201799,10,2025-02-23 14:57:35.735803,2025-02-23 14:57:47.819068,12.083265
channel-0,4035774,30201806,30201818,12,2025-02-23 14:57:57.063072,2025-02-23 14:58:11.336988,14.273916
channel-0,4035775,30201814,30201823,9,2025-02-23 14:58:06.647432,2025-02-23 14:58:18.411566,11.764134
channel-0,4035776,30201826,30201847,21,2025-02-23 14:58:22.441244,2025-02-23 14:58:49.211790,26.770546
channel-0,4035777,30201853,30201864,11,2025-02-23 14:59:01.605601,2025-02-23 14:59:15.261283,13.655682
channel-0,4035778,30201921,30201945,24,2025-02-23 15:00:53.249087,2025-02-23 15:01:57.637845,64.388758
channel-0,4035779,30201928,30201943,15,2025-02-23 15:01:14.146766,2025-02-23 15:01:49.852254,35.705488
channel-0,4035780,30201938,30201954,16,2025-02-23 15:01:40.095487,2025-02-23 15:02:12.051444,31.955957
channel-0,4035781,30201942,30201954,12,2025-02-23 15:01:48.122844,2025-02-23 15:02:12.051444,23.9286
channel-0,4035782,30201945,30201952,7,2025-02-23 15:01:57.637845,2025-02-23 15:02:09.304457,11.666612
channel-0,4035783,30201958,30201976,18,2025-02-23 15:02:22.817110,2025-02-23 15:02:57.093115,34.276005
channel-0,4035784,30201958,30201979,21,2025-02-23 15:02:22.817110,2025-02-23 15:03:01.386192,38.569082
channel-0,4035785,30201979,30202004,25,2025-02-23 15:03:01.386192,2025-02-23 15:03:40.207610,38.821418
channel-0,4035786,30201995,30202004,9,2025-02-23 15:03:26.200811,2025-02-23 15:03:40.207610,14.006799
channel-0,4035787,30202004,30202026,22,2025-02-23 15:03:40.207610,2025-02-23 15:04:15.629368,35.421758
channel-0,4035788,30202023,30202038,15,2025-02-23 15:04:11.753269,2025-02-23 15:04:32.256354,20.503085
channel-0,4035789,30202050,30202069,19,2025-02-23 15:04:51.378704,2025-02-23 15:05:23.187195,31.808491
channel-0,4035790,30202054,30202068,14,2025-02-23 15:04:56.308933,2025-02-23 15:05:22.054727,25.745794
channel-0,4035791,30202056,30202080,24,2025-02-23 15:05:02.644305,2025-02-23 15:05:38.856698,36.212393
channel-0,4035792,30202056,30202068,12,2025-02-23 15:05:02.644305,2025-02-23 15:05:22.054727,19.410422
channel-0,4035793,30202062,30202069,7,2025-02-23 15:05:10.354085,2025-02-23 15:05:23.187195,12.83311
channel-0,4035794,30202071,30202080,9,2025-02-23 15:05:26.434304,2025-02-23 15:05:38.856698,12.422394
channel-0,4035795,30202074,30202094,20,2025-02-23 15:05:31.404288,2025-02-23 15:06:11.504779,40.100491
channel-0,4035796,30202125,30202138,13,2025-02-23 15:06:54.432273,2025-02-23 15:07:11.388436,16.956163
channel-0,4035797,30202131,30202151,20,2025-02-23 15:07:02.582858,2025-02-23 15:07:29.069166,26.486308
channel-0,4035798,30202131,30202156,25,2025-02-23 15:07:02.582858,2025-02-23 15:07:35.476950,32.894092
channel-0,4035799,30202151,30202180,29,2025-02-23 15:07:29.069166,2025-02-23 15:08:08.623058,39.553892
channel-0,4035800,30202160,30202186,26,2025-02-23 15:07:40.317647,2025-02-23 15:08:15.942067,35.62442
channel-0,4035801,30202181,30202189,8,2025-02-23 15:08:09.864953,2025-02-23 15:08:19.478399,9.613446
channel-0,4035802,30202217,30202227,10,2025-02-23 15:09:00.107913,2025-02-23 15:09:13.419780,13.311867
channel-0,4035803,30202232,30202246,14,2025-02-23 15:09:19.694728,2025-02-23 15:09:37.908090,18.213362
channel-0,4035804,30202238,30202371,133,2025-02-23 15:09:26.850017,2025-02-23 15:12:36.538251,189.688234
channel-0,4035805,30202250,30202270,20,2025-02-23 15:09:46.067444,2025-02-23 15:10:19.560852,33.493408
channel-0,4035806,30202263,30202280,17,2025-02-23 15:10:02.846203,2025-02-23 15:10:32.909721,30.063518
channel-0,4035807,30202268,30202280,12,2025-02-23 15:10:16.156785,2025-02-23 15:10:32.909721,16.752936
channel-0,4035808,30202281,30202304,23,2025-02-23 15:10:34.232761,2025-02-23 15:11:04.574280,30.341519
channel-0,4035809,30202289,30202299,10,2025-02-23 15:10:46.032884,2025-02-23 15:10:58.600253,12.567369
channel-0,4035810,30202299,30202309,10,2025-02-23 15:10:58.600253,2025-02-23 15:11:11.010458,12.410205
channel-0,4035811,30202309,30202319,10,2025-02-23 15:11:11.010458,2025-02-23 15:11:24.413295,13.402837
channel-0,4035812,30202322,30202340,18,2025-02-23 15:11:28.382651,2025-02-23 15:11:52.923504,24.540853
channel-0,4035813,30202331,30202340,9,2025-02-23 15:11:40.547474,2025-02-23 15:11:52.923504,12.37603
channel-0,4035814,30202381,30202390,9,2025-02-23 15:12:49.538102,2025-02-23 15:13:01.817911,12.279809
channel-0,4035815,30202427,30202438,11,2025-02-23 15:13:54.189231,2025-02-23 15:14:13.646078,19.456847
channel-0,4035816,30202529,30202540,11,2025-02-23 15:16:23.888842,2025-02-23 15:16:37.975987,14.087145
channel-0,4035817,30202543,30202555,12,2025-02-23 15:16:41.687409,2025-02-23 15:16:56.533809,14.8464
channel-0,4035818,30202554,30202572,18,2025-02-23 15:16:55.255625,2025-02-23 15:17:17.487962,22.232337
channel-0,4035819,30202568,30202575,7,2025-02-23 15:17:12.655142,2025-02-23 15:17:24.652988,11.997846
channel-0,4035820,30202572,30202584,12,2025-02-23 15:17:17.487962,2025-02-23 15:17:37.131250,19.643288
channel-0,4035821,30202584,30202603,19,2025-02-23 15:17:37.131250,2025-02-23 15:18:01.437028,24.305778
channel-0,4035822,30202591,30202603,12,2025-02-23 15:17:46.336162,2025-02-23 15:18:01.437028,15.100866
channel-0,4035823,30202615,30202637,22,2025-02-23 15:18:16.809722,2025-02-23 15:18:48.915493,32.105771
channel-0,4035824,30202677,30202685,8,2025-02-23 15:19:42.424958,2025-02-23 15:19:55.430077,13.005119
channel-0,4035825,30202710,30202727,17,2025-02-23 15:20:32.326210,2025-02-23 15:20:55.046600,22.72039
channel-0,4035826,30202719,30202731,12,2025-02-23 15:20:44.355070,2025-02-23 15:21:00.846029,16.490959
channel-0,4035827,30202765,30202774,9,2025-02-23 15:21:44.234304,2025-02-23 15:22:00.053445,15.819141
channel-0,4035828,30202788,30202800,12,2025-02-23 15:22:20.871923,2025-02-23 15:22:35.845855,14.973932
channel-0,4035829,30202833,30202854,21,2025-02-23 15:23:19.949048,2025-02-23 15:23:45.154609,25.205561
channel-0,4035830,30202878,30202889,11,2025-02-23 15:24:17.699857,2025-02-23 15:24:30.654718,12.954861
channel-0,4035831,30202931,30202940,9,2025-02-23 15:25:29.360636,2025-02-23 15:25:40.423325,11.062689
channel-0,4035832,30202932,30202957,25,2025-02-23 15:25:30.435207,2025-02-23 15:26:03.254287,32.81908
channel-0,4035833,30202950,30202957,7,2025-02-23 15:25:53.606922,2025-02-23 15:26:03.254287,9.647365
channel-0,4035834,30203007,30203018,11,2025-02-23 15:27:13.659123,2025-02-23 15:27:29.279067,15.619944
channel-0,4035835,30203015,30203029,14,2025-02-23 15:27:24.624220,2025-02-23 15:27:43.551861,18.927641
channel-0,4035836,30203031,30203042,11,2025-02-23 15:27:45.778993,2025-02-23 15:28:00.336422,14.557429
channel-0,4035837,30203084,30203097,13,2025-02-23 15:28:58.469979,2025-02-23 15:29:13.947019,15.47704
channel-0,4035838,30203105,30203114,9,2025-02-23 15:29:26.749310,2025-02-23 15:29:39.778863,13.029553
channel-0,4035839,30203106,30203114,8,2025-02-23 15:29:28.522587,2025-02-23 15:29:39.778863,11.256276
channel-0,4035840,30203130,30203139,9,2025-02-23 15:30:01.937368,2025-02-23 15:30:16.289859,14.352491
channel-0,4035841,30203130,30203139,9,2025-02-23 15:30:01.937368,2025-02-23 15:30:16.289859,14.352491
channel-0,4035842,30203154,30203163,9,2025-02-23 15:30:39.292951,2025-02-23 15:30:51.243440,11.950489
channel-0,4035843,30203177,30203187,10,2025-02-23 15:31:10.863250,2025-02-23 15:31:23.897642,13.034392
channel-0,4035844,30203226,30203239,13,2025-02-23 15:32:16.741956,2025-02-23 15:32:32.847649,16.105693
channel-0,4035845,30203230,30203239,9,2025-02-23 15:32:22.036126,2025-02-23 15:32:32.847649,10.811523
channel-0,4035846,30203257,30203284,27,2025-02-23 15:32:57.829252,2025-02-23 15:33:32.372793,34.543541
channel-0,4035847,30203260,30203272,12,2025-02-23 15:33:01.221441,2025-02-23 15:33:17.385461,16.16402
channel-0,4035848,30203275,30203284,9,2025-02-23 15:33:21.373297,2025-02-23 15:33:32.372793,10.999496
channel-0,4035849,30203293,30203304,11,2025-02-23 15:33:44.185816,2025-02-23 15:33:58.631729,14.445913
channel-0,4035850,30203325,30203334,9,2025-02-23 15:34:32.274041,2025-02-23 15:34:44.220837,11.946796
channel-0,4035851,30203330,30203336,6,2025-02-23 15:34:38.313869,2025-02-23 15:34:49.653808,11.339939
channel-0,4035852,30203339,30203350,11,2025-02-23 15:34:53.216092,2025-02-23 15:35:08.291511,15.075419
channel-0,4035853,30203365,30203374,9,2025-02-23 15:35:27.031047,2025-02-23 15:35:38.383842,11.352795
channel-0,4035854,30203385,30203390,5,2025-02-23 15:35:51.455135,2025-02-23 15:36:01.899020,10.443885
channel-0,4035855,30203414,30203427,13,2025-02-23 15:36:35.510364,2025-02-23 15:36:51.923598,16.413234
channel-0,4035856,30203462,30203474,12,2025-02-23 15:37:37.599335,2025-02-23 15:37:53.444244,15.844909
channel-0,4035857,30203475,30203484,9,2025-02-23 15:37:54.632706,2025-02-23 15:38:08.692007,14.059301
channel-0,4035858,30203533,30203556,23,2025-02-23 15:39:15.794909,2025-02-23 15:39:45.468108,29.673199
channel-0,4035859,30203542,30203555,13,2025-02-23 15:39:27.646501,2025-02-23 15:39:43.836893,16.190392
channel-0,4035860,30203567,30203576,9,2025-02-23 15:40:03.084862,2025-02-23 15:40:16.092351,13.007489
channel-0,4035861,30203594,30203608,14,2025-02-23 15:40:40.610967,2025-02-23 15:40:57.252484,16.641517
channel-0,4035862,30203611,30203622,11,2025-02-23 15:41:01.362717,2025-02-23 15:41:15.671064,14.308347
channel-0,4035863,30203664,30203675,11,2025-02-23 15:42:11.840751,2025-02-23 15:42:26.306157,14.465406
channel-0,4035864,30203666,30203678,12,2025-02-23 15:42:14.258837,2025-02-23 15:42:30.253717,15.99488
channel-0,4035865,30203680,30203704,24,2025-02-23 15:42:32.701806,2025-02-23 15:43:05.618407,32.916601
channel-0,4035866,30203689,30203699,10,2025-02-23 15:42:46.214902,2025-02-23 15:42:58.860782,12.64588
channel-0,4035867,30203693,30203704,11,2025-02-23 15:42:51.333852,2025-02-23 15:43:05.618407,14.284555
channel-0,4035868,30203695,30203704,9,2025-02-23 15:42:54.110083,2025-02-23 15:43:05.618407,11.508324
channel-0,4035869,30203698,30203709,11,2025-02-23 15:42:57.653392,2025-02-23 15:43:11.778678,14.125286
channel-0,4035870,30203700,30203709,9,2025-02-23 15:43:00.154189,2025-02-23 15:43:11.778678,11.624489
channel-0,4035871,30203734,30203743,9,2025-02-23 15:43:47.627486,2025-02-23 15:44:00.996967,13.369481
channel-0,4035872,30203752,30203765,13,2025-02-23 15:44:12.326881,2025-02-23 15:44:27.899832,15.572951
channel-0,4035873,30203769,30203780,11,2025-02-23 15:44:33.608899,2025-02-23 15:44:47.638283,14.029384
channel-0,4035874,30203787,30203796,9,2025-02-23 15:45:00.063082,2025-02-23 15:45:11.827303,11.764221
channel-0,4035875,30203814,30203824,10,2025-02-23 15:45:34.674682,2025-02-23 15:45:47.577586,12.902904
channel-0,4035876,30203930,30203953,23,2025-02-23 15:48:12.462697,2025-02-23 15:48:45.677161,33.214464
channel-0,4035877,30203930,30203945,15,2025-02-23 15:48:12.462697,2025-02-23 15:48:34.650064,22.187367
channel-0,4035878,30203931,30203953,22,2025-02-23 15:48:13.674124,2025-02-23 15:48:45.677161,32.003037
channel-0,4035879,30203934,30203953,19,2025-02-23 15:48:18.214240,2025-02-23 15:48:45.677161,27.462921
channel-0,4035880,30203938,30203945,7,2025-02-23 15:48:26.376552,2025-02-23 15:48:34.650064,8.273512
channel-0,4035881,30204040,30204068,28,2025-02-23 15:50:42.185762,2025-02-23 15:51:19.374686,37.188924
channel-0,4035882,30204083,30204107,24,2025-02-23 15:51:38.516720,2025-02-23 15:52:10.362280,31.84556
channel-0,4035883,30204085,30204115,30,2025-02-23 15:51:42.437332,2025-02-23 15:52:23.101943,40.664611
channel-0,4035884,30204086,30204107,21,2025-02-23 15:51:43.687652,2025-02-23 15:52:10.362280,26.674628
channel-0,4035885,30204095,30204107,12,2025-02-23 15:51:55.757568,2025-02-23 15:52:10.362280,14.604712
channel-0,4035886,30204164,30204191,27,2025-02-23 15:53:30.128010,2025-02-23 15:54:05.080757,34.952747
channel-0,4035887,30204242,30204266,24,2025-02-23 15:55:10.000232,2025-02-23 15:55:42.965517,32.965285
channel-0,4035888,30204266,30204278,12,2025-02-23 15:55:42.965517,2025-02-23 15:55:58.593931,15.628414
channel-0,4035889,30204266,30204278,12,2025-02-23 15:55:42.965517,2025-02-23 15:55:58.593931,15.628414
channel-0,4035890,30204284,30204292,8,2025-02-23 15:56:06.449799,2025-02-23 15:56:16.547741,10.097942
channel-0,4035891,30204311,30204334,23,2025-02-23 15:56:39.322443,2025-02-23 15:57:11.005069,31.682626
channel-0,4035892,30204347,30204356,9,2025-02-23 15:57:31.891257,2025-02-23 15:57:45.318348,13.427091
channel-0,4035893,30204376,30204387,11,2025-02-23 15:58:10.697381,2025-02-23 15:58:25.065790,14.368409
channel-0,4035894,30204379,30204406,27,2025-02-23 15:58:15.327152,2025-02-23 15:58:48.363544,33.036392
channel-0,4035895,30204391,30204400,9,2025-02-23 15:58:29.925314,2025-02-23 15:58:41.588804,11.66349
channel-0,4035896,30204449,30204477,28,2025-02-23 15:59:43.987022,2025-02-23 16:00:22.678793,38.691771
channel-0,4035897,30204506,30204515,9,2025-02-23 16:01:01.359835,2025-02-23 16:01:15.444235,14.0844
channel-0,4035898,30204522,30204535,13,2025-02-23 16:01:25.127445,2025-02-23 16:01:40.646348,15.518903
channel-0,4035899,30204529,30204552,23,2025-02-23 16:01:33.665852,2025-02-23 16:02:02.680435,29.014583
channel-0,4035900,30204544,30204552,8,2025-02-23 16:01:52.061970,2025-02-23 16:02:02.680435,10.618465
channel-0,4035901,30204600,30204608,8,2025-02-23 16:03:07.941292,2025-02-23 16:03:20.088032,12.14674
channel-0,4035902,30204605,30204618,13,2025-02-23 16:03:14.925683,2025-02-23 16:03:32.562028,17.636345
channel-0,4035903,30204639,30204645,6,2025-02-23 16:03:59.043566,2025-02-23 16:04:07.271420,8.227854
channel-0,4035904,30204646,30204657,11,2025-02-23 16:04:08.606224,2025-02-23 16:04:25.126215,16.519991
channel-0,4035905,30204673,30204684,11,2025-02-23 16:04:45.409683,2025-02-23 16:04:59.989424,14.579741
channel-0,4035906,30204673,30204684,11,2025-02-23 16:04:45.409683,2025-02-23 16:04:59.989424,14.579741
channel-0,4035907,30204674,30204684,10,2025-02-23 16:04:46.584270,2025-02-23 16:04:59.989424,13.405154
channel-0,4035908,30204699,30204711,12,2025-02-23 16:05:21.696041,2025-02-23 16:05:37.754932,16.058891
channel-0,4035909,30204780,30204785,5,2025-02-23 16:07:08.962852,2025-02-23 16:07:15.831254,6.868402
channel-0,4035910,30204792,30204800,8,2025-02-23 16:07:24.634728,2025-02-23 16:07:35.752539,11.117811
channel-0,4035911,30204813,30204822,9,2025-02-23 16:07:51.491638,2025-02-23 16:08:03.476585,11.984947
channel-0,4035912,30204896,30204907,11,2025-02-23 16:09:41.991305,2025-02-23 16:09:55.073270,13.081965
channel-0,4035913,30204946,30204966,20,2025-02-23 16:10:46.942579,2025-02-23 16:11:21.229868,34.287289
channel-0,4035914,30204975,30205001,26,2025-02-23 16:11:32.676901,2025-02-23 16:12:08.452619,35.775718
channel-0,4035915,30204987,30204997,10,2025-02-23 16:11:48.612425,2025-02-23 16:12:02.837247,14.224822
channel-0,4035916,30205122,30205129,7,2025-02-23 16:14:46.382940,2025-02-23 16:15:00.854721,14.471781
channel-0,4035917,30205127,30205138,11,2025-02-23 16:14:56.864258,2025-02-23 16:15:12.556292,15.692034
channel-0,4035918,30205142,30205167,25,2025-02-23 16:15:17.871161,2025-02-23 16:15:48.597622,30.726461
channel-0,4035919,30205178,30205191,13,2025-02-23 16:16:04.548629,2025-02-23 16:16:21.321453,16.772824
channel-0,4035920,30205189,30205214,25,2025-02-23 16:16:18.940955,2025-02-23 16:16:56.578953,37.637998
channel-0,4035921,30205199,30205208,9,2025-02-23 16:16:32.071764,2025-02-23 16:16:44.480765,12.409001
channel-0,4035922,30205206,30205214,8,2025-02-23 16:16:42.140111,2025-02-23 16:16:56.578953,14.438842
channel-0,4035923,30205215,30205224,9,2025-02-23 16:16:58.730601,2025-02-23 16:17:09.308687,10.578086
channel-0,4035924,30205219,30205229,10,2025-02-23 16:17:03.641820,2025-02-23 16:17:17.945134,14.303314
channel-0,4035925,30205220,30205232,12,2025-02-23 16:17:04.753006,2025-02-23 16:17:21.667590,16.914584
channel-0,4035926,30205241,30205253,12,2025-02-23 16:17:32.394342,2025-02-23 16:17:46.775673,14.381331
channel-0,4035927,30205265,30205276,11,2025-02-23 16:18:01.912829,2025-02-23 16:18:16.628961,14.716132
channel-0,4035928,30205267,30205276,9,2025-02-23 16:18:05.350676,2025-02-23 16:18:16.628961,11.278285
channel-0,4035929,30205288,30205298,10,2025-02-23 16:18:32.889614,2025-02-23 16:18:47.169353,14.279739
channel-0,4035930,30205416,30205424,8,2025-02-23 16:21:24.669155,2025-02-23 16:21:35.333476,10.664321
channel-0,4035931,30205427,30205437,10,2025-02-23 16:21:40.628954,2025-02-23 16:21:53.775764,13.14681
channel-0,4035932,30205513,30205523,10,2025-02-23 16:23:32.881816,2025-02-23 16:23:47.137684,14.255868
channel-0,4035933,30205518,30205535,17,2025-02-23 16:23:39.774800,2025-02-23 16:24:02.145240,22.37044
channel-0,4035934,30205564,30205579,15,2025-02-23 16:24:39.258187,2025-02-23 16:25:00.890512,21.632325
channel-0,4035935,30205582,30205591,9,2025-02-23 16:25:04.469743,2025-02-23 16:25:19.434943,14.9652
channel-0,4035936,30205623,30205636,13,2025-02-23 16:26:00.534144,2025-02-23 16:26:16.368545,15.834401
channel-0,4035937,30205659,30205670,11,2025-02-23 16:26:48.822206,2025-02-23 16:27:03.267002,14.444796
channel-0,4035938,30205766,30205775,9,2025-02-23 16:29:08.700226,2025-02-23 16:29:19.811889,11.111663
channel-0,4035939,30205801,30205816,15,2025-02-23 16:29:54.700289,2025-02-23 16:30:15.461131,20.760842
channel-0,4035940,30206000,30206007,7,2025-02-23 16:34:16.732834,2025-02-23 16:34:28.308566,11.575732
channel-0,4035941,30206082,30206091,9,2025-02-23 16:36:07.240223,2025-02-23 16:36:18.107551,10.867328
channel-0,4035942,30206264,30206272,8,2025-02-23 16:40:06.676509,2025-02-23 16:40:18.478444,11.801935
channel-0,4035943,30206295,30206302,7,2025-02-23 16:40:49.554930,2025-02-23 16:40:58.998152,9.443222
channel-0,4035944,30206300,30206312,12,2025-02-23 16:40:56.456852,2025-02-23 16:41:11.140206,14.683354
channel-0,4035945,30206347,30206358,11,2025-02-23 16:41:58.082481,2025-02-23 16:42:13.296470,15.213989
channel-0,4035946,30206356,30206369,13,2025-02-23 16:42:09.862989,2025-02-23 16:42:26.361982,16.498993
channel-0,4035947,30206385,30206395,10,2025-02-23 16:42:47.142450,2025-02-23 16:43:01.902511,14.760061
channel-0,4035948,30206395,30206405,10,2025-02-23 16:43:01.902511,2025-02-23 16:43:14.150631,12.24812
channel-0,4035949,30206448,30206463,15,2025-02-23 16:44:12.359068,2025-02-23 16:44:31.360629,19.001561
channel-0,4035950,30206450,30206463,13,2025-02-23 16:44:15.654846,2025-02-23 16:44:31.360629,15.705783
channel-0,4035951,30206555,30206567,12,2025-02-23 16:46:32.940257,2025-02-23 16:46:48.657803,15.717546
channel-0,4035952,30206577,30206585,8,2025-02-23 16:47:01.700117,2025-02-23 16:47:13.469778,11.769661
channel-0,4035953,30206595,30206604,9,2025-02-23 16:47:27.752509,2025-02-23 16:47:38.232273,10.479764
channel-0,4035954,30206644,30206655,11,2025-02-23 16:48:34.673422,2025-02-23 16:48:47.280910,12.607488
channel-0,4035955,30206691,30206699,8,2025-02-23 16:49:33.833280,2025-02-23 16:49:46.464721,12.631441
channel-0,4035956,30206716,30206727,11,2025-02-23 16:50:09.487327,2025-02-23 16:50:24.402504,14.915177
channel-0,4035957,30206776,30206789,13,2025-02-23 16:51:27.531502,2025-02-23 16:51:44.199468,16.667966
channel-0,4035958,30206918,30206930,12,2025-02-23 16:54:39.272034,2025-02-23 16:54:55.108956,15.836922
channel-0,4035959,30206949,30206961,12,2025-02-23 16:55:23.523802,2025-02-23 16:55:39.633965,16.110163
channel-0,4035960,30206970,30206979,9,2025-02-23 16:55:51.876157,2025-02-23 16:56:04.062077,12.18592
channel-0,4035961,30207043,30207053,10,2025-02-23 16:57:30.540349,2025-02-23 16:57:43.118426,12.578077
channel-0,4035962,30207129,30207140,11,2025-02-23 16:59:23.898397,2025-02-23 16:59:37.608431,13.710034
channel-0,4035963,30207155,30207166,11,2025-02-23 16:59:59.021668,2025-02-23 17:00:12.856054,13.834386
channel-0,4035964,30207157,30207166,9,2025-02-23 17:00:01.311755,2025-02-23 17:00:12.856054,11.544299
channel-0,4035965,30207166,30207176,10,2025-02-23 17:00:12.856054,2025-02-23 17:00:24.659147,11.803093
channel-0,4035966,30207304,30207315,11,2025-02-23 17:03:13.476205,2025-02-23 17:03:28.524274,15.048069
channel-0,4035967,30207321,30207351,30,2025-02-23 17:03:35.709370,2025-02-23 17:04:15.284884,39.575514
channel-0,4035968,30207341,30207353,12,2025-02-23 17:04:01.053047,2025-02-23 17:04:17.623672,16.570625
channel-0,4035969,30207384,30207396,12,2025-02-23 17:05:03.047721,2025-02-23 17:05:18.263245,15.215524
channel-0,4035970,30207385,30207396,11,2025-02-23 17:05:04.232088,2025-02-23 17:05:18.263245,14.031157
channel-0,4035971,30207422,30207434,12,2025-02-23 17:05:50.420048,2025-02-23 17:06:05.888143,15.468095
channel-0,4035972,30207497,30207508,11,2025-02-23 17:07:33.823047,2025-02-23 17:07:47.606989,13.783942
channel-0,4035973,30207589,30207611,22,2025-02-23 17:09:35.722292,2025-02-23 17:10:03.969317,28.247025
channel-0,4035974,30207604,30207613,9,2025-02-23 17:09:55.926341,2025-02-23 17:10:06.364296,10.437955
channel-0,4035975,30207638,30207659,21,2025-02-23 17:10:43.446428,2025-02-23 17:11:14.872886,31.426458
channel-0,4035976,30207706,30207714,8,2025-02-23 17:12:15.190822,2025-02-23 17:12:24.577761,9.386939
channel-0,4035977,30207709,30207717,8,2025-02-23 17:12:18.752246,2025-02-23 17:12:30.743377,11.991131
channel-0,4035978,30207779,30207789,10,2025-02-23 17:13:49.279318,2025-02-23 17:14:03.623295,14.343977
channel-0,4035979,30207790,30207799,9,2025-02-23 17:14:04.903668,2025-02-23 17:14:15.943311,11.039643
channel-0,4035980,30207835,30207845,10,2025-02-23 17:15:08.062700,2025-02-23 17:15:19.758690,11.69599
channel-0,4035981,30207852,30207868,16,2025-02-23 17:15:28.841647,2025-02-23 17:15:47.270952,18.429305
channel-0,4035982,30207856,30207868,12,2025-02-23 17:15:33.412897,2025-02-23 17:15:47.270952,13.858055
channel-0,4035983,30207944,30207955,11,2025-02-23 17:18:01.518540,2025-02-23 17:18:17.447760,15.92922
channel-0,4035984,30207979,30207988,9,2025-02-23 17:18:50.829829,2025-02-23 17:19:01.915916,11.086087
channel-0,4035985,30208187,30208199,12,2025-02-23 17:23:33.125929,2025-02-23 17:23:48.801194,15.675265
channel-0,4035986,30208190,30208199,9,2025-02-23 17:23:37.147527,2025-02-23 17:23:48.801194,11.653667
channel-0,4035987,30208194,30208204,10,2025-02-23 17:23:41.994153,2025-02-23 17:23:54.521176,12.527023
channel-0,4035988,30208206,30208217,11,2025-02-23 17:23:57.940707,2025-02-23 17:24:11.787679,13.846972
channel-0,4035989,30208231,30208243,12,2025-02-23 17:24:31.148735,2025-02-23 17:24:46.751217,15.602482
channel-0,4035990,30208265,30208279,14,2025-02-23 17:25:14.341031,2025-02-23 17:25:31.974222,17.633191
channel-0,4035991,30208293,30208303,10,2025-02-23 17:25:52.558087,2025-02-23 17:26:04.267800,11.709713
channel-0,4035992,30208390,30208401,11,2025-02-23 17:28:00.639646,2025-02-23 17:28:16.492569,15.852923
channel-0,4035993,30208454,30208465,11,2025-02-23 17:29:26.535858,2025-02-23 17:29:42.380663,15.844805
channel-0,4035994,30208458,30208470,12,2025-02-23 17:29:31.341346,2025-02-23 17:29:48.416967,17.075621
channel-0,4035995,30208516,30208528,12,2025-02-23 17:30:51.003647,2025-02-23 17:31:06.767389,15.763742
channel-0,4035996,30208516,30208528,12,2025-02-23 17:30:51.003647,2025-02-23 17:31:06.767389,15.763742
channel-0,4035997,30208577,30208587,10,2025-02-23 17:32:10.286012,2025-02-23 17:32:23.805119,13.519107
channel-0,4035998,30208585,30208599,14,2025-02-23 17:32:19.748282,2025-02-23 17:32:38.155262,18.40698
channel-0,4035999,30208621,30208631,10,2025-02-23 17:33:07.308093,2025-02-23 17:33:19.794479,12.486386
channel-0,4036000,30208623,30208636,13,2025-02-23 17:33:09.859228,2025-02-23 17:33:26.082000,16.222772
channel-0,4036001,30208693,30208702,9,2025-02-23 17:34:40.257191,2025-02-23 17:34:56.792225,16.535034
channel-0,4036002,30208697,30208707,10,2025-02-23 17:34:48.861065,2025-02-23 17:35:02.935553,14.074488
channel-0,4036003,30208750,30208759,9,2025-02-23 17:36:00.884747,2025-02-23 17:36:17.831701,16.946954
channel-0,4036004,30208788,30208799,11,2025-02-23 17:36:53.842224,2025-02-23 17:37:09.163654,15.32143
channel-0,4036005,30208830,30208839,9,2025-02-23 17:37:46.797815,2025-02-23 17:37:58.818543,12.020728
channel-0,4036006,30208845,30208855,10,2025-02-23 17:38:10.254598,2025-02-23 17:38:24.773715,14.519117
channel-0,4036007,30208877,30208888,11,2025-02-23 17:38:53.452228,2025-02-23 17:39:07.321238,13.86901
channel-0,4036008,30208879,30208888,9,2025-02-23 17:38:55.758164,2025-02-23 17:39:07.321238,11.563074
channel-0,4036009,30208903,30208912,9,2025-02-23 17:39:31.603238,2025-02-23 17:39:42.688869,11.085631
channel-0,4036010,30208923,30208937,14,2025-02-23 17:39:55.641349,2025-02-23 17:40:14.371345,18.729996
channel-0,4036011,30208947,30208958,11,2025-02-23 17:40:30.714347,2025-02-23 17:40:44.920485,14.206138
channel-0,4036012,30208955,30208966,11,2025-02-23 17:40:41.443233,2025-02-23 17:40:56.843714,15.400481
channel-0,4036013,30208972,30208982,10,2025-02-23 17:41:04.058289,2025-02-23 17:41:16.018259,11.95997
channel-0,4036014,30208976,30208988,12,2025-02-23 17:41:08.793966,2025-02-23 17:41:23.267439,14.473473
channel-0,4036015,30208984,30208994,10,2025-02-23 17:41:18.428045,2025-02-23 17:41:32.467651,14.039606
channel-0,4036016,30208999,30209010,11,2025-02-23 17:41:38.720331,2025-02-23 17:41:52.633253,13.912922
channel-0,4036017,30209007,30209018,11,2025-02-23 17:41:49.101596,2025-02-23 17:42:04.426868,15.325272
channel-0,4036018,30209044,30209056,12,2025-02-23 17:42:36.720954,2025-02-23 17:42:50.872824,14.15187
channel-0,4036019,30209059,30209071,12,2025-02-23 17:42:54.917636,2025-02-23 17:43:10.842548,15.924912
channel-0,4036020,30209081,30209093,12,2025-02-23 17:43:24.843306,2025-02-23 17:43:40.891888,16.048582
channel-0,4036021,30209097,30209103,6,2025-02-23 17:43:45.675990,2025-02-23 17:43:55.178325,9.502335
channel-0,4036022,30209105,30209115,10,2025-02-23 17:43:59.107531,2025-02-23 17:44:10.830859,11.723328
channel-0,4036023,30209135,30209143,8,2025-02-23 17:44:37.868750,2025-02-23 17:44:49.522306,11.653556
channel-0,4036024,30209135,30209143,8,2025-02-23 17:44:37.868750,2025-02-23 17:44:49.522306,11.653556
channel-0,4036025,30209141,30209153,12,2025-02-23 17:44:46.874674,2025-02-23 17:45:02.400235,15.525561
channel-0,4036026,30209180,30209190,10,2025-02-23 17:45:35.672069,2025-02-23 17:45:49.742157,14.070088
channel-0,4036027,30209184,30209194,10,2025-02-23 17:45:41.455994,2025-02-23 17:45:57.885157,16.429163
channel-0,4036028,30209212,30209222,10,2025-02-23 17:46:20.249538,2025-02-23 17:46:32.020058,11.77052
channel-0,4036029,30209229,30209248,19,2025-02-23 17:46:40.285214,2025-02-23 17:47:04.874016,24.588802
channel-0,4036030,30209249,30209260,11,2025-02-23 17:47:06.014199,2025-02-23 17:47:19.861219,13.84702
channel-0,4036031,30209249,30209260,11,2025-02-23 17:47:06.014199,2025-02-23 17:47:19.861219,13.84702
channel-0,4036032,30209257,30209266,9,2025-02-23 17:47:15.468634,2025-02-23 17:47:28.867630,13.398996
channel-0,4036033,30209276,30209288,12,2025-02-23 17:47:46.399556,2025-02-23 17:48:03.902131,17.502575
channel-0,4036034,30209288,30209300,12,2025-02-23 17:48:03.902131,2025-02-23 17:48:21.040040,17.137909
channel-0,4036035,30209346,30209356,10,2025-02-23 17:49:20.165341,2025-02-23 17:49:32.389006,12.223665
channel-0,4036036,30209347,30209356,9,2025-02-23 17:49:21.408865,2025-02-23 17:49:32.389006,10.980141
channel-0,4036037,30209381,30209390,9,2025-02-23 17:50:07.328415,2025-02-23 17:50:19.229777,11.901362
channel-0,4036038,30209467,30209478,11,2025-02-23 17:52:01.000943,2025-02-23 17:52:15.422200,14.421257
channel-0,4036039,30209472,30209484,12,2025-02-23 17:52:07.335859,2025-02-23 17:52:22.192748,14.856889
channel-0,4036040,30209509,30209525,16,2025-02-23 17:52:55.138678,2025-02-23 17:53:17.161155,22.022477
channel-0,4036041,30209530,30209541,11,2025-02-23 17:53:23.973755,2025-02-23 17:53:42.519421,18.545666
channel-0,4036042,30209610,30209634,24,2025-02-23 17:55:07.903444,2025-02-23 17:55:44.051942,36.148498
channel-0,4036043,30209617,30209623,6,2025-02-23 17:55:18.637707,2025-02-23 17:55:31.161388,12.523681
channel-0,4036044,30209632,30209661,29,2025-02-23 17:55:41.705988,2025-02-23 17:56:19.019912,37.313924
channel-0,4036045,30209660,30209689,29,2025-02-23 17:56:17.803407,2025-02-23 17:56:53.952792,36.149385
channel-0,4036046,30209672,30209685,13,2025-02-23 17:56:33.669097,2025-02-23 17:56:49.435258,15.766161
channel-0,4036047,30209678,30209689,11,2025-02-23 17:56:41.065967,2025-02-23 17:56:53.952792,12.886825
channel-0,4036048,30209717,30209727,10,2025-02-23 17:57:33.274634,2025-02-23 17:57:44.857058,11.582424
channel-0,4036049,30209784,30209793,9,2025-02-23 17:59:02.465731,2025-02-23 17:59:14.405072,11.939341
channel-0,4036050,30209828,30209836,8,2025-02-23 18:00:02.219469,2025-02-23 18:00:11.743672,9.524203
channel-0,4036051,30209844,30209856,12,2025-02-23 18:00:21.928521,2025-02-23 18:00:35.911067,13.982546
channel-0,4036052,30209861,30209874,13,2025-02-23 18:00:42.680995,2025-02-23 18:00:59.479571,16.798576
channel-0,4036053,30209921,30209932,11,2025-02-23 18:02:04.825653,2025-02-23 18:02:17.981598,13.155945
channel-0,4036054,30209945,30209954,9,2025-02-23 18:02:36.003162,2025-02-23 18:02:47.049601,11.046439
channel-0,4036055,30210014,30210028,14,2025-02-23 18:04:13.108505,2025-02-23 18:04:29.735723,16.627218
channel-0,4036056,30210111,30210125,14,2025-02-23 18:06:18.835347,2025-02-23 18:06:35.344617,16.50927
channel-0,4036057,30210154,30210165,11,2025-02-23 18:07:19.228393,2025-02-23 18:07:35.225579,15.997186
channel-0,4036058,30210246,30210271,25,2025-02-23 18:09:22.306348,2025-02-23 18:09:54.881736,32.575388
channel-0,4036059,30210273,30210284,11,2025-02-23 18:09:57.285769,2025-02-23 18:10:11.789003,14.503234
channel-0,4036060,30210274,30210284,10,2025-02-23 18:09:58.452711,2025-02-23 18:10:11.789003,13.336292
channel-0,4036061,30210307,30210330,23,2025-02-23 18:10:40.129363,2025-02-23 18:11:10.597623,30.46826
channel-0,4036062,30210311,30210335,24,2025-02-23 18:10:45.358644,2025-02-23 18:11:16.321922,30.963278
channel-0,4036063,30210350,30210359,9,2025-02-23 18:11:36.928797,2025-02-23 18:11:53.942098,17.013301
channel-0,4036064,30210402,30210413,11,2025-02-23 18:12:51.842778,2025-02-23 18:13:05.880919,14.038141
channel-0,4036065,30210503,30210514,11,2025-02-23 18:15:06.049493,2025-02-23 18:15:20.972969,14.923476
channel-0,4036066,30210555,30210565,10,2025-02-23 18:16:13.656814,2025-02-23 18:16:24.782192,11.125378
channel-0,4036067,30210631,30210641,10,2025-02-23 18:17:58.579746,2025-02-23 18:18:11.342822,12.763076
channel-0,4036068,30210689,30210701,12,2025-02-23 18:19:14.612104,2025-02-23 18:19:30.830870,16.218766
channel-0,4036069,30210696,30210706,10,2025-02-23 18:19:24.169516,2025-02-23 18:19:36.966322,12.796806
channel-0,4036070,30210719,30210744,25,2025-02-23 18:19:52.903740,2025-02-23 18:20:24.560829,31.657089
channel-0,4036071,30210736,30210744,8,2025-02-23 18:20:15.265441,2025-02-23 18:20:24.560829,9.295388
channel-0,4036072,30210739,30210748,9,2025-02-23 18:20:18.630878,2025-02-23 18:20:31.345528,12.71465
channel-0,4036073,30210761,30210771,10,2025-02-23 18:20:47.402611,2025-02-23 18:21:03.673114,16.270503
channel-0,4036074,30210783,30210810,27,2025-02-23 18:21:18.818759,2025-02-23 18:21:51.611738,32.792979
channel-0,4036075,30210876,30210883,7,2025-02-23 18:23:19.842707,2025-02-23 18:23:29.789344,9.946637
channel-0,4036076,30210945,30210956,11,2025-02-23 18:24:51.002266,2025-02-23 18:25:05.040532,14.038266
channel-0,4036077,30210967,30210973,6,2025-02-23 18:25:18.165577,2025-02-23 18:25:26.476536,8.310959
channel-0,4036078,30210970,30210980,10,2025-02-23 18:25:22.891979,2025-02-23 18:25:37.841351,14.949372
channel-0,4036079,30211042,30211071,29,2025-02-23 18:27:01.150130,2025-02-23 18:27:38.388687,37.238557
channel-0,4036080,30211104,30211133,29,2025-02-23 18:28:23.317554,2025-02-23 18:29:03.115567,39.798013
channel-0,4036081,30211342,30211349,7,2025-02-23 18:33:40.215882,2025-02-23 18:33:49.227731,9.011849
channel-0,4036082,30211416,30211428,12,2025-02-23 18:35:22.281893,2025-02-23 18:35:36.599673,14.31778
channel-0,4036083,30211456,30211469,13,2025-02-23 18:36:19.703125,2025-02-23 18:36:35.971026,16.267901
channel-0,4036084,30211457,30211469,12,2025-02-23 18:36:20.875071,2025-02-23 18:36:35.971026,15.095955
channel-0,4036085,30211464,30211476,12,2025-02-23 18:36:30.310150,2025-02-23 18:36:44.226419,13.916269
channel-0,4036086,30211560,30211571,11,2025-02-23 18:38:34.806587,2025-02-23 18:38:48.679251,13.872664
channel-0,4036087,30211566,30211576,10,2025-02-23 18:38:41.870695,2025-02-23 18:38:56.006316,14.135621
channel-0,4036088,30211620,30211629,9,2025-02-23 18:39:57.260533,2025-02-23 18:40:08.475670,11.215137
channel-0,4036089,30211661,30211668,7,2025-02-23 18:40:50.803492,2025-02-23 18:40:59.557444,8.753952
channel-0,4036090,30211682,30211692,10,2025-02-23 18:41:16.513383,2025-02-23 18:41:29.741835,13.228452
channel-0,4036091,30211886,30211897,11,2025-02-23 18:45:50.592045,2025-02-23 18:46:06.318346,15.726301
channel-0,4036092,30211895,30211907,12,2025-02-23 18:46:04.013354,2025-02-23 18:46:17.700004,13.68665
channel-0,4036093,30211920,30211930,10,2025-02-23 18:46:32.780209,2025-02-23 18:46:46.022431,13.242222
channel-0,4036094,30211928,30211940,12,2025-02-23 18:46:42.568573,2025-02-23 18:46:58.957158,16.388585
channel-0,4036095,30211965,30211973,8,2025-02-23 18:47:33.139662,2025-02-23 18:47:44.426926,11.287264
channel-0,4036096,30211993,30212007,14,2025-02-23 18:48:10.348225,2025-02-23 18:48:26.381132,16.032907
channel-0,4036097,30211996,30212007,11,2025-02-23 18:48:13.715810,2025-02-23 18:48:26.381132,12.665322
channel-0,4036098,30212013,30212023,10,2025-02-23 18:48:34.485833,2025-02-23 18:48:46.336673,11.85084
channel-0,4036099,30212013,30212023,10,2025-02-23 18:48:34.485833,2025-02-23 18:48:46.336673,11.85084
channel-0,4036100,30212053,30212059,6,2025-02-23 18:49:38.842965,2025-02-23 18:49:54.041163,15.198198
channel-0,4036101,30212057,30212068,11,2025-02-23 18:49:49.065058,2025-02-23 18:50:06.337986,17.272928
channel-0,4036102,30212062,30212071,9,2025-02-23 18:49:58.604880,2025-02-23 18:50:11.047090,12.44221
channel-0,4036103,30212077,30212086,9,2025-02-23 18:50:23.190979,2025-02-23 18:50:36.495441,13.304462
channel-0,4036104,30212086,30212117,31,2025-02-23 18:50:36.495441,2025-02-23 18:51:14.890396,38.394955
channel-0,4036105,30212100,30212112,12,2025-02-23 18:50:54.814824,2025-02-23 18:51:08.939205,14.124381
channel-0,4036106,30212100,30212112,12,2025-02-23 18:50:54.814824,2025-02-23 18:51:08.939205,14.124381
channel-0,4036107,30212103,30212117,14,2025-02-23 18:50:58.192329,2025-02-23 18:51:14.890396,16.698067
channel-0,4036108,30212111,30212120,9,2025-02-23 18:51:07.836066,2025-02-23 18:51:18.687994,10.851928
channel-0,4036109,30212114,30212123,9,2025-02-23 18:51:11.305033,2025-02-23 18:51:23.682845,12.377812
channel-0,4036110,30212115,30212136,21,2025-02-23 18:51:12.580356,2025-02-23 18:51:42.467678,29.887322
channel-0,4036111,30212119,30212136,17,2025-02-23 18:51:17.632086,2025-02-23 18:51:42.467678,24.835592
channel-0,4036112,30212173,30212184,11,2025-02-23 18:52:27.984094,2025-02-23 18:52:42.636770,14.652676
channel-0,4036113,30212182,30212212,30,2025-02-23 18:52:39.853433,2025-02-23 18:53:19.218305,39.364872
channel-0,4036114,30212224,30212237,13,2025-02-23 18:53:41.300705,2025-02-23 18:53:56.711344,15.410639
channel-0,4036115,30212237,30212244,7,2025-02-23 18:53:56.711344,2025-02-23 18:54:07.160247,10.448903
channel-0,4036116,30212238,30212250,12,2025-02-23 18:53:57.856509,2025-02-23 18:54:14.500587,16.644078
channel-0,4036117,30212257,30212267,10,2025-02-23 18:54:24.685288,2025-02-23 18:54:38.533412,13.848124
channel-0,4036118,30212287,30212299,12,2025-02-23 18:55:05.031711,2025-02-23 18:55:20.975810,15.944099
channel-0,4036119,30212297,30212303,6,2025-02-23 18:55:16.799503,2025-02-23 18:55:28.221202,11.421699
channel-0,4036120,30212313,30212321,8,2025-02-23 18:55:40.158200,2025-02-23 18:55:50.944725,10.786525
channel-0,4036121,30212356,30212365,9,2025-02-23 18:56:34.730253,2025-02-23 18:56:46.073284,11.343031
channel-0,4036122,30212365,30212374,9,2025-02-23 18:56:46.073284,2025-02-23 18:56:59.117110,13.043826
channel-0,4036123,30212381,30212401,20,2025-02-23 18:57:07.312840,2025-02-23 18:57:41.602232,34.289392
channel-0,4036124,30212386,30212396,10,2025-02-23 18:57:18.332991,2025-02-23 18:57:35.704062,17.371071
channel-0,4036125,30212412,30212424,12,2025-02-23 18:57:57.077075,2025-02-23 18:58:12.388872,15.311797
channel-0,4036126,30212435,30212445,10,2025-02-23 18:58:26.096833,2025-02-23 18:58:40.968430,14.871597
channel-0,4036127,30212459,30212469,10,2025-02-23 18:58:59.133336,2025-02-23 18:59:12.875121,13.741785
channel-0,4036128,30212472,30212484,12,2025-02-23 18:59:16.309332,2025-02-23 18:59:33.082501,16.773169
channel-0,4036129,30212499,30212509,10,2025-02-23 18:59:50.808465,2025-02-23 19:00:03.884138,13.075673
channel-0,4036130,30212514,30212522,8,2025-02-23 19:00:12.033254,2025-02-23 19:00:22.464815,10.431561
channel-0,4036131,30212521,30212531,10,2025-02-23 19:00:21.367952,2025-02-23 19:00:35.025143,13.657191
channel-0,4036132,30212530,30212541,11,2025-02-23 19:00:33.640248,2025-02-23 19:00:46.757793,13.117545
channel-0,4036133,30212611,30212621,10,2025-02-23 19:02:21.364182,2025-02-23 19:02:33.276210,11.912028
channel-0,4036134,30212656,30212667,11,2025-02-23 19:03:23.167522,2025-02-23 19:03:38.083779,14.916257
channel-0,4036135,30212675,30212688,13,2025-02-23 19:03:47.537114,2025-02-23 19:04:02.608708,15.071594
channel-0,4036136,30212692,30212702,10,2025-02-23 19:04:07.530926,2025-02-23 19:04:21.072185,13.541259
channel-0,4036137,30212742,30212753,11,2025-02-23 19:05:17.065912,2025-02-23 19:05:34.478428,17.412516
channel-0,4036138,30212742,30212753,11,2025-02-23 19:05:17.065912,2025-02-23 19:05:34.478428,17.412516
channel-0,4036139,30212776,30212784,8,2025-02-23 19:06:03.907306,2025-02-23 19:06:14.332093,10.424787
channel-0,4036140,30212932,30212944,12,2025-02-23 19:09:32.740602,2025-02-23 19:09:47.962933,15.222331
channel-0,4036141,30212955,30212967,12,2025-02-23 19:10:04.981318,2025-02-23 19:10:19.718532,14.737214
channel-0,4036142,30212975,30212985,10,2025-02-23 19:10:29.583372,2025-02-23 19:10:41.144492,11.56112
channel-0,4036143,30212992,30213003,11,2025-02-23 19:10:51.483862,2025-02-23 19:11:06.143243,14.659381
channel-0,4036144,30213018,30213044,26,2025-02-23 19:11:25.707760,2025-02-23 19:12:00.129407,34.421647
channel-0,4036145,30213020,30213031,11,2025-02-23 19:11:28.074666,2025-02-23 19:11:41.659575,13.584909
channel-0,4036146,30213033,30213044,11,2025-02-23 19:11:44.033489,2025-02-23 19:12:00.129407,16.095918
channel-0,4036147,30213048,30213057,9,2025-02-23 19:12:08.088292,2025-02-23 19:12:19.994974,11.906682
channel-0,4036148,30213052,30213062,10,2025-02-23 19:12:13.749998,2025-02-23 19:12:26.772683,13.022685
channel-0,4036149,30213068,30213077,9,2025-02-23 19:12:33.687450,2025-02-23 19:12:45.234802,11.547352
channel-0,4036150,30213082,30213094,12,2025-02-23 19:12:54.798722,2025-02-23 19:13:14.242488,19.443766
channel-0,4036151,30213108,30213119,11,2025-02-23 19:13:31.948464,2025-02-23 19:13:44.480811,12.532347
channel-0,4036152,30213124,30213132,8,2025-02-23 19:13:50.843460,2025-02-23 19:14:01.389763,10.546303
channel-0,4036153,30213157,30213171,14,2025-02-23 19:14:34.389449,2025-02-23 19:14:57.995008,23.605559
channel-0,4036154,30213268,30213280,12,2025-02-23 19:17:04.927977,2025-02-23 19:17:23.756530,18.828553
channel-0,4036155,30213268,30213280,12,2025-02-23 19:17:04.927977,2025-02-23 19:17:23.756530,18.828553
channel-0,4036156,30213274,30213289,15,2025-02-23 19:17:15.988612,2025-02-23 19:17:36.172091,20.183479
channel-0,4036157,30213293,30213305,12,2025-02-23 19:17:40.797596,2025-02-23 19:17:56.460843,15.663247
channel-0,4036158,30213309,30213320,11,2025-02-23 19:18:01.274452,2025-02-23 19:18:15.498695,14.224243
channel-0,4036159,30213310,30213320,10,2025-02-23 19:18:03.365923,2025-02-23 19:18:15.498695,12.132772
channel-0,4036160,30213316,30213327,11,2025-02-23 19:18:10.349311,2025-02-23 19:18:26.398482,16.049171
channel-0,4036161,30213322,30213332,10,2025-02-23 19:18:18.873398,2025-02-23 19:18:32.480631,13.607233
channel-0,4036162,30213330,30213341,11,2025-02-23 19:18:30.053954,2025-02-23 19:18:45.149917,15.095963
channel-0,4036163,30213334,30213341,7,2025-02-23 19:18:36.072558,2025-02-23 19:18:45.149917,9.077359
channel-0,4036164,30213337,30213346,9,2025-02-23 19:18:39.577073,2025-02-23 19:18:52.555591,12.978518
channel-0,4036165,30213362,30213371,9,2025-02-23 19:19:12.091187,2025-02-23 19:19:23.753733,11.662546
channel-0,4036166,30213384,30213407,23,2025-02-23 19:19:43.220660,2025-02-23 19:20:13.260158,30.039498
channel-0,4036167,30213388,30213398,10,2025-02-23 19:19:49.046279,2025-02-23 19:20:02.225956,13.179677
channel-0,4036168,30213394,30213415,21,2025-02-23 19:19:57.088334,2025-02-23 19:20:23.430742,26.342408
channel-0,4036169,30213548,30213559,11,2025-02-23 19:23:21.412075,2025-02-23 19:23:34.456047,13.043972
channel-0,4036170,30213570,30213581,11,2025-02-23 19:23:47.417988,2025-02-23 19:24:04.179107,16.761119
channel-0,4036171,30213577,30213587,10,2025-02-23 19:23:58.931462,2025-02-23 19:24:11.222756,12.291294
channel-0,4036172,30213614,30213622,8,2025-02-23 19:24:50.373475,2025-02-23 19:24:59.843294,9.469819
channel-0,4036173,30213637,30213646,9,2025-02-23 19:25:21.062241,2025-02-23 19:25:33.823660,12.761419
channel-0,4036174,30213687,30213693,6,2025-02-23 19:26:27.816098,2025-02-23 19:26:40.080779,12.264681
channel-0,4036175,30213910,30213921,11,2025-02-23 19:31:29.018710,2025-02-23 19:31:43.969395,14.950685
channel-0,4036176,30213938,30213947,9,2025-02-23 19:32:04.388372,2025-02-23 19:32:17.440184,13.051812
channel-0,4036177,30213947,30213961,14,2025-02-23 19:32:17.440184,2025-02-23 19:32:37.721768,20.281584
channel-0,4036178,30213948,30213961,13,2025-02-23 19:32:22.789752,2025-02-23 19:32:37.721768,14.932016
channel-0,4036179,30214011,30214024,13,2025-02-23 19:33:43.069940,2025-02-23 19:33:59.370346,16.300406
channel-0,4036180,30214163,30214172,9,2025-02-23 19:37:07.489469,2025-02-23 19:37:18.237798,10.748329
channel-0,4036181,30214215,30214226,11,2025-02-23 19:38:15.146168,2025-02-23 19:38:28.906011,13.759843
channel-0,4036182,30214265,30214284,19,2025-02-23 19:39:22.943315,2025-02-23 19:39:45.836690,22.893375
channel-0,4036183,30214368,30214378,10,2025-02-23 19:41:41.111975,2025-02-23 19:41:53.244481,12.132506
channel-0,4036184,30214452,30214465,13,2025-02-23 19:43:33.341181,2025-02-23 19:43:50.015482,16.674301
channel-0,4036185,30214516,30214525,9,2025-02-23 19:45:01.202121,2025-02-23 19:45:11.832380,10.630259
channel-0,4036186,30214519,30214532,13,2025-02-23 19:45:04.922579,2025-02-23 19:45:19.830692,14.908113
channel-0,4036187,30214608,30214621,13,2025-02-23 19:46:59.567116,2025-02-23 19:47:15.351274,15.784158
channel-0,4036188,30214927,30214936,9,2025-02-23 19:54:04.160755,2025-02-23 19:54:14.959100,10.798345
channel-0,4036189,30214954,30214965,11,2025-02-23 19:54:37.190313,2025-02-23 19:54:50.135849,12.945536
channel-0,4036190,30215015,30215024,9,2025-02-23 19:56:02.015341,2025-02-23 19:56:13.758446,11.743105
channel-0,4036191,30215019,30215028,9,2025-02-23 19:56:06.634505,2025-02-23 19:56:19.883630,13.249125
channel-0,4036192,30215026,30215038,12,2025-02-23 19:56:17.274558,2025-02-23 19:56:32.318242,15.043684
channel-0,4036193,30215074,30215086,12,2025-02-23 19:57:18.463078,2025-02-23 19:57:34.471085,16.008007
channel-0,4036194,30215079,30215091,12,2025-02-23 19:57:25.736932,2025-02-23 19:57:40.267348,14.530416
channel-0,4036195,30215103,30215121,18,2025-02-23 19:57:54.766577,2025-02-23 19:58:18.822677,24.0561
channel-0,4036196,30215117,30215123,6,2025-02-23 19:58:12.687841,2025-02-23 19:58:21.781587,9.093746
channel-0,4036197,30215122,30215131,9,2025-02-23 19:58:20.583148,2025-02-23 19:58:31.518843,10.935695
channel-0,4036198,30215143,30215153,10,2025-02-23 19:58:49.635269,2025-02-23 19:59:02.006295,12.371026
channel-0,4036199,30215157,30215166,9,2025-02-23 19:59:06.559279,2025-02-23 19:59:21.860648,15.301369
channel-0,4036200,30215179,30215189,10,2025-02-23 19:59:39.951251,2025-02-23 19:59:53.707875,13.756624
channel-0,4036201,30215183,30215194,11,2025-02-23 19:59:45.568989,2025-02-23 19:59:59.725485,14.156496
channel-0,4036202,30215188,30215198,10,2025-02-23 19:59:52.548713,2025-02-23 20:00:05.914148,13.365435
channel-0,4036203,30215204,30215216,12,2025-02-23 20:00:14.092870,2025-02-23 20:00:30.415145,16.322275
channel-0,4036204,30215218,30215230,12,2025-02-23 20:00:32.780200,2025-02-23 20:00:48.308875,15.528675
channel-0,4036205,30215230,30215251,21,2025-02-23 20:00:48.308875,2025-02-23 20:01:17.260267,28.951392
channel-0,4036206,30215251,30215261,10,2025-02-23 20:01:17.260267,2025-02-23 20:01:29.168470,11.908203
channel-0,4036207,30215272,30215287,15,2025-02-23 20:01:44.871502,2025-02-23 20:02:02.252733,17.381231
channel-0,4036208,30215310,30215319,9,2025-02-23 20:02:30.917034,2025-02-23 20:02:44.728343,13.811309
channel-0,4036209,30215319,30215329,10,2025-02-23 20:02:44.728343,2025-02-23 20:02:56.814048,12.085705
channel-0,4036210,30215360,30215376,16,2025-02-23 20:03:43.979923,2025-02-23 20:04:05.382679,21.402756
channel-0,4036211,30215394,30215404,10,2025-02-23 20:04:30.151863,2025-02-23 20:04:41.685762,11.533899
channel-0,4036212,30215412,30215419,7,2025-02-23 20:04:52.212405,2025-02-23 20:05:05.625176,13.412771
channel-0,4036213,30215437,30215444,7,2025-02-23 20:05:28.501176,2025-02-23 20:05:36.723083,8.221907
channel-0,4036214,30215489,30215500,11,2025-02-23 20:06:32.503036,2025-02-23 20:06:47.187831,14.684795
channel-0,4036215,30215529,30215540,11,2025-02-23 20:07:27.733536,2025-02-23 20:07:41.914444,14.180908
channel-0,4036216,30215530,30215540,10,2025-02-23 20:07:28.901039,2025-02-23 20:07:41.914444,13.013405
channel-0,4036217,30215583,30215593,10,2025-02-23 20:08:38.673620,2025-02-23 20:08:50.686114,12.012494
channel-0,4036218,30215621,30215633,12,2025-02-23 20:09:31.027935,2025-02-23 20:09:45.656593,14.628658
channel-0,4036219,30215627,30215637,10,2025-02-23 20:09:38.827197,2025-02-23 20:09:52.402143,13.574946
channel-0,4036220,30215635,30215645,10,2025-02-23 20:09:49.021072,2025-02-23 20:10:04.212375,15.191303
channel-0,4036221,30215639,30215650,11,2025-02-23 20:09:54.914629,2025-02-23 20:10:11.587537,16.672908
channel-0,4036222,30215650,30215660,10,2025-02-23 20:10:11.587537,2025-02-23 20:10:24.509509,12.921972
channel-0,4036223,30215650,30215660,10,2025-02-23 20:10:11.587537,2025-02-23 20:10:24.509509,12.921972
channel-0,4036224,30215656,30215668,12,2025-02-23 20:10:19.803957,2025-02-23 20:10:34.449836,14.645879
channel-0,4036225,30215694,30215705,11,2025-02-23 20:11:09.343754,2025-02-23 20:11:24.779514,15.43576
channel-0,4036226,30215719,30215724,5,2025-02-23 20:11:42.823886,2025-02-23 20:11:50.358000,7.534114
channel-0,4036227,30215731,30215740,9,2025-02-23 20:11:58.643570,2025-02-23 20:12:09.111117,10.467547
channel-0,4036228,30215748,30215759,11,2025-02-23 20:12:20.097014,2025-02-23 20:12:38.980022,18.883008
channel-0,4036229,30215759,30215768,9,2025-02-23 20:12:38.980022,2025-02-23 20:12:50.202140,11.222118
channel-0,4036230,30215768,30215779,11,2025-02-23 20:12:50.202140,2025-02-23 20:13:09.658253,19.456113
channel-0,4036231,30215830,30215840,10,2025-02-23 20:14:15.404273,2025-02-23 20:14:30.111981,14.707708
channel-0,4036232,30215878,30215899,21,2025-02-23 20:15:21.670411,2025-02-23 20:15:49.573024,27.902613
channel-0,4036233,30215888,30215899,11,2025-02-23 20:15:34.818792,2025-02-23 20:15:49.573024,14.754232
channel-0,4036234,30215905,30215915,10,2025-02-23 20:15:56.354060,2025-02-23 20:16:08.235208,11.881148
channel-0,4036235,30215917,30215930,13,2025-02-23 20:16:10.653315,2025-02-23 20:16:26.435416,15.782101
channel-0,4036236,30215950,30215960,10,2025-02-23 20:16:58.894669,2025-02-23 20:17:11.466708,12.572039
channel-0,4036237,30215971,30215983,12,2025-02-23 20:17:28.605198,2025-02-23 20:17:42.913657,14.308459
channel-0,4036238,30215990,30216000,10,2025-02-23 20:17:53.142516,2025-02-23 20:18:04.972761,11.830245
channel-0,4036239,30216002,30216013,11,2025-02-23 20:18:07.484515,2025-02-23 20:18:25.059586,17.575071
channel-0,4036240,30216009,30216018,9,2025-02-23 20:18:20.289215,2025-02-23 20:18:31.358192,11.068977
channel-0,4036241,30216033,30216044,11,2025-02-23 20:18:52.504257,2025-02-23 20:19:08.791084,16.286827
channel-0,4036242,30216040,30216049,9,2025-02-23 20:19:04.162932,2025-02-23 20:19:14.607275,10.444343
channel-0,4036243,30216059,30216070,11,2025-02-23 20:19:26.933766,2025-02-23 20:19:39.649296,12.71553
channel-0,4036244,30216065,30216073,8,2025-02-23 20:19:33.812020,2025-02-23 20:19:45.137144,11.325124
channel-0,4036245,30216131,30216142,11,2025-02-23 20:21:08.255171,2025-02-23 20:21:23.465791,15.21062
channel-0,4036246,30216135,30216147,12,2025-02-23 20:21:13.040425,2025-02-23 20:21:29.593072,16.552647
channel-0,4036247,30216139,30216152,13,2025-02-23 20:21:19.809792,2025-02-23 20:21:35.279896,15.470104
channel-0,4036248,30216166,30216177,11,2025-02-23 20:21:53.441064,2025-02-23 20:22:06.223997,12.782933
channel-0,4036249,30216197,30216205,8,2025-02-23 20:22:35.913743,2025-02-23 20:22:48.176183,12.26244
channel-0,4036250,30216218,30216228,10,2025-02-23 20:23:03.979379,2025-02-23 20:23:16.018575,12.039196
channel-0,4036251,30216266,30216278,12,2025-02-23 20:24:05.595960,2025-02-23 20:24:19.444733,13.848773
channel-0,4036252,30216316,30216323,7,2025-02-23 20:25:10.273375,2025-02-23 20:25:21.122205,10.84883
channel-0,4036253,30216333,30216345,12,2025-02-23 20:25:35.210686,2025-02-23 20:25:50.514347,15.303661
channel-0,4036254,30216357,30216370,13,2025-02-23 20:26:05.188327,2025-02-23 20:26:21.279570,16.091243
channel-0,4036255,30216366,30216378,12,2025-02-23 20:26:15.625274,2025-02-23 20:26:33.516037,17.890763
channel-0,4036256,30216391,30216403,12,2025-02-23 20:26:53.465485,2025-02-23 20:27:10.310462,16.844977
channel-0,4036257,30216433,30216445,12,2025-02-23 20:27:50.434043,2025-02-23 20:28:04.887987,14.453944
channel-0,4036258,30216563,30216571,8,2025-02-23 20:30:38.718116,2025-02-23 20:30:49.108731,10.390615
channel-0,4036259,30216572,30216596,24,2025-02-23 20:30:51.316899,2025-02-23 20:31:25.378089,34.06119
channel-0,4036260,30216616,30216629,13,2025-02-23 20:31:52.808044,2025-02-23 20:32:08.577634,15.76959
channel-0,4036261,30216667,30216679,12,2025-02-23 20:33:00.882221,2025-02-23 20:33:16.403649,15.521428
channel-0,4036262,30216692,30216704,12,2025-02-23 20:33:31.515518,2025-02-23 20:33:48.101954,16.586436
channel-0,4036263,30216719,30216728,9,2025-02-23 20:34:10.708719,2025-02-23 20:34:26.298001,15.589282
channel-0,4036264,30216764,30216774,10,2025-02-23 20:35:12.771420,2025-02-23 20:35:24.442793,11.671373
channel-0,4036265,30216775,30216784,9,2025-02-23 20:35:25.582938,2025-02-23 20:35:37.797284,12.214346
channel-0,4036266,30216818,30216828,10,2025-02-23 20:36:26.666336,2025-02-23 20:36:38.854764,12.188428
channel-0,4036267,30216819,30216841,22,2025-02-23 20:36:27.908529,2025-02-23 20:36:55.826955,27.918426
channel-0,4036268,30216835,30216846,11,2025-02-23 20:36:47.988404,2025-02-23 20:37:03.648449,15.660045
channel-0,4036269,30216846,30216852,6,2025-02-23 20:37:03.648449,2025-02-23 20:37:10.964449,7.316
channel-0,4036270,30216864,30216874,10,2025-02-23 20:37:27.457715,2025-02-23 20:37:39.224516,11.766801
channel-0,4036271,30216864,30216874,10,2025-02-23 20:37:27.457715,2025-02-23 20:37:39.224516,11.766801
channel-0,4036272,30216876,30216888,12,2025-02-23 20:37:41.863021,2025-02-23 20:37:58.288759,16.425738
channel-0,4036273,30216895,30216903,8,2025-02-23 20:38:11.063998,2025-02-23 20:38:21.020536,9.956538
channel-0,4036274,30216916,30216928,12,2025-02-23 20:38:39.916283,2025-02-23 20:38:53.706824,13.790541
channel-0,4036275,30216951,30216963,12,2025-02-23 20:39:23.035694,2025-02-23 20:39:38.579743,15.544049
channel-0,4036276,30216960,30216973,13,2025-02-23 20:39:34.996968,2025-02-23 20:39:50.410395,15.413427
channel-0,4036277,30216985,30216998,13,2025-02-23 20:40:09.622871,2025-02-23 20:40:24.892058,15.269187
channel-0,4036278,30216996,30217006,10,2025-02-23 20:40:22.533694,2025-02-23 20:40:39.712477,17.178783
channel-0,4036279,30217056,30217078,22,2025-02-23 20:41:45.257861,2025-02-23 20:42:14.487479,29.229618
channel-0,4036280,30217084,30217094,10,2025-02-23 20:42:21.933261,2025-02-23 20:42:33.953341,12.02008
channel-0,4036281,30217086,30217098,12,2025-02-23 20:42:24.227908,2025-02-23 20:42:38.761273,14.533365
channel-0,4036282,30217091,30217107,16,2025-02-23 20:42:30.232618,2025-02-23 20:42:51.077714,20.845096
channel-0,4036283,30217106,30217116,10,2025-02-23 20:42:49.402868,2025-02-23 20:43:02.737727,13.334859
channel-0,4036284,30217107,30217116,9,2025-02-23 20:42:51.077714,2025-02-23 20:43:02.737727,11.660013
channel-0,4036285,30217125,30217132,7,2025-02-23 20:43:17.412435,2025-02-23 20:43:28.133457,10.721022
channel-0,4036286,30217168,30217176,8,2025-02-23 20:44:19.246754,2025-02-23 20:44:30.219227,10.972473
channel-0,4036287,30217207,30217214,7,2025-02-23 20:45:11.621722,2025-02-23 20:45:22.953168,11.331446
channel-0,4036288,30217214,30217223,9,2025-02-23 20:45:22.953168,2025-02-23 20:45:33.625405,10.672237
channel-0,4036289,30217240,30217253,13,2025-02-23 20:45:57.388135,2025-02-23 20:46:18.024667,20.636532
channel-0,4036290,30217262,30217272,10,2025-02-23 20:46:29.743373,2025-02-23 20:46:42.400550,12.657177
channel-0,4036291,30217278,30217292,14,2025-02-23 20:46:49.500849,2025-02-23 20:47:06.055728,16.554879
channel-0,4036292,30217300,30217312,12,2025-02-23 20:47:16.532869,2025-02-23 20:47:31.047518,14.514649
channel-0,4036293,30217311,30217320,9,2025-02-23 20:47:29.925298,2025-02-23 20:47:43.193846,13.268548
channel-0,4036294,30217349,30217359,10,2025-02-23 20:48:25.866929,2025-02-23 20:48:37.801169,11.93424
channel-0,4036295,30217361,30217372,11,2025-02-23 20:48:40.938549,2025-02-23 20:48:56.026816,15.088267
channel-0,4036296,30217364,30217377,13,2025-02-23 20:48:45.518214,2025-02-23 20:49:01.890859,16.372645
channel-0,4036297,30217416,30217427,11,2025-02-23 20:49:51.206298,2025-02-23 20:50:08.917874,17.711576
channel-0,4036298,30217453,30217464,11,2025-02-23 20:50:43.682869,2025-02-23 20:50:57.791874,14.109005
channel-0,4036299,30217507,30217518,11,2025-02-23 20:51:54.217415,2025-02-23 20:52:10.368886,16.151471
channel-0,4036300,30217522,30217532,10,2025-02-23 20:52:15.075182,2025-02-23 20:52:26.919713,11.844531
channel-0,4036301,30217545,30217570,25,2025-02-23 20:52:44.571620,2025-02-23 20:53:15.969724,31.398104
channel-0,4036302,30217547,30217560,13,2025-02-23 20:52:47.893073,2025-02-23 20:53:03.371489,15.478416
channel-0,4036303,30217583,30217611,28,2025-02-23 20:53:36.803356,2025-02-23 20:54:10.892495,34.089139
channel-0,4036304,30217719,30217730,11,2025-02-23 20:56:37.207202,2025-02-23 20:56:51.279087,14.071885
channel-0,4036305,30217760,30217781,21,2025-02-23 20:57:29.350696,2025-02-23 20:57:57.466371,28.115675
channel-0,4036306,30217827,30217851,24,2025-02-23 20:58:57.831478,2025-02-23 20:59:34.802264,36.970786
channel-0,4036307,30217834,30217845,11,2025-02-23 20:59:06.392046,2025-02-23 20:59:23.299034,16.906988
channel-0,4036308,30217853,30217874,21,2025-02-23 20:59:37.664207,2025-02-23 21:00:04.242582,26.578375
channel-0,4036309,30217932,30217942,10,2025-02-23 21:01:24.843660,2025-02-23 21:01:39.613694,14.770034
channel-0,4036310,30217947,30217958,11,2025-02-23 21:01:45.339042,2025-02-23 21:01:59.301794,13.962752
channel-0,4036311,30218010,30218017,7,2025-02-23 21:03:09.351860,2025-02-23 21:03:20.496366,11.144506
channel-0,4036312,30218011,30218022,11,2025-02-23 21:03:10.562420,2025-02-23 21:03:27.102449,16.540029
channel-0,4036313,30218033,30218040,7,2025-02-23 21:03:41.505373,2025-02-23 21:03:53.121140,11.615767
channel-0,4036314,30218089,30218114,25,2025-02-23 21:04:55.088042,2025-02-23 21:05:26.631151,31.543109
channel-0,4036315,30218205,30218227,22,2025-02-23 21:07:26.064945,2025-02-23 21:07:56.364053,30.299108
channel-0,4036316,30218221,30218250,29,2025-02-23 21:07:47.519957,2025-02-23 21:08:26.204559,38.684602
channel-0,4036317,30218250,30218271,21,2025-02-23 21:08:26.204559,2025-02-23 21:08:57.407756,31.203197
channel-0,4036318,30218259,30218271,12,2025-02-23 21:08:40.435963,2025-02-23 21:08:57.407756,16.971793
channel-0,4036319,30218304,30218316,12,2025-02-23 21:09:40.322005,2025-02-23 21:09:57.199138,16.877133
channel-0,4036320,30218312,30218331,19,2025-02-23 21:09:52.166503,2025-02-23 21:10:16.016139,23.849636
channel-0,4036321,30218336,30218346,10,2025-02-23 21:10:22.222850,2025-02-23 21:10:35.294772,13.071922
channel-0,4036322,30218338,30218359,21,2025-02-23 21:10:24.697486,2025-02-23 21:10:52.771825,28.074339
channel-0,4036323,30218345,30218355,10,2025-02-23 21:10:34.131571,2025-02-23 21:10:46.075201,11.94363
channel-0,4036324,30218441,30218803,362,2025-02-23 21:12:37.848642,2025-02-23 21:20:44.638522,486.78988
channel-0,4036325,30218460,30218471,11,2025-02-23 21:13:05.895594,2025-02-23 21:13:22.233566,16.337972
channel-0,4036326,30218498,30218507,9,2025-02-23 21:13:56.455173,2025-02-23 21:14:09.352992,12.897819
channel-0,4036327,30218504,30218513,9,2025-02-23 21:14:04.660004,2025-02-23 21:14:17.300985,12.640981
channel-0,4036328,30218529,30218536,7,2025-02-23 21:14:37.185467,2025-02-23 21:14:49.772208,12.586741
channel-0,4036329,30218557,30218570,13,2025-02-23 21:15:17.459334,2025-02-23 21:15:33.245601,15.786267
channel-0,4036330,30218592,30218602,10,2025-02-23 21:16:02.616740,2025-02-23 21:16:17.031919,14.415179
channel-0,4036331,30218675,30218686,11,2025-02-23 21:17:55.117396,2025-02-23 21:18:08.086734,12.969338
channel-0,4036332,30218678,30218693,15,2025-02-23 21:17:58.576628,2025-02-23 21:18:16.538031,17.961403
channel-0,4036333,30218696,30218722,26,2025-02-23 21:18:21.244122,2025-02-23 21:18:55.271904,34.027782
channel-0,4036334,30218719,30218803,84,2025-02-23 21:18:51.257548,2025-02-23 21:20:44.638522,113.380974
channel-0,4036335,30218747,30218760,13,2025-02-23 21:19:28.362969,2025-02-23 21:19:46.449076,18.086107
channel-0,4036336,30218832,30218843,11,2025-02-23 21:21:23.435546,2025-02-23 21:21:39.383623,15.948077
channel-0,4036337,30218978,30218988,10,2025-02-23 21:24:35.930398,2025-02-23 21:24:49.834623,13.904225
channel-0,4036338,30219003,30219012,9,2025-02-23 21:25:09.064761,2025-02-23 21:25:20.374847,11.310086
channel-0,4036339,30219006,30219016,10,2025-02-23 21:25:12.499690,2025-02-23 21:25:25.275111,12.775421
channel-0,4036340,30219008,30219016,8,2025-02-23 21:25:14.807742,2025-02-23 21:25:25.275111,10.467369
channel-0,4036341,30219021,30219031,10,2025-02-23 21:25:31.487999,2025-02-23 21:25:44.197800,12.709801
channel-0,4036342,30219029,30219036,7,2025-02-23 21:25:41.773122,2025-02-23 21:25:53.292326,11.519204
channel-0,4036343,30219033,30219042,9,2025-02-23 21:25:47.630742,2025-02-23 21:26:00.235914,12.605172
channel-0,4036344,30219036,30219061,25,2025-02-23 21:25:53.292326,2025-02-23 21:26:24.705272,31.412946
channel-0,4036345,30219110,30219121,11,2025-02-23 21:27:32.290751,2025-02-23 21:27:45.929036,13.638285
channel-0,4036346,30219113,30219126,13,2025-02-23 21:27:35.903665,2025-02-23 21:27:51.695632,15.791967
channel-0,4036347,30219217,30219246,29,2025-02-23 21:29:50.071700,2025-02-23 21:30:27.228711,37.157011
channel-0,4036348,30219319,30219329,10,2025-02-23 21:32:08.954113,2025-02-23 21:32:22.322384,13.368271
channel-0,4036349,30219377,30219389,12,2025-02-23 21:33:23.765241,2025-02-23 21:33:39.665170,15.899929
channel-0,4036350,30219395,30219407,12,2025-02-23 21:33:47.346147,2025-02-23 21:34:01.604880,14.258733
channel-0,4036351,30219418,30219427,9,2025-02-23 21:34:21.373623,2025-02-23 21:34:32.307192,10.933569
channel-0,4036352,30219437,30219447,10,2025-02-23 21:34:44.149161,2025-02-23 21:34:56.826757,12.677596
channel-0,4036353,30219451,30219462,11,2025-02-23 21:35:02.492870,2025-02-23 21:35:15.259849,12.766979
channel-0,4036354,30219490,30219499,9,2025-02-23 21:35:50.917912,2025-02-23 21:36:03.402220,12.484308
channel-0,4036355,30219501,30219510,9,2025-02-23 21:36:08.888668,2025-02-23 21:36:20.651978,11.76331
channel-0,4036356,30219510,30219518,8,2025-02-23 21:36:20.651978,2025-02-23 21:36:32.773920,12.121942
channel-0,4036357,30219513,30219519,6,2025-02-23 21:36:25.597923,2025-02-23 21:36:35.098778,9.500855
channel-0,4036358,30219570,30219580,10,2025-02-23 21:37:37.557171,2025-02-23 21:37:52.197025,14.639854
channel-0,4036359,30219617,30219629,12,2025-02-23 21:38:40.132665,2025-02-23 21:38:54.282564,14.149899
channel-0,4036360,30219641,30219653,12,2025-02-23 21:39:11.692025,2025-02-23 21:39:26.485758,14.793733
channel-0,4036361,30219657,30219666,9,2025-02-23 21:39:31.030044,2025-02-23 21:39:42.965210,11.935166
channel-0,4036362,30219680,30219704,24,2025-02-23 21:40:04.399349,2025-02-23 21:40:38.194688,33.795339
channel-0,4036363,30219685,30219709,24,2025-02-23 21:40:10.413437,2025-02-23 21:40:45.101240,34.687803
channel-0,4036364,30219708,30219719,11,2025-02-23 21:40:42.756662,2025-02-23 21:40:57.358178,14.601516
channel-0,4036365,30219717,30219728,11,2025-02-23 21:40:55.156593,2025-02-23 21:41:08.328500,13.171907
channel-0,4036366,30219718,30219742,24,2025-02-23 21:40:56.208348,2025-02-23 21:41:27.289508,31.08116
channel-0,4036367,30219731,30219759,28,2025-02-23 21:41:11.923041,2025-02-23 21:41:51.310058,39.387017
channel-0,4036368,30219737,30219759,22,2025-02-23 21:41:20.623235,2025-02-23 21:41:51.310058,30.686823
channel-0,4036369,30219744,30219755,11,2025-02-23 21:41:30.117358,2025-02-23 21:41:45.678102,15.560744
channel-0,4036370,30219836,30219849,13,2025-02-23 21:43:30.152176,2025-02-23 21:43:47.748819,17.596643
channel-0,4036371,30219904,30219914,10,2025-02-23 21:45:02.448072,2025-02-23 21:45:16.265705,13.817633
channel-0,4036372,30219937,30219942,5,2025-02-23 21:45:47.925330,2025-02-23 21:45:54.149505,6.224175
channel-0,4036373,30220003,30220011,8,2025-02-23 21:47:14.095917,2025-02-23 21:47:24.858590,10.762673
channel-0,4036374,30220142,30220156,14,2025-02-23 21:50:20.796585,2025-02-23 21:50:38.325787,17.529202
channel-0,4036375,30220245,30220258,13,2025-02-23 21:52:33.340357,2025-02-23 21:52:48.859443,15.519086
channel-0,4036376,30220283,30220292,9,2025-02-23 21:53:26.273473,2025-02-23 21:53:37.908076,11.634603
channel-0,4036377,30220304,30220316,12,2025-02-23 21:53:53.330213,2025-02-23 21:54:08.922601,15.592388
channel-0,4036378,30220383,30220394,11,2025-02-23 21:55:38.313218,2025-02-23 21:55:55.653122,17.339904
channel-0,4036379,30220417,30220427,10,2025-02-23 21:56:25.368240,2025-02-23 21:56:37.245118,11.876878
channel-0,4036380,30220427,30220436,9,2025-02-23 21:56:37.245118,2025-02-23 21:56:49.269485,12.024367
channel-0,4036381,30220440,30220446,6,2025-02-23 21:56:53.843917,2025-02-23 21:57:06.298749,12.454832
channel-0,4036382,30220531,30220542,11,2025-02-23 21:58:54.182496,2025-02-23 21:59:08.907152,14.724656
channel-0,4036383,30220551,30220576,25,2025-02-23 21:59:23.263964,2025-02-23 21:59:55.230122,31.966158
channel-0,4036384,30220569,30220581,12,2025-02-23 21:59:46.808761,2025-02-23 22:00:02.128790,15.320029
channel-0,4036385,30220583,30220595,12,2025-02-23 22:00:04.434365,2025-02-23 22:00:18.575407,14.141042
channel-0,4036386,30220683,30220693,10,2025-02-23 22:02:13.984734,2025-02-23 22:02:26.527638,12.542904
channel-0,4036387,30220842,30220854,12,2025-02-23 22:05:44.295545,2025-02-23 22:05:58.400149,14.104604
channel-0,4036388,30220864,30220873,9,2025-02-23 22:06:11.572572,2025-02-23 22:06:24.134530,12.561958
channel-0,4036389,30220890,30220898,8,2025-02-23 22:06:47.496909,2025-02-23 22:06:57.276053,9.779144
channel-0,4036390,30220929,30220940,11,2025-02-23 22:07:38.489851,2025-02-23 22:07:53.420106,14.930255
channel-0,4036391,30221032,30221042,10,2025-02-23 22:09:53.596150,2025-02-23 22:10:07.473812,13.877662
channel-0,4036392,30221042,30221049,7,2025-02-23 22:10:07.473812,2025-02-23 22:10:15.728083,8.254271
channel-0,4036393,30221113,30221122,9,2025-02-23 22:11:42.957523,2025-02-23 22:11:53.483822,10.526299
channel-0,4036394,30221163,30221176,13,2025-02-23 22:12:48.010239,2025-02-23 22:13:06.847103,18.836864
channel-0,4036395,30221220,30221229,9,2025-02-23 22:14:05.633515,2025-02-23 22:14:18.288611,12.655096
channel-0,4036396,30221224,30221234,10,2025-02-23 22:14:10.923496,2025-02-23 22:14:24.154122,13.230626
channel-0,4036397,30221273,30221301,28,2025-02-23 22:15:16.086038,2025-02-23 22:15:50.420334,34.334296
channel-0,4036398,30221331,30221343,12,2025-02-23 22:16:30.001111,2025-02-23 22:16:44.240496,14.239385
channel-0,4036399,30221342,30221351,9,2025-02-23 22:16:43.093007,2025-02-23 22:16:55.200241,12.107234
channel-0,4036400,30221381,30221388,7,2025-02-23 22:17:37.131851,2025-02-23 22:17:47.173639,10.041788
channel-0,4036401,30221449,30221463,14,2025-02-23 22:19:06.073281,2025-02-23 22:19:22.865873,16.792592
channel-0,4036402,30221479,30221488,9,2025-02-23 22:19:44.198085,2025-02-23 22:19:59.219692,15.021607
channel-0,4036403,30221482,30221488,6,2025-02-23 22:19:47.783839,2025-02-23 22:19:59.219692,11.435853
channel-0,4036404,30221524,30221549,25,2025-02-23 22:20:46.052197,2025-02-23 22:21:17.395109,31.342912
channel-0,4036405,30221524,30221537,13,2025-02-23 22:20:46.052197,2025-02-23 22:21:02.381129,16.328932
channel-0,4036406,30221579,30221591,12,2025-02-23 22:22:00.969583,2025-02-23 22:22:17.878245,16.908662
channel-0,4036407,30221680,30221688,8,2025-02-23 22:24:09.198222,2025-02-23 22:24:21.287916,12.089694
channel-0,4036408,30221691,30221720,29,2025-02-23 22:24:26.015051,2025-02-23 22:25:01.652094,35.637043
channel-0,4036409,30221777,30221784,7,2025-02-23 22:26:19.787718,2025-02-23 22:26:32.453296,12.665578
channel-0,4036410,30221798,30221810,12,2025-02-23 22:26:51.285336,2025-02-23 22:27:05.696016,14.41068
channel-0,4036411,30221820,30221831,11,2025-02-23 22:27:17.952434,2025-02-23 22:27:33.722653,15.770219
channel-0,4036412,30221825,30221835,10,2025-02-23 22:27:24.781454,2025-02-23 22:27:40.655209,15.873755
channel-0,4036413,30221846,30221860,14,2025-02-23 22:27:54.742342,2025-02-23 22:28:11.675376,16.933034
channel-0,4036414,30221865,30221875,10,2025-02-23 22:28:17.945299,2025-02-23 22:28:29.885872,11.940573
channel-0,4036415,30221931,30221956,25,2025-02-23 22:29:42.412393,2025-02-23 22:30:14.847836,32.435443
channel-0,4036416,30221939,30221947,8,2025-02-23 22:29:51.729590,2025-02-23 22:30:01.303615,9.574025
channel-0,4036417,30222035,30222048,13,2025-02-23 22:32:04.167893,2025-02-23 22:32:19.920921,15.753028
channel-0,4036418,30222174,30222181,7,2025-02-23 22:35:02.595528,2025-02-23 22:35:16.240267,13.644739
channel-0,4036419,30222226,30222236,10,2025-02-23 22:36:17.088799,2025-02-23 22:36:28.461248,11.372449
channel-0,4036420,30222233,30222246,13,2025-02-23 22:36:25.087575,2025-02-23 22:36:41.246981,16.159406
channel-0,4036421,30222284,30222311,27,2025-02-23 22:37:35.494633,2025-02-23 22:38:10.223221,34.728588
channel-0,4036422,30222415,30222425,10,2025-02-23 22:40:28.542385,2025-02-23 22:40:40.260957,11.718572
channel-0,4036423,30222441,30222453,12,2025-02-23 22:41:03.511928,2025-02-23 22:41:19.277274,15.765346
channel-0,4036424,30222461,30222471,10,2025-02-23 22:41:29.510565,2025-02-23 22:41:43.383028,13.872463
channel-0,4036425,30222470,30222481,11,2025-02-23 22:41:42.136796,2025-02-23 22:41:55.850925,13.714129
channel-0,4036426,30222492,30222511,19,2025-02-23 22:42:09.296748,2025-02-23 22:42:33.717945,24.421197
channel-0,4036427,30222506,30222517,11,2025-02-23 22:42:25.890290,2025-02-23 22:42:41.363151,15.472861
channel-0,4036428,30222633,30222642,9,2025-02-23 22:45:17.414497,2025-02-23 22:45:29.657777,12.24328
channel-0,4036429,30222680,30222703,23,2025-02-23 22:46:17.667264,2025-02-23 22:46:48.543966,30.876702
channel-0,4036430,30222731,30222754,23,2025-02-23 22:47:26.329074,2025-02-23 22:47:59.415671,33.086597
channel-0,4036431,30222739,30222749,10,2025-02-23 22:47:36.607569,2025-02-23 22:47:52.412288,15.804719
channel-0,4036432,30222745,30222754,9,2025-02-23 22:47:46.629596,2025-02-23 22:47:59.415671,12.786075
channel-0,4036433,30222793,30222806,13,2025-02-23 22:48:53.250787,2025-02-23 22:49:08.973378,15.722591
channel-0,4036434,30222801,30222826,25,2025-02-23 22:49:03.247886,2025-02-23 22:49:38.577059,35.329173
channel-0,4036435,30222868,30222881,13,2025-02-23 22:50:32.242349,2025-02-23 22:50:49.580165,17.337816
channel-0,4036436,30222951,30222957,6,2025-02-23 22:52:20.310246,2025-02-23 22:52:28.317780,8.007534
channel-0,4036437,30222958,30222985,27,2025-02-23 22:52:33.723567,2025-02-23 22:53:07.314480,33.590913
channel-0,4036438,30223003,30223015,12,2025-02-23 22:53:29.407838,2025-02-23 22:53:45.697293,16.289455
channel-0,4036439,30223142,30223151,9,2025-02-23 22:56:36.429452,2025-02-23 22:56:47.892513,11.463061
channel-0,4036440,30223162,30223172,10,2025-02-23 22:57:00.890856,2025-02-23 22:57:12.932263,12.041407
channel-0,4036441,30223191,30223202,11,2025-02-23 22:57:37.050629,2025-02-23 22:57:52.517001,15.466372
channel-0,4036442,30223233,30223242,9,2025-02-23 22:58:35.856892,2025-02-23 22:58:49.085763,13.228871
channel-0,4036443,30223295,30223305,10,2025-02-23 22:59:55.385576,2025-02-23 23:00:09.023910,13.638334
channel-0,4036444,30223370,30223378,8,2025-02-23 23:01:36.564298,2025-02-23 23:01:48.168862,11.604564
channel-0,4036445,30223380,30223391,11,2025-02-23 23:01:50.568135,2025-02-23 23:02:09.862561,19.294426
channel-0,4036446,30223412,30223433,21,2025-02-23 23:02:37.087443,2025-02-23 23:03:04.643553,27.55611
channel-0,4036447,30223424,30223433,9,2025-02-23 23:02:52.357461,2025-02-23 23:03:04.643553,12.286092
channel-0,4036448,30223428,30223436,8,2025-02-23 23:02:58.032260,2025-02-23 23:03:08.309127,10.276867
channel-0,4036449,30223439,30223448,9,2025-02-23 23:03:11.880661,2025-02-23 23:03:26.158059,14.277398
channel-0,4036450,30223460,30223472,12,2025-02-23 23:03:42.020797,2025-02-23 23:03:56.803676,14.782879
channel-0,4036451,30223470,30223475,5,2025-02-23 23:03:54.295436,2025-02-23 23:04:01.666491,7.371055
channel-0,4036452,30223491,30223503,12,2025-02-23 23:04:25.548557,2025-02-23 23:04:39.833435,14.284878
channel-0,4036453,30223526,30223536,10,2025-02-23 23:05:08.489546,2025-02-23 23:05:22.312512,13.822966
channel-0,4036454,30223540,30223551,11,2025-02-23 23:05:26.753197,2025-02-23 23:05:40.683136,13.929939
channel-0,4036455,30223541,30223551,10,2025-02-23 23:05:27.989887,2025-02-23 23:05:40.683136,12.693249
channel-0,4036456,30223550,30223558,8,2025-02-23 23:05:39.506276,2025-02-23 23:05:50.018425,10.512149
channel-0,4036457,30223558,30223568,10,2025-02-23 23:05:50.018425,2025-02-23 23:06:06.536783,16.518358
channel-0,4036458,30223627,30223644,17,2025-02-23 23:07:22.852919,2025-02-23 23:07:50.643805,27.790886
channel-0,4036459,30223635,30223644,9,2025-02-23 23:07:32.435829,2025-02-23 23:07:50.643805,18.207976
channel-0,4036460,30223692,30223702,10,2025-02-23 23:08:53.049089,2025-02-23 23:09:06.155871,13.106782
channel-0,4036461,30223742,30223751,9,2025-02-23 23:09:59.576926,2025-02-23 23:10:12.380541,12.803615
channel-0,4036462,30223753,30223765,12,2025-02-23 23:10:14.637217,2025-02-23 23:10:31.166919,16.529702
channel-0,4036463,30223790,30223801,11,2025-02-23 23:11:02.501256,2025-02-23 23:11:15.815119,13.313863
channel-0,4036464,30223866,30223878,12,2025-02-23 23:12:47.746226,2025-02-23 23:13:02.385418,14.639192
channel-0,4036465,30223921,30223930,9,2025-02-23 23:13:58.791567,2025-02-23 23:14:09.986654,11.195087
channel-0,4036466,30223974,30223984,10,2025-02-23 23:15:07.012124,2025-02-23 23:15:20.568573,13.556449
channel-0,4036467,30224017,30224026,9,2025-02-23 23:16:06.385549,2025-02-23 23:16:17.440213,11.054664
channel-0,4036468,30224043,30224055,12,2025-02-23 23:16:38.659752,2025-02-23 23:16:52.741473,14.081721
channel-0,4036469,30224121,30224133,12,2025-02-23 23:18:24.419279,2025-02-23 23:18:39.570710,15.151431
channel-0,4036470,30224134,30224143,9,2025-02-23 23:18:40.715485,2025-02-23 23:18:51.021355,10.30587
channel-0,4036471,30224148,30224171,23,2025-02-23 23:18:57.981808,2025-02-23 23:19:31.614446,33.632638
channel-0,4036472,30224205,30224225,20,2025-02-23 23:20:19.387864,2025-02-23 23:20:44.485515,25.097651
channel-0,4036473,30224208,30224234,26,2025-02-23 23:20:23.236458,2025-02-23 23:20:57.178003,33.941545
channel-0,4036474,30224390,30224400,10,2025-02-23 23:24:25.984806,2025-02-23 23:24:39.660727,13.675921
channel-0,4036475,30224414,30224424,10,2025-02-23 23:24:56.450942,2025-02-23 23:25:10.245429,13.794487
channel-0,4036476,30224429,30224453,24,2025-02-23 23:25:20.227514,2025-02-23 23:25:52.245083,32.017569
channel-0,4036477,30224508,30224517,9,2025-02-23 23:27:04.369421,2025-02-23 23:27:18.203500,13.834079
channel-0,4036478,30224623,30224632,9,2025-02-23 23:29:38.522987,2025-02-23 23:29:49.742440,11.219453
channel-0,4036479,30224741,30224746,5,2025-02-23 23:32:15.899120,2025-02-23 23:32:22.637686,6.738566
channel-0,4036480,30224784,30224797,13,2025-02-23 23:33:13.161038,2025-02-23 23:33:28.935346,15.774308
channel-0,4036481,30224823,30224832,9,2025-02-23 23:34:02.019542,2025-02-23 23:34:13.495810,11.476268
channel-0,4036482,30225006,30225015,9,2025-02-23 23:38:04.124237,2025-02-23 23:38:17.402206,13.277969
channel-0,4036483,30225525,30225537,12,2025-02-23 23:49:33.185912,2025-02-23 23:49:50.992778,17.806866
channel-0,4036484,30225677,30225691,14,2025-02-23 23:53:00.306632,2025-02-23 23:53:16.600012,16.29338
channel-0,4036485,30225706,30225718,12,2025-02-23 23:53:37.649096,2025-02-23 23:53:54.356286,16.70719
channel-0,4036486,30225997,30226006,9,2025-02-24 00:00:06.053652,2025-02-24 00:00:18.476118,12.422466
channel-0,4036487,30226046,30226053,7,2025-02-24 00:01:15.086671,2025-02-24 00:01:23.704635,8.617964
channel-0,4036488,30226399,30226413,14,2025-02-24 00:09:14.287739,2025-02-24 00:09:31.023776,16.736037
channel-0,4036489,30226402,30226413,11,2025-02-24 00:09:17.844295,2025-02-24 00:09:31.023776,13.179481
channel-0,4036490,30226468,30226477,9,2025-02-24 00:10:44.825375,2025-02-24 00:10:55.238721,10.413346
channel-0,4036491,30226471,30226480,9,2025-02-24 00:10:48.405734,2025-02-24 00:11:02.049446,13.643712
channel-0,4036492,30226540,30226549,9,2025-02-24 00:12:21.983735,2025-02-24 00:12:36.279862,14.296127
channel-0,4036493,30226561,30226570,9,2025-02-24 00:12:51.005702,2025-02-24 00:13:03.360240,12.354538
