channel_id,sequence,send_height,ack_height,block_delay,send_time,ack_time,time_delay_sec
channel-6994,1324104,30280013,30280025,12,2025-02-24 20:01:12.743359,2025-02-24 20:01:26.182512,13.439153
channel-6994,1324105,30280063,30280073,10,2025-02-24 20:02:22.436137,2025-02-24 20:02:33.945087,11.50895
channel-6994,1324106,30280099,30280109,10,2025-02-24 20:03:08.787856,2025-02-24 20:03:24.618251,15.830395
channel-6994,1324107,30280103,30280114,11,2025-02-24 20:03:14.309819,2025-02-24 20:03:31.370359,17.06054
channel-6994,1324108,30280114,30280124,10,2025-02-24 20:03:31.370359,2025-02-24 20:03:43.177204,11.806845
channel-6994,1324109,30280118,30280129,11,2025-02-24 20:03:36.034075,2025-02-24 20:03:49.421947,13.387872
channel-6994,1324110,30280256,30280266,10,2025-02-24 20:06:34.520722,2025-02-24 20:06:46.396475,11.875753
channel-6994,1324111,30280271,30280281,10,2025-02-24 20:06:52.713626,2025-02-24 20:07:04.411062,11.697436
channel-6994,1324112,30280276,30280286,10,2025-02-24 20:06:58.463873,2025-02-24 20:07:11.598140,13.134267
channel-6994,1324113,30280317,30280327,10,2025-02-24 20:07:54.777568,2025-02-24 20:08:11.289502,16.511934
channel-6994,1324114,30280322,30280337,15,2025-02-24 20:08:01.392532,2025-02-24 20:08:22.997286,21.604754
channel-6994,1324115,30280354,30280387,33,2025-02-24 20:08:49.841610,2025-02-24 20:09:30.739881,40.898271
channel-6994,1324116,30280431,30280445,14,2025-02-24 20:10:30.661934,2025-02-24 20:10:48.608741,17.946807
channel-6994,1324117,30280455,30280466,11,2025-02-24 20:11:00.285065,2025-02-24 20:11:14.732250,14.447185
channel-6994,1324118,30280564,30280578,14,2025-02-24 20:13:24.834198,2025-02-24 20:13:42.582099,17.747901
channel-6994,1324119,30280577,30280587,10,2025-02-24 20:13:41.274043,2025-02-24 20:13:54.128252,12.854209
channel-6994,1324120,30280689,30280702,13,2025-02-24 20:16:09.011970,2025-02-24 20:16:24.200054,15.188084
channel-6994,1324121,30280695,30280707,12,2025-02-24 20:16:16.011775,2025-02-24 20:16:30.053219,14.041444
channel-6994,1324122,30280700,30280713,13,2025-02-24 20:16:21.977566,2025-02-24 20:16:37.200632,15.223066
channel-6994,1324123,30280728,30280736,8,2025-02-24 20:16:56.896908,2025-02-24 20:17:10.039058,13.14215
channel-6994,1324124,30280760,30280771,11,2025-02-24 20:17:41.502276,2025-02-24 20:17:58.071098,16.568822
channel-6994,1324125,30280790,30280803,13,2025-02-24 20:18:20.623497,2025-02-24 20:18:36.869365,16.245868
channel-6994,1324126,30280796,30280806,10,2025-02-24 20:18:28.521386,2025-02-24 20:18:41.602954,13.081568
channel-6994,1324127,30280837,30280849,12,2025-02-24 20:19:21.504268,2025-02-24 20:19:37.951083,16.446815
channel-6994,1324128,30280854,30280862,8,2025-02-24 20:19:44.952657,2025-02-24 20:19:56.508352,11.555695
channel-6994,1324129,30280866,30280878,12,2025-02-24 20:20:01.018351,2025-02-24 20:20:16.944738,15.926387
channel-6994,1324130,30280886,30280898,12,2025-02-24 20:20:26.869222,2025-02-24 20:20:40.514250,13.645028
channel-6994,1324131,30280889,30280898,9,2025-02-24 20:20:30.287686,2025-02-24 20:20:40.514250,10.226564
channel-6994,1324132,30280950,30280962,12,2025-02-24 20:21:48.345683,2025-02-24 20:22:04.373266,16.027583
channel-6994,1324133,30280951,30280962,11,2025-02-24 20:21:50.027138,2025-02-24 20:22:04.373266,14.346128
channel-6994,1324134,30280963,30280976,13,2025-02-24 20:22:06.830438,2025-02-24 20:22:23.732689,16.902251
channel-6994,1324135,30280985,30280997,12,2025-02-24 20:22:35.472080,2025-02-24 20:22:50.217868,14.745788
channel-6994,1324136,30280997,30281008,11,2025-02-24 20:22:50.217868,2025-02-24 20:23:02.938172,12.720304
channel-6994,1324137,30281012,30281022,10,2025-02-24 20:23:08.787374,2025-02-24 20:23:21.447792,12.660418
channel-6994,1324138,30281064,30281075,11,2025-02-24 20:24:16.874357,2025-02-24 20:24:30.688524,13.814167
channel-6994,1324139,30281120,30281131,11,2025-02-24 20:25:27.773020,2025-02-24 20:25:44.071137,16.298117
channel-6994,1324140,30281132,30281147,15,2025-02-24 20:25:45.207798,2025-02-24 20:26:03.290342,18.082544
channel-6994,1324141,30281140,30281152,12,2025-02-24 20:25:54.977181,2025-02-24 20:26:09.837342,14.860161
channel-6994,1324142,30281199,30281211,12,2025-02-24 20:27:13.013719,2025-02-24 20:27:29.665087,16.651368
channel-6994,1324143,30281237,30281247,10,2025-02-24 20:28:01.016613,2025-02-24 20:28:13.911004,12.894391
channel-6994,1324144,30281245,30281258,13,2025-02-24 20:28:11.121091,2025-02-24 20:28:27.772625,16.651534
channel-6994,1324145,30281248,30281263,15,2025-02-24 20:28:15.138577,2025-02-24 20:28:34.102817,18.96424
channel-6994,1324146,30281249,30281263,14,2025-02-24 20:28:16.300461,2025-02-24 20:28:34.102817,17.802356
channel-6994,1324147,30281262,30281272,10,2025-02-24 20:28:32.929636,2025-02-24 20:28:46.908919,13.979283
channel-6994,1324148,30281270,30281282,12,2025-02-24 20:28:43.399258,2025-02-24 20:28:59.407344,16.008086
channel-6994,1324149,30281272,30281282,10,2025-02-24 20:28:46.908919,2025-02-24 20:28:59.407344,12.498425
channel-6994,1324150,30281280,30281290,10,2025-02-24 20:28:56.911863,2025-02-24 20:29:10.025137,13.113274
channel-6994,1324151,30281340,30281353,13,2025-02-24 20:30:17.535796,2025-02-24 20:30:37.348183,19.812387
channel-6994,1324152,30281341,30281353,12,2025-02-24 20:30:18.778994,2025-02-24 20:30:37.348183,18.569189
channel-6994,1324153,30281446,30281462,16,2025-02-24 20:32:37.747838,2025-02-24 20:32:57.706145,19.958307
channel-6994,1324154,30281483,30281497,14,2025-02-24 20:33:25.464035,2025-02-24 20:33:43.308642,17.844607
channel-6994,1324155,30281537,30281545,8,2025-02-24 20:34:33.339007,2025-02-24 20:34:44.322152,10.983145
channel-6994,1324156,30281555,30281564,9,2025-02-24 20:35:01.818304,2025-02-24 20:35:16.011958,14.193654
channel-6994,1324157,30281571,30281585,14,2025-02-24 20:35:24.310452,2025-02-24 20:35:40.841088,16.530636
channel-6994,1324158,30281736,30281746,10,2025-02-24 20:38:56.369363,2025-02-24 20:39:09.891394,13.522031
channel-6994,1324159,30281756,30281766,10,2025-02-24 20:39:22.494967,2025-02-24 20:39:34.305081,11.810114
channel-6994,1324160,30281834,30281846,12,2025-02-24 20:41:10.538783,2025-02-24 20:41:24.546917,14.008134
channel-6994,1324161,30281842,30281855,13,2025-02-24 20:41:20.098722,2025-02-24 20:41:35.614697,15.515975
channel-6994,1324162,30281901,30281912,11,2025-02-24 20:42:37.732067,2025-02-24 20:42:50.906528,13.174461
channel-6994,1324163,30281909,30281923,14,2025-02-24 20:42:47.588835,2025-02-24 20:43:04.412862,16.824027
channel-6994,1324164,30281929,30281940,11,2025-02-24 20:43:12.681251,2025-02-24 20:43:29.745682,17.064431
channel-6994,1324165,30281936,30281952,16,2025-02-24 20:43:24.368585,2025-02-24 20:43:43.530322,19.161737
channel-6994,1324166,30281953,30281966,13,2025-02-24 20:43:44.946677,2025-02-24 20:44:01.425216,16.478539
channel-6994,1324167,30281956,30281966,10,2025-02-24 20:43:49.478061,2025-02-24 20:44:01.425216,11.947155
channel-6994,1324168,30282018,30282029,11,2025-02-24 20:45:11.166491,2025-02-24 20:45:26.152883,14.986392
channel-6994,1324169,30282050,30282066,16,2025-02-24 20:45:55.933069,2025-02-24 20:46:17.373235,21.440166
channel-6994,1324170,30282185,30282197,12,2025-02-24 20:48:55.572080,2025-02-24 20:49:09.974988,14.402908
channel-6994,1324171,30282260,30282269,9,2025-02-24 20:50:35.169990,2025-02-24 20:50:48.781889,13.611899
channel-6994,1324172,30282283,30282296,13,2025-02-24 20:51:05.042532,2025-02-24 20:51:20.013395,14.970863
channel-6994,1324173,30282325,30282341,16,2025-02-24 20:51:57.446591,2025-02-24 20:52:18.351173,20.904582
channel-6994,1324174,30282376,30282387,11,2025-02-24 20:53:05.649507,2025-02-24 20:53:18.740138,13.090631
channel-6994,1324175,30282389,30282400,11,2025-02-24 20:53:20.939883,2025-02-24 20:53:37.219079,16.279196
channel-6994,1324176,30282445,30282455,10,2025-02-24 20:54:40.550297,2025-02-24 20:54:53.467316,12.917019
channel-6994,1324177,30282458,30282469,11,2025-02-24 20:54:57.895268,2025-02-24 20:55:12.615014,14.719746
channel-6994,1324178,30282497,30282507,10,2025-02-24 20:55:48.169480,2025-02-24 20:56:02.071455,13.901975
channel-6994,1324179,30282498,30282507,9,2025-02-24 20:55:49.781571,2025-02-24 20:56:02.071455,12.289884
channel-6994,1324180,30282582,30282593,11,2025-02-24 20:57:38.166733,2025-02-24 20:57:52.171127,14.004394
channel-6994,1324181,30282602,30282612,10,2025-02-24 20:58:06.386729,2025-02-24 20:58:22.865412,16.478683
channel-6994,1324182,30282610,30282623,13,2025-02-24 20:58:17.096703,2025-02-24 20:58:36.617518,19.520815
channel-6994,1324183,30282622,30282634,12,2025-02-24 20:58:35.353947,2025-02-24 20:58:49.815791,14.461844
channel-6994,1324184,30282631,30282646,15,2025-02-24 20:58:46.238038,2025-02-24 20:59:03.575566,17.337528
channel-6994,1324185,30282651,30282661,10,2025-02-24 20:59:09.338169,2025-02-24 20:59:22.594156,13.255987
channel-6994,1324186,30282652,30282661,9,2025-02-24 20:59:10.649351,2025-02-24 20:59:22.594156,11.944805
channel-6994,1324187,30282694,30282710,16,2025-02-24 21:00:08.065430,2025-02-24 21:00:29.765994,21.700564
channel-6994,1324188,30282733,30282743,10,2025-02-24 21:00:57.132331,2025-02-24 21:01:11.100418,13.968087
channel-6994,1324189,30282776,30282786,10,2025-02-24 21:01:57.229577,2025-02-24 21:02:09.726826,12.497249
channel-6994,1324190,30282797,30282809,12,2025-02-24 21:02:23.195648,2025-02-24 21:02:41.110957,17.915309
channel-6994,1324191,30282808,30282823,15,2025-02-24 21:02:39.887747,2025-02-24 21:03:01.023947,21.1362
channel-6994,1324192,30282841,30282851,10,2025-02-24 21:03:23.564133,2025-02-24 21:03:36.632509,13.068376
channel-6994,1324193,30282853,30282866,13,2025-02-24 21:03:40.582472,2025-02-24 21:03:57.916415,17.333943
channel-6994,1324194,30282862,30282871,9,2025-02-24 21:03:52.466935,2025-02-24 21:04:04.648725,12.18179
channel-6994,1324195,30282898,30282909,11,2025-02-24 21:04:39.460509,2025-02-24 21:04:53.077101,13.616592
channel-6994,1324196,30283037,30283049,12,2025-02-24 21:07:46.435497,2025-02-24 21:08:02.427226,15.991729
channel-6994,1324197,30283061,30283076,15,2025-02-24 21:08:17.967858,2025-02-24 21:08:35.593037,17.625179
channel-6994,1324198,30283110,30283119,9,2025-02-24 21:09:18.447055,2025-02-24 21:09:31.851829,13.404774
channel-6994,1324199,30283240,30283254,14,2025-02-24 21:12:12.837913,2025-02-24 21:12:29.070122,16.232209
channel-6994,1324200,30283247,30283257,10,2025-02-24 21:12:21.077564,2025-02-24 21:12:33.300825,12.223261
channel-6994,1324201,30283275,30283286,11,2025-02-24 21:12:55.140275,2025-02-24 21:13:11.328758,16.188483
channel-6994,1324202,30283281,30283290,9,2025-02-24 21:13:05.109792,2025-02-24 21:13:17.524833,12.415041
channel-6994,1324203,30283351,30283364,13,2025-02-24 21:14:34.195538,2025-02-24 21:14:50.909158,16.71362
channel-6994,1324204,30283435,30283445,10,2025-02-24 21:16:28.071273,2025-02-24 21:16:43.127791,15.056518
channel-6994,1324205,30283458,30283468,10,2025-02-24 21:17:02.196720,2025-02-24 21:17:14.298354,12.101634
channel-6994,1324206,30283476,30283488,12,2025-02-24 21:17:23.485823,2025-02-24 21:17:38.384188,14.898365
channel-6994,1324207,30283479,30283492,13,2025-02-24 21:17:27.914261,2025-02-24 21:17:44.633113,16.718852
channel-6994,1324208,30283482,30283492,10,2025-02-24 21:17:31.410729,2025-02-24 21:17:44.633113,13.222384
channel-6994,1324209,30283526,30283538,12,2025-02-24 21:18:25.767868,2025-02-24 21:18:42.615652,16.847784
channel-6994,1324210,30283560,30283570,10,2025-02-24 21:19:10.959354,2025-02-24 21:19:24.167942,13.208588
channel-6994,1324211,30283618,30283631,13,2025-02-24 21:20:26.568520,2025-02-24 21:20:43.349483,16.780963
channel-6994,1324212,30283643,30283653,10,2025-02-24 21:21:03.113449,2025-02-24 21:21:15.605858,12.492409
channel-6994,1324213,30283715,30283724,9,2025-02-24 21:22:31.967106,2025-02-24 21:22:46.355258,14.388152
channel-6994,1324214,30283828,30283838,10,2025-02-24 21:25:01.084179,2025-02-24 21:25:12.776163,11.691984
channel-6994,1324215,30283906,30283915,9,2025-02-24 21:26:45.787111,2025-02-24 21:26:57.436590,11.649479
channel-6994,1324216,30283914,30283923,9,2025-02-24 21:26:56.252071,2025-02-24 21:27:09.687731,13.43566
channel-6994,1324217,30283985,30283997,12,2025-02-24 21:28:28.140949,2025-02-24 21:28:43.914443,15.773494
channel-6994,1324218,30284012,30284026,14,2025-02-24 21:29:04.196849,2025-02-24 21:29:21.609349,17.4125
channel-6994,1324219,30284045,30284053,8,2025-02-24 21:29:44.864565,2025-02-24 21:29:58.812968,13.948403
channel-6994,1324220,30284090,30284102,12,2025-02-24 21:30:51.134197,2025-02-24 21:31:06.392982,15.258785
channel-6994,1324221,30284100,30284110,10,2025-02-24 21:31:04.016909,2025-02-24 21:31:18.086453,14.069544
channel-6994,1324222,30284115,30284130,15,2025-02-24 21:31:25.661819,2025-02-24 21:31:43.499594,17.837775
channel-6994,1324223,30284137,30284150,13,2025-02-24 21:31:51.317252,2025-02-24 21:32:06.875227,15.557975
channel-6994,1324224,30284143,30284154,11,2025-02-24 21:31:58.069408,2025-02-24 21:32:11.521809,13.452401
channel-6994,1324225,30284168,30284179,11,2025-02-24 21:32:31.928355,2025-02-24 21:32:47.632506,15.704151
channel-6994,1324226,30284217,30284228,11,2025-02-24 21:33:35.510503,2025-02-24 21:33:49.717047,14.206544
channel-6994,1324227,30284219,30284228,9,2025-02-24 21:33:37.714403,2025-02-24 21:33:49.717047,12.002644
channel-6994,1324228,30284226,30284239,13,2025-02-24 21:33:46.242970,2025-02-24 21:34:02.585897,16.342927
channel-6994,1324229,30284241,30284250,9,2025-02-24 21:34:05.989292,2025-02-24 21:34:18.552953,12.563661
channel-6994,1324230,30284241,30284250,9,2025-02-24 21:34:05.989292,2025-02-24 21:34:18.552953,12.563661
channel-6994,1324231,30284256,30284267,11,2025-02-24 21:34:28.891996,2025-02-24 21:34:46.515822,17.623826
channel-6994,1324232,30284441,30284450,9,2025-02-24 21:38:30.965957,2025-02-24 21:38:43.295804,12.329847
channel-6994,1324233,30284565,30284579,14,2025-02-24 21:41:17.167595,2025-02-24 21:41:33.390874,16.223279
channel-6994,1324234,30284583,30284594,11,2025-02-24 21:41:38.021931,2025-02-24 21:41:53.690990,15.669059
channel-6994,1324235,30284728,30284739,11,2025-02-24 21:44:51.556884,2025-02-24 21:45:05.516380,13.959496
channel-6994,1324236,30284976,30284989,13,2025-02-24 21:50:17.036477,2025-02-24 21:50:32.858513,15.822036
channel-6994,1324237,30285222,30285237,15,2025-02-24 21:55:39.556105,2025-02-24 21:55:56.931110,17.375005
channel-6994,1324238,30285262,30285274,12,2025-02-24 21:56:29.811692,2025-02-24 21:56:44.245687,14.433995
channel-6994,1324239,30285265,30285274,9,2025-02-24 21:56:33.533814,2025-02-24 21:56:44.245687,10.711873
channel-6994,1324240,30285333,30285347,14,2025-02-24 21:58:07.623520,2025-02-24 21:58:24.496584,16.873064
channel-6994,1324241,30285532,30285541,9,2025-02-24 22:02:34.447793,2025-02-24 22:02:53.611874,19.164081
channel-6994,1324242,30285559,30285584,25,2025-02-24 22:03:24.238714,2025-02-24 22:03:57.991277,33.752563
channel-6994,1324243,30285573,30285584,11,2025-02-24 22:03:44.050700,2025-02-24 22:03:57.991277,13.940577
channel-6994,1324244,30285574,30285589,15,2025-02-24 22:03:45.309506,2025-02-24 22:04:03.945900,18.636394
channel-6994,1324245,30285579,30285604,25,2025-02-24 22:03:51.595200,2025-02-24 22:04:27.982716,36.387516
channel-6994,1324246,30285594,30285601,7,2025-02-24 22:04:09.812841,2025-02-24 22:04:19.727761,9.91492
channel-6994,1324247,30285639,30285651,12,2025-02-24 22:05:20.533808,2025-02-24 22:05:36.643977,16.110169
channel-6994,1324248,30285738,30285752,14,2025-02-24 22:07:35.275754,2025-02-24 22:07:52.850576,17.574822
channel-6994,1324249,30285742,30285757,15,2025-02-24 22:07:39.949886,2025-02-24 22:07:58.618493,18.668607
channel-6994,1324250,30285765,30285804,39,2025-02-24 22:08:08.880324,2025-02-24 22:09:03.270210,54.389886
channel-6994,1324251,30285780,30285791,11,2025-02-24 22:08:27.465424,2025-02-24 22:08:44.677252,17.211828
channel-6994,1324252,30285784,30285796,12,2025-02-24 22:08:32.149377,2025-02-24 22:08:51.459070,19.309693
channel-6994,1324253,30285833,30285865,32,2025-02-24 22:09:40.933780,2025-02-24 22:10:27.049540,46.11576
channel-6994,1324254,30285858,30285879,21,2025-02-24 22:10:13.863937,2025-02-24 22:10:44.471377,30.60744
channel-6994,1324255,30285859,30285870,11,2025-02-24 22:10:15.177879,2025-02-24 22:10:33.069603,17.891724
channel-6994,1324256,30285862,30285875,13,2025-02-24 22:10:22.230697,2025-02-24 22:10:39.446630,17.215933
channel-6994,1324257,30285867,30285879,12,2025-02-24 22:10:29.410802,2025-02-24 22:10:44.471377,15.060575
channel-6994,1324258,30285869,30285879,10,2025-02-24 22:10:31.957009,2025-02-24 22:10:44.471377,12.514368
channel-6994,1324259,30285901,30285950,49,2025-02-24 22:11:18.829798,2025-02-24 22:12:26.891324,68.061526
channel-6994,1324260,30285938,30285950,12,2025-02-24 22:12:11.176988,2025-02-24 22:12:26.891324,15.714336
channel-6994,1324261,30285949,30285960,11,2025-02-24 22:12:25.559454,2025-02-24 22:12:38.469958,12.910504
channel-6994,1324262,30285963,30285975,12,2025-02-24 22:12:42.908989,2025-02-24 22:12:56.827008,13.918019
channel-6994,1324263,30285966,30286009,43,2025-02-24 22:12:46.284581,2025-02-24 22:13:46.773726,60.489145
channel-6994,1324264,30285998,30286009,11,2025-02-24 22:13:31.628250,2025-02-24 22:13:46.773726,15.145476
channel-6994,1324265,30286000,30286033,33,2025-02-24 22:13:34.931264,2025-02-24 22:14:16.890905,41.959641
channel-6994,1324266,30286028,30286067,39,2025-02-24 22:14:10.862839,2025-02-24 22:15:02.784881,51.922042
channel-6994,1324267,30286028,30286038,10,2025-02-24 22:14:10.862839,2025-02-24 22:14:25.012777,14.149938
channel-6994,1324268,30286041,30286072,31,2025-02-24 22:14:28.814023,2025-02-24 22:15:08.453177,39.639154
channel-6994,1324269,30286095,30286140,45,2025-02-24 22:15:39.674747,2025-02-24 22:16:38.748858,59.074111
channel-6994,1324270,30286118,30286131,13,2025-02-24 22:16:11.438607,2025-02-24 22:16:26.674001,15.235394
channel-6994,1324271,30286132,30286143,11,2025-02-24 22:16:27.875423,2025-02-24 22:16:45.594147,17.718724
channel-6994,1324272,30286144,30286154,10,2025-02-24 22:16:46.878496,2025-02-24 22:17:03.711537,16.833041
channel-6994,1324273,30286157,30286217,60,2025-02-24 22:17:06.952803,2025-02-24 22:18:21.648662,74.695859
channel-6994,1324274,30286176,30286206,30,2025-02-24 22:17:29.571399,2025-02-24 22:18:07.711542,38.140143
channel-6994,1324275,30286177,30286187,10,2025-02-24 22:17:30.787113,2025-02-24 22:17:45.336067,14.548954
channel-6994,1324276,30286206,30286217,11,2025-02-24 22:18:07.711542,2025-02-24 22:18:21.648662,13.93712
channel-6994,1324277,30286220,30286229,9,2025-02-24 22:18:25.347919,2025-02-24 22:18:36.780295,11.432376
channel-6994,1324278,30286233,30286274,41,2025-02-24 22:18:46.305097,2025-02-24 22:19:40.517946,54.212849
channel-6994,1324279,30286240,30286251,11,2025-02-24 22:18:56.190758,2025-02-24 22:19:10.652923,14.462165
channel-6994,1324280,30286247,30286266,19,2025-02-24 22:19:05.465263,2025-02-24 22:19:29.535086,24.069823
channel-6994,1324281,30286252,30286270,18,2025-02-24 22:19:11.873254,2025-02-24 22:19:34.889051,23.015797
channel-6994,1324282,30286273,30286285,12,2025-02-24 22:19:38.229291,2025-02-24 22:19:54.551095,16.321804
channel-6994,1324283,30286296,30286340,44,2025-02-24 22:20:08.224304,2025-02-24 22:21:07.213740,58.989436
channel-6994,1324284,30286310,30286320,10,2025-02-24 22:20:27.062112,2025-02-24 22:20:41.570177,14.508065
channel-6994,1324285,30286351,30286363,12,2025-02-24 22:21:23.014204,2025-02-24 22:21:38.994172,15.979968
channel-6994,1324286,30286362,30286402,40,2025-02-24 22:21:37.856135,2025-02-24 22:22:30.842686,52.986551
channel-6994,1324287,30286373,30286386,13,2025-02-24 22:21:52.779734,2025-02-24 22:22:09.926003,17.146269
channel-6994,1324288,30286427,30286490,63,2025-02-24 22:23:06.499785,2025-02-24 22:24:29.806784,83.306999
channel-6994,1324289,30286430,30286439,9,2025-02-24 22:23:10.950067,2025-02-24 22:23:22.074835,11.124768
channel-6994,1324290,30286494,30286556,62,2025-02-24 22:24:34.591387,2025-02-24 22:25:54.900319,80.308932
channel-6994,1324291,30286521,30286533,12,2025-02-24 22:25:08.494414,2025-02-24 22:25:23.631867,15.137453
channel-6994,1324292,30286561,30286572,11,2025-02-24 22:26:04.168562,2025-02-24 22:26:18.716699,14.548137
channel-6994,1324293,30286566,30286576,10,2025-02-24 22:26:10.051128,2025-02-24 22:26:23.894870,13.843742
channel-6994,1324294,30286569,30286617,48,2025-02-24 22:26:13.426750,2025-02-24 22:27:17.728098,64.301348
channel-6994,1324295,30286584,30286594,10,2025-02-24 22:26:35.712752,2025-02-24 22:26:48.384407,12.671655
channel-6994,1324296,30286599,30286613,14,2025-02-24 22:26:54.177582,2025-02-24 22:27:12.143609,17.966027
channel-6994,1324297,30286611,30286621,10,2025-02-24 22:27:09.280867,2025-02-24 22:27:23.773196,14.492329
channel-6994,1324298,30286617,30286630,13,2025-02-24 22:27:17.728098,2025-02-24 22:27:34.744955,17.016857
channel-6994,1324299,30286629,30286679,50,2025-02-24 22:27:33.534363,2025-02-24 22:28:37.151454,63.617091
channel-6994,1324300,30286658,30286669,11,2025-02-24 22:28:08.667920,2025-02-24 22:28:24.270778,15.602858
channel-6994,1324301,30286694,30286730,36,2025-02-24 22:28:56.365325,2025-02-24 22:29:42.942687,46.577362
channel-6994,1324302,30286698,30286707,9,2025-02-24 22:29:01.219912,2025-02-24 22:29:12.772592,11.55268
channel-6994,1324303,30286712,30286726,14,2025-02-24 22:29:18.851280,2025-02-24 22:29:37.050716,18.199436
channel-6994,1324304,30286715,30286726,11,2025-02-24 22:29:23.651157,2025-02-24 22:29:37.050716,13.399559
channel-6994,1324305,30286757,30286796,39,2025-02-24 22:30:18.828378,2025-02-24 22:31:11.879783,53.051405
channel-6994,1324306,30286822,30286863,41,2025-02-24 22:31:44.781220,2025-02-24 22:32:39.143606,54.362386
channel-6994,1324307,30286884,30286925,41,2025-02-24 22:33:05.031678,2025-02-24 22:33:56.788677,51.756999
channel-6994,1324308,30286948,30286986,38,2025-02-24 22:34:25.686759,2025-02-24 22:35:17.924966,52.238207
channel-6994,1324309,30286967,30286982,15,2025-02-24 22:34:50.291860,2025-02-24 22:35:12.555256,22.263396
channel-6994,1324310,30286979,30286990,11,2025-02-24 22:35:09.029567,2025-02-24 22:35:24.679611,15.650044
channel-6994,1324311,30286982,30286995,13,2025-02-24 22:35:12.555256,2025-02-24 22:35:30.967707,18.412451
channel-6994,1324312,30286985,30286995,10,2025-02-24 22:35:16.699994,2025-02-24 22:35:30.967707,14.267713
channel-6994,1324313,30287007,30287049,42,2025-02-24 22:35:47.153781,2025-02-24 22:36:43.938929,56.785148
channel-6994,1324314,30287069,30287082,13,2025-02-24 22:37:09.752053,2025-02-24 22:37:27.575757,17.823704
channel-6994,1324315,30287069,30287107,38,2025-02-24 22:37:09.752053,2025-02-24 22:38:02.127464,52.375411
channel-6994,1324316,30287101,30287112,11,2025-02-24 22:37:53.405398,2025-02-24 22:38:07.806668,14.40127
channel-6994,1324317,30287134,30287176,42,2025-02-24 22:38:36.008314,2025-02-24 22:39:28.378629,52.370315
channel-6994,1324318,30287145,30287157,12,2025-02-24 22:38:48.899684,2025-02-24 22:39:05.267657,16.367973
channel-6994,1324319,30287159,30287173,14,2025-02-24 22:39:07.472066,2025-02-24 22:39:23.825563,16.353497
channel-6994,1324320,30287163,30287173,10,2025-02-24 22:39:12.385273,2025-02-24 22:39:23.825563,11.44029
channel-6994,1324321,30287194,30287247,53,2025-02-24 22:39:59.691804,2025-02-24 22:41:07.686699,67.994895
channel-6994,1324322,30287259,30287324,65,2025-02-24 22:41:22.488127,2025-02-24 22:42:45.216543,82.728416
channel-6994,1324323,30287312,30287324,12,2025-02-24 22:42:29.520154,2025-02-24 22:42:45.216543,15.696389
channel-6994,1324324,30287335,30287385,50,2025-02-24 22:42:58.703480,2025-02-24 22:44:06.047090,67.34361
channel-6994,1324325,30287349,30287361,12,2025-02-24 22:43:16.481019,2025-02-24 22:43:36.361144,19.880125
channel-6994,1324326,30287362,30287375,13,2025-02-24 22:43:37.454556,2025-02-24 22:43:53.827155,16.372599
channel-6994,1324327,30287375,30287385,10,2025-02-24 22:43:53.827155,2025-02-24 22:44:06.047090,12.219935
channel-6994,1324328,30287397,30287446,49,2025-02-24 22:44:20.995354,2025-02-24 22:45:33.266706,72.271352
channel-6994,1324329,30287451,30287488,37,2025-02-24 22:45:39.594718,2025-02-24 22:46:26.704640,47.109922
channel-6994,1324330,30287469,30287479,10,2025-02-24 22:46:01.997142,2025-02-24 22:46:15.477676,13.480534
channel-6994,1324331,30287511,30287549,38,2025-02-24 22:46:56.314529,2025-02-24 22:47:46.242480,49.927951
channel-6994,1324332,30287567,30287607,40,2025-02-24 22:48:08.319558,2025-02-24 22:49:01.100310,52.780752
channel-6994,1324333,30287600,30287621,21,2025-02-24 22:48:52.270493,2025-02-24 22:49:23.719733,31.44924
channel-6994,1324334,30287622,30287632,10,2025-02-24 22:49:24.997581,2025-02-24 22:49:36.480603,11.483022
channel-6994,1324335,30287623,30287636,13,2025-02-24 22:49:26.091296,2025-02-24 22:49:42.484983,16.393687
channel-6994,1324336,30287625,30287668,43,2025-02-24 22:49:28.239406,2025-02-24 22:50:23.382299,55.142893
channel-6994,1324337,30287637,30287652,15,2025-02-24 22:49:43.672665,2025-02-24 22:50:02.777174,19.104509
channel-6994,1324338,30287682,30287696,14,2025-02-24 22:50:43.706604,2025-02-24 22:51:00.028709,16.322105
channel-6994,1324339,30287685,30287724,39,2025-02-24 22:50:47.066928,2025-02-24 22:51:36.815341,49.748413
channel-6994,1324340,30287699,30287709,10,2025-02-24 22:51:03.343710,2025-02-24 22:51:18.972057,15.628347
channel-6994,1324341,30287700,30287709,9,2025-02-24 22:51:04.556326,2025-02-24 22:51:18.972057,14.415731
channel-6994,1324342,30287731,30287745,14,2025-02-24 22:51:46.982689,2025-02-24 22:52:04.414088,17.431399
channel-6994,1324343,30287756,30287791,35,2025-02-24 22:52:17.345135,2025-02-24 22:53:07.640138,50.295003
channel-6994,1324344,30287774,30287788,14,2025-02-24 22:52:39.725147,2025-02-24 22:52:59.753074,20.027927
channel-6994,1324345,30287780,30287791,11,2025-02-24 22:52:49.208285,2025-02-24 22:53:07.640138,18.431853
channel-6994,1324346,30287811,30287820,9,2025-02-24 22:53:36.821880,2025-02-24 22:53:48.914624,12.092744
channel-6994,1324347,30287817,30287863,46,2025-02-24 22:53:45.404632,2025-02-24 22:54:43.853467,58.448835
channel-6994,1324348,30287836,30287848,12,2025-02-24 22:54:11.006810,2025-02-24 22:54:25.535194,14.528384
channel-6994,1324350,30287894,30287902,8,2025-02-24 22:55:28.005401,2025-02-24 22:55:38.672844,10.667443
channel-6994,1324351,30287910,30287921,11,2025-02-24 22:55:49.459417,2025-02-24 22:56:02.937133,13.477716
channel-6994,1324352,30287949,30287992,43,2025-02-24 22:56:40.779134,2025-02-24 22:57:40.457411,59.678277
channel-6994,1324353,30288008,30288045,37,2025-02-24 22:58:01.031489,2025-02-24 22:58:57.026206,55.994717
channel-6994,1324354,30288058,30288070,12,2025-02-24 22:59:15.360899,2025-02-24 22:59:31.506719,16.14582
channel-6994,1324355,30288077,30288121,44,2025-02-24 22:59:39.320004,2025-02-24 23:00:39.106310,59.786306
channel-6994,1324356,30288087,30288099,12,2025-02-24 22:59:51.178781,2025-02-24 23:00:07.986595,16.807814
channel-6994,1324357,30288107,30288117,10,2025-02-24 23:00:18.231958,2025-02-24 23:00:32.051080,13.819122
channel-6994,1324358,30288153,30288195,42,2025-02-24 23:01:23.041369,2025-02-24 23:02:17.581461,54.540092
channel-6994,1324359,30288226,30288268,42,2025-02-24 23:03:00.787437,2025-02-24 23:04:02.071984,61.284547
channel-6994,1324360,30288285,30288323,38,2025-02-24 23:04:23.061021,2025-02-24 23:05:14.732870,51.671849
channel-6994,1324361,30288286,30288300,14,2025-02-24 23:04:24.344376,2025-02-24 23:04:40.879125,16.534749
channel-6994,1324362,30288286,30288300,14,2025-02-24 23:04:24.344376,2025-02-24 23:04:40.879125,16.534749
channel-6994,1324363,30288309,30288319,10,2025-02-24 23:04:53.457458,2025-02-24 23:05:09.921170,16.463712
channel-6994,1324364,30288320,30288333,13,2025-02-24 23:05:11.207980,2025-02-24 23:05:26.338437,15.130457
channel-6994,1324365,30288331,30288347,16,2025-02-24 23:05:24.012897,2025-02-24 23:05:43.220401,19.207504
channel-6994,1324366,30288347,30288386,39,2025-02-24 23:05:43.220401,2025-02-24 23:06:34.953893,51.733492
channel-6994,1324367,30288403,30288444,41,2025-02-24 23:06:58.613711,2025-02-24 23:07:55.420374,56.806663
channel-6994,1324368,30288410,30288432,22,2025-02-24 23:07:08.721958,2025-02-24 23:07:39.762981,31.041023
channel-6994,1324369,30288473,30288513,40,2025-02-24 23:08:32.978844,2025-02-24 23:09:26.572143,53.593299
channel-6994,1324370,30288527,30288537,10,2025-02-24 23:09:44.874708,2025-02-24 23:09:56.817595,11.942887
channel-6994,1324372,30288594,30288633,39,2025-02-24 23:11:13.408682,2025-02-24 23:12:07.582283,54.173601
channel-6994,1324373,30288659,30288701,42,2025-02-24 23:12:40.395147,2025-02-24 23:13:34.174843,53.779696
channel-6994,1324374,30288696,30288707,11,2025-02-24 23:13:26.337944,2025-02-24 23:13:41.764330,15.426386
channel-6994,1324375,30288704,30288716,12,2025-02-24 23:13:37.702709,2025-02-24 23:13:52.452560,14.749851
channel-6994,1324376,30288724,30288762,38,2025-02-24 23:14:01.682148,2025-02-24 23:14:53.092743,51.410595
channel-6994,1324377,30288724,30288735,11,2025-02-24 23:14:01.682148,2025-02-24 23:14:17.098619,15.416471
channel-6994,1324378,30288753,30288767,14,2025-02-24 23:14:42.921349,2025-02-24 23:14:59.543769,16.62242
channel-6994,1324379,30288785,30288824,39,2025-02-24 23:15:20.471516,2025-02-24 23:16:11.601210,51.129694
channel-6994,1324380,30288832,30288842,10,2025-02-24 23:16:23.770453,2025-02-24 23:16:36.537824,12.767371
channel-6994,1324381,30288842,30288884,42,2025-02-24 23:16:36.537824,2025-02-24 23:17:32.929712,56.391888
channel-6994,1324382,30288910,30288956,46,2025-02-24 23:18:06.312347,2025-02-24 23:19:04.156444,57.844097
channel-6994,1324383,30288914,30288926,12,2025-02-24 23:18:11.086819,2025-02-24 23:18:26.347990,15.261171
channel-6994,1324384,30288975,30289026,51,2025-02-24 23:19:29.938863,2025-02-24 23:20:41.018299,71.079436
channel-6994,1324385,30289043,30289091,48,2025-02-24 23:21:03.757467,2025-02-24 23:22:08.030322,64.272855
channel-6994,1324386,30289104,30289159,55,2025-02-24 23:22:24.204318,2025-02-24 23:23:32.513804,68.309486
channel-6994,1324387,30289106,30289159,53,2025-02-24 23:22:26.435733,2025-02-24 23:23:32.513804,66.078071
channel-6994,1324388,30289176,30289228,52,2025-02-24 23:23:57.212042,2025-02-24 23:25:05.430107,68.218065
channel-6994,1324389,30289185,30289194,9,2025-02-24 23:24:10.037803,2025-02-24 23:24:22.760607,12.722804
channel-6994,1324390,30289189,30289214,25,2025-02-24 23:24:16.007054,2025-02-24 23:24:46.731957,30.724903
channel-6994,1324391,30289238,30289289,51,2025-02-24 23:25:17.130245,2025-02-24 23:26:33.796004,76.665759
channel-6994,1324392,30289302,30289352,50,2025-02-24 23:26:50.164684,2025-02-24 23:27:54.069412,63.904728
channel-6994,1324393,30289367,30289410,43,2025-02-24 23:28:17.204794,2025-02-24 23:29:11.560517,54.355723
channel-6994,1324394,30289397,30289410,13,2025-02-24 23:28:56.448202,2025-02-24 23:29:11.560517,15.112315
channel-6994,1324395,30289428,30289464,36,2025-02-24 23:29:35.066045,2025-02-24 23:30:26.375996,51.309951
channel-6994,1324396,30289432,30289444,12,2025-02-24 23:29:40.698827,2025-02-24 23:30:00.336628,19.637801
channel-6994,1324398,30289505,30289519,14,2025-02-24 23:31:25.265423,2025-02-24 23:31:42.250763,16.98534
channel-6994,1324399,30289548,30289591,43,2025-02-24 23:32:21.608504,2025-02-24 23:33:14.516965,52.908461
channel-6994,1324400,30289593,30289605,12,2025-02-24 23:33:16.763185,2025-02-24 23:33:31.783573,15.020388
channel-6994,1324401,30289614,30289656,42,2025-02-24 23:33:48.306411,2025-02-24 23:34:42.242222,53.935811
channel-6994,1324402,30289639,30289652,13,2025-02-24 23:34:19.473808,2025-02-24 23:34:35.698677,16.224869
channel-6994,1324403,30289655,30289664,9,2025-02-24 23:34:40.951024,2025-02-24 23:34:52.857117,11.906093
channel-6994,1324404,30289681,30289725,44,2025-02-24 23:35:17.476636,2025-02-24 23:36:20.204498,62.727862
channel-6994,1324405,30289703,30289725,22,2025-02-24 23:35:47.420881,2025-02-24 23:36:20.204498,32.783617
channel-6994,1324406,30289748,30289785,37,2025-02-24 23:36:48.969322,2025-02-24 23:37:37.840047,48.870725
channel-6994,1324407,30289808,30289853,45,2025-02-24 23:38:07.559241,2025-02-24 23:39:04.964417,57.405176
channel-6994,1324408,30289871,30289906,35,2025-02-24 23:39:29.996096,2025-02-24 23:40:24.766717,54.770621
channel-6994,1324409,30289898,30289911,13,2025-02-24 23:40:13.880502,2025-02-24 23:40:30.345974,16.465472
channel-6994,1324410,30289932,30289971,39,2025-02-24 23:40:57.027518,2025-02-24 23:41:52.222819,55.195301
channel-6994,1324411,30289999,30290034,35,2025-02-24 23:42:27.602141,2025-02-24 23:43:12.397485,44.795344
channel-6994,1324412,30290023,30290034,11,2025-02-24 23:42:58.928892,2025-02-24 23:43:12.397485,13.468593
channel-6994,1324413,30290058,30290095,37,2025-02-24 23:43:45.244157,2025-02-24 23:44:35.248001,50.003844
channel-6994,1324414,30290080,30290089,9,2025-02-24 23:44:12.678550,2025-02-24 23:44:24.468892,11.790342
channel-6994,1324415,30290092,30290107,15,2025-02-24 23:44:31.395565,2025-02-24 23:44:50.756664,19.361099
channel-6994,1324416,30290117,30290157,40,2025-02-24 23:45:03.975429,2025-02-24 23:45:59.298094,55.322665
channel-6994,1324417,30290151,30290161,10,2025-02-24 23:45:52.320567,2025-02-24 23:46:05.213322,12.892755
channel-6994,1324418,30290160,30290170,10,2025-02-24 23:46:03.946648,2025-02-24 23:46:15.820157,11.873509
channel-6994,1324419,30290175,30290214,39,2025-02-24 23:46:22.117783,2025-02-24 23:47:10.933064,48.815281
channel-6994,1324420,30290234,30290244,10,2025-02-24 23:47:40.810884,2025-02-24 23:47:54.322003,13.511119
channel-6994,1324421,30290238,30290277,39,2025-02-24 23:47:45.274017,2025-02-24 23:48:36.708193,51.434176
channel-6994,1324422,30290246,30290258,12,2025-02-24 23:47:57.658009,2025-02-24 23:48:12.204041,14.546032
channel-6994,1324423,30290280,30290291,11,2025-02-24 23:48:40.283621,2025-02-24 23:48:55.335851,15.05223
channel-6994,1324424,30290298,30290336,38,2025-02-24 23:49:03.999512,2025-02-24 23:49:57.056016,53.056504
channel-6994,1324425,30290304,30290326,22,2025-02-24 23:49:11.764354,2025-02-24 23:49:44.152853,32.388499
channel-6994,1324426,30290305,30290311,6,2025-02-24 23:49:12.914404,2025-02-24 23:49:24.639388,11.724984
channel-6994,1324427,30290355,30290391,36,2025-02-24 23:50:22.124016,2025-02-24 23:51:12.520022,50.396006
channel-6994,1324428,30290419,30290459,40,2025-02-24 23:51:46.890680,2025-02-24 23:52:39.273753,52.383073
channel-6994,1324429,30290434,30290447,13,2025-02-24 23:52:06.384518,2025-02-24 23:52:25.437973,19.053455
channel-6994,1324430,30290479,30290513,34,2025-02-24 23:53:05.617257,2025-02-24 23:53:51.890200,46.272943
channel-6994,1324431,30290488,30290500,12,2025-02-24 23:53:17.386155,2025-02-24 23:53:32.557687,15.171532
channel-6994,1324432,30290527,30290536,9,2025-02-24 23:54:10.197841,2025-02-24 23:54:22.033254,11.835413
channel-6994,1324433,30290536,30290579,43,2025-02-24 23:54:22.033254,2025-02-24 23:55:17.441218,55.407964
channel-6994,1324434,30290539,30290551,12,2025-02-24 23:54:25.462075,2025-02-24 23:54:40.249537,14.787462
channel-6994,1324435,30290563,30290575,12,2025-02-24 23:54:57.436296,2025-02-24 23:55:12.328357,14.892061
channel-6994,1324436,30290595,30290646,51,2025-02-24 23:55:37.931210,2025-02-24 23:56:44.547852,66.616642
channel-6994,1324437,30290623,30290631,8,2025-02-24 23:56:13.227860,2025-02-24 23:56:24.554804,11.326944
channel-6994,1324438,30290659,30290692,33,2025-02-24 23:57:01.373429,2025-02-24 23:57:44.094545,42.721116
channel-6994,1324439,30290688,30290699,11,2025-02-24 23:57:39.036480,2025-02-24 23:57:52.170463,13.133983
channel-6994,1324440,30290717,30290755,38,2025-02-24 23:58:17.311197,2025-02-24 23:59:11.003173,53.691976
channel-6994,1324441,30290719,30290728,9,2025-02-24 23:58:19.631685,2025-02-24 23:58:32.877973,13.246288
channel-6994,1324442,30290725,30290735,10,2025-02-24 23:58:27.951033,2025-02-24 23:58:46.041047,18.090014
channel-6994,1324443,30290773,30290830,57,2025-02-24 23:59:34.065346,2025-02-25 00:00:46.065613,72.000267
channel-6994,1324444,30290791,30290802,11,2025-02-24 23:59:56.494833,2025-02-25 00:00:09.289390,12.794557
channel-6994,1324445,30290861,30290911,50,2025-02-25 00:01:25.669239,2025-02-25 00:02:31.592744,65.923505
channel-6994,1324446,30290897,30290911,14,2025-02-25 00:02:13.845913,2025-02-25 00:02:31.592744,17.746831
channel-6994,1324447,30290923,30290955,32,2025-02-25 00:02:48.485881,2025-02-25 00:03:38.092461,49.60658
channel-6994,1324448,30290932,30290943,11,2025-02-25 00:03:02.605444,2025-02-25 00:03:19.095124,16.48968
channel-6994,1324449,30290951,30290965,14,2025-02-25 00:03:30.496384,2025-02-25 00:03:49.636555,19.140171
channel-6994,1324450,30290994,30291033,39,2025-02-25 00:04:28.986009,2025-02-25 00:05:19.677312,50.691303
channel-6994,1324451,30291004,30291014,10,2025-02-25 00:04:43.288934,2025-02-25 00:04:56.346438,13.057504
channel-6994,1324452,30291004,30291014,10,2025-02-25 00:04:43.288934,2025-02-25 00:04:56.346438,13.057504
channel-6994,1324453,30291055,30291091,36,2025-02-25 00:05:48.018087,2025-02-25 00:06:36.197932,48.179845
channel-6994,1324454,30291115,30291150,35,2025-02-25 00:07:06.913008,2025-02-25 00:07:54.223695,47.310687
channel-6994,1324455,30291116,30291124,8,2025-02-25 00:07:08.079871,2025-02-25 00:07:18.314171,10.2343
channel-6994,1324456,30291171,30291212,41,2025-02-25 00:08:23.762009,2025-02-25 00:09:19.126126,55.364117
channel-6994,1324457,30291234,30291290,56,2025-02-25 00:09:45.088448,2025-02-25 00:10:59.378176,74.289728
channel-6994,1324458,30291239,30291265,26,2025-02-25 00:09:51.357480,2025-02-25 00:10:28.298100,36.94062
channel-6994,1324459,30291281,30291313,32,2025-02-25 00:10:48.744908,2025-02-25 00:11:31.435002,42.690094
channel-6994,1324460,30291283,30291300,17,2025-02-25 00:10:50.889576,2025-02-25 00:11:11.556424,20.666848
channel-6994,1324461,30291288,30291318,30,2025-02-25 00:10:56.939198,2025-02-25 00:11:37.502990,40.563792
channel-6994,1324462,30291301,30291313,12,2025-02-25 00:11:13.762900,2025-02-25 00:11:31.435002,17.672102
channel-6994,1324463,30291308,30291355,47,2025-02-25 00:11:23.751454,2025-02-25 00:12:30.888574,67.13712
channel-6994,1324464,30291353,30291376,23,2025-02-25 00:12:28.593623,2025-02-25 00:13:03.753334,35.159711
channel-6994,1324465,30291367,30291422,55,2025-02-25 00:12:47.159405,2025-02-25 00:14:00.180709,73.021304
channel-6994,1324466,30291380,30291392,12,2025-02-25 00:13:08.744247,2025-02-25 00:13:22.483657,13.73941
channel-6994,1324467,30291435,30291477,42,2025-02-25 00:14:19.001960,2025-02-25 00:15:17.212320,58.21036
channel-6994,1324468,30291436,30291462,26,2025-02-25 00:14:20.758624,2025-02-25 00:14:58.851301,38.092677
channel-6994,1324469,30291498,30291540,42,2025-02-25 00:15:44.396623,2025-02-25 00:16:47.643248,63.246625
channel-6994,1324470,30291547,30291561,14,2025-02-25 00:17:01.521046,2025-02-25 00:17:18.077304,16.556258
channel-6994,1324471,30291559,30291606,47,2025-02-25 00:17:15.616913,2025-02-25 00:18:17.189904,61.572991
channel-6994,1324472,30291567,30291579,12,2025-02-25 00:17:26.165770,2025-02-25 00:17:41.032486,14.866716
channel-6994,1324473,30291622,30291671,49,2025-02-25 00:18:35.979186,2025-02-25 00:19:39.623597,63.644411
channel-6994,1324474,30291644,30291653,9,2025-02-25 00:19:03.995107,2025-02-25 00:19:16.786545,12.791438
channel-6994,1324475,30291655,30291667,12,2025-02-25 00:19:19.253164,2025-02-25 00:19:33.841822,14.588658
channel-6994,1324476,30291664,30291681,17,2025-02-25 00:19:29.837908,2025-02-25 00:19:52.096959,22.259051
channel-6994,1324477,30291690,30291746,56,2025-02-25 00:20:07.890366,2025-02-25 00:21:20.423877,72.533511
channel-6994,1324478,30291730,30291741,11,2025-02-25 00:20:59.945590,2025-02-25 00:21:14.398979,14.453389
channel-6994,1324479,30291941,30291975,34,2025-02-25 00:25:37.040547,2025-02-25 00:26:28.842110,51.801563
channel-6994,1324480,30291949,30291959,10,2025-02-25 00:25:47.746641,2025-02-25 00:26:03.677286,15.930645
channel-6994,1324481,30292026,30292032,6,2025-02-25 00:27:34.745172,2025-02-25 00:27:43.862806,9.117634
channel-6994,1324482,30292049,30292060,11,2025-02-25 00:28:07.993247,2025-02-25 00:28:21.501311,13.508064
channel-6994,1324483,30292049,30292070,21,2025-02-25 00:28:07.993247,2025-02-25 00:28:34.017044,26.023797
channel-6994,1324484,30292132,30292143,11,2025-02-25 00:29:55.012608,2025-02-25 00:30:09.145945,14.133337
channel-6994,1324485,30292163,30292170,7,2025-02-25 00:30:32.710368,2025-02-25 00:30:44.549662,11.839294
channel-6994,1324486,30292228,30292239,11,2025-02-25 00:32:01.031493,2025-02-25 00:32:14.867358,13.835865
channel-6994,1324487,30292373,30292384,11,2025-02-25 00:35:15.612470,2025-02-25 00:35:29.654925,14.042455
channel-6994,1324488,30292523,30292564,41,2025-02-25 00:38:30.182600,2025-02-25 00:39:22.994118,52.811518
channel-6994,1324489,30292536,30292547,11,2025-02-25 00:38:46.215992,2025-02-25 00:38:58.797017,12.581025
channel-6994,1324490,30292560,30292591,31,2025-02-25 00:39:17.504921,2025-02-25 00:39:58.953397,41.448476
channel-6994,1324491,30292572,30292583,11,2025-02-25 00:39:33.563737,2025-02-25 00:39:46.127372,12.563635
channel-6994,1324492,30292589,30292626,37,2025-02-25 00:39:56.629032,2025-02-25 00:40:44.833849,48.204817
channel-6994,1324493,30292655,30292690,35,2025-02-25 00:41:22.098690,2025-02-25 00:42:07.811938,45.713248
channel-6994,1324494,30292693,30292705,12,2025-02-25 00:42:11.650180,2025-02-25 00:42:26.940806,15.290626
channel-6994,1324495,30292723,30292758,35,2025-02-25 00:42:49.053809,2025-02-25 00:43:38.141012,49.087203
channel-6994,1324496,30292784,30292822,38,2025-02-25 00:44:10.795910,2025-02-25 00:45:03.394835,52.598925
channel-6994,1324497,30292855,30292896,41,2025-02-25 00:45:46.661471,2025-02-25 00:46:38.688144,52.026673
channel-6994,1324498,30292921,30292962,41,2025-02-25 00:47:12.351752,2025-02-25 00:48:05.527943,53.176191
channel-6994,1324499,30293195,30293207,12,2025-02-25 00:53:15.452552,2025-02-25 00:53:30.596926,15.144374
channel-6994,1324500,30293270,30293282,12,2025-02-25 00:54:56.218928,2025-02-25 00:55:11.281572,15.062644
channel-6994,1324501,30293625,30293651,26,2025-02-25 01:02:46.065707,2025-02-25 01:03:23.516430,37.450723
channel-6994,1324502,30293678,30293687,9,2025-02-25 01:03:56.942245,2025-02-25 01:04:11.043233,14.100988
channel-6994,1324503,30293726,30293736,10,2025-02-25 01:04:59.697154,2025-02-25 01:05:11.736495,12.039341
channel-6994,1324504,30293790,30293803,13,2025-02-25 01:06:25.296760,2025-02-25 01:06:40.373806,15.077046
channel-6994,1324505,30293821,30293828,7,2025-02-25 01:07:05.210600,2025-02-25 01:07:17.265847,12.055247
channel-6994,1324506,30293907,30293948,41,2025-02-25 01:09:01.194789,2025-02-25 01:09:59.647970,58.453181
channel-6994,1324507,30293968,30294018,50,2025-02-25 01:10:25.265552,2025-02-25 01:11:30.617450,65.351898
channel-6994,1324508,30294028,30294038,10,2025-02-25 01:11:45.175697,2025-02-25 01:11:59.739736,14.564039
channel-6994,1324509,30294034,30294073,39,2025-02-25 01:11:55.116121,2025-02-25 01:12:44.234981,49.11886
channel-6994,1324510,30294100,30294146,46,2025-02-25 01:13:17.517891,2025-02-25 01:14:21.222410,63.704519
channel-6994,1324511,30294160,30294201,41,2025-02-25 01:14:40.173234,2025-02-25 01:15:30.973777,50.800543
channel-6994,1324512,30294348,30294357,9,2025-02-25 01:18:41.804869,2025-02-25 01:18:54.861909,13.05704
channel-6994,1324513,30294464,30294474,10,2025-02-25 01:21:17.595460,2025-02-25 01:21:35.940601,18.345141
channel-6994,1324514,30294504,30294515,11,2025-02-25 01:22:16.114980,2025-02-25 01:22:28.703944,12.588964
channel-6994,1324515,30294542,30294550,8,2025-02-25 01:23:00.825499,2025-02-25 01:23:16.250676,15.425177
channel-6994,1324516,30294552,30294565,13,2025-02-25 01:23:18.586215,2025-02-25 01:23:35.030737,16.444522
channel-6994,1324517,30294612,30294624,12,2025-02-25 01:24:34.353842,2025-02-25 01:24:49.041542,14.6877
channel-6994,1324518,30294678,30294688,10,2025-02-25 01:26:01.953756,2025-02-25 01:26:17.605258,15.651502
channel-6994,1324519,30294719,30294729,10,2025-02-25 01:26:57.409795,2025-02-25 01:27:10.776411,13.366616
channel-6994,1324520,30294801,30294810,9,2025-02-25 01:28:41.915763,2025-02-25 01:28:53.421537,11.505774
channel-6994,1324521,30294895,30294905,10,2025-02-25 01:30:49.617265,2025-02-25 01:31:02.020845,12.40358
channel-6994,1324522,30295038,30295051,13,2025-02-25 01:33:58.372960,2025-02-25 01:34:13.555054,15.182094
channel-6994,1324523,30295084,30295094,10,2025-02-25 01:35:01.275795,2025-02-25 01:35:13.240905,11.96511
channel-6994,1324524,30295146,30295156,10,2025-02-25 01:36:18.799266,2025-02-25 01:36:34.846702,16.047436
channel-6994,1324525,30295393,30295406,13,2025-02-25 01:41:50.860537,2025-02-25 01:42:06.229611,15.369074
channel-6994,1324526,30295491,30295525,34,2025-02-25 01:43:59.066928,2025-02-25 01:44:44.818990,45.752062
channel-6994,1324527,30295496,30295507,11,2025-02-25 01:44:06.161323,2025-02-25 01:44:21.630705,15.469382
channel-6994,1324528,30295555,30295566,11,2025-02-25 01:45:21.737120,2025-02-25 01:45:37.669439,15.932319
channel-6994,1324529,30295671,30295681,10,2025-02-25 01:47:50.597705,2025-02-25 01:48:03.767804,13.170099
channel-6994,1324530,30295703,30295712,9,2025-02-25 01:48:31.713252,2025-02-25 01:48:46.576764,14.863512
channel-6994,1324531,30295824,30295834,10,2025-02-25 01:51:10.698957,2025-02-25 01:51:24.121274,13.422317
channel-6994,1324532,30295851,30295863,12,2025-02-25 01:51:49.002597,2025-02-25 01:52:07.386474,18.383877
channel-6994,1324533,30295866,30295889,23,2025-02-25 01:52:11.255557,2025-02-25 01:52:42.680537,31.42498
channel-6994,1324534,30295917,30295947,30,2025-02-25 01:53:20.661493,2025-02-25 01:54:02.298081,41.636588
channel-6994,1324535,30295936,30295947,11,2025-02-25 01:53:47.333525,2025-02-25 01:54:02.298081,14.964556
channel-6994,1324536,30295948,30295960,12,2025-02-25 01:54:03.468301,2025-02-25 01:54:18.070944,14.602643
channel-6994,1324537,30296066,30296108,42,2025-02-25 01:56:36.819631,2025-02-25 01:57:31.318889,54.499258
channel-6994,1324538,30296112,30296125,13,2025-02-25 01:57:36.087966,2025-02-25 01:57:55.518753,19.430787
channel-6994,1324539,30296132,30296172,40,2025-02-25 01:58:05.282044,2025-02-25 01:58:54.179057,48.897013
channel-6994,1324540,30296138,30296152,14,2025-02-25 01:58:12.040598,2025-02-25 01:58:29.943944,17.903346
channel-6994,1324541,30296176,30296185,9,2025-02-25 01:58:58.719556,2025-02-25 01:59:11.926743,13.207187
channel-6994,1324542,30296205,30296219,14,2025-02-25 01:59:37.633628,2025-02-25 01:59:55.826500,18.192872
channel-6994,1324543,30296206,30296219,13,2025-02-25 01:59:39.149433,2025-02-25 01:59:55.826500,16.677067
channel-6994,1324544,30296240,30296257,17,2025-02-25 02:00:23.253915,2025-02-25 02:00:45.201081,21.947166
channel-6994,1324545,30296353,30296366,13,2025-02-25 02:02:56.133174,2025-02-25 02:03:11.444833,15.311659
channel-6994,1324546,30296380,30296393,13,2025-02-25 02:03:31.280839,2025-02-25 02:03:48.124785,16.843946
channel-6994,1324547,30296437,30296448,11,2025-02-25 02:04:43.542091,2025-02-25 02:04:57.204414,13.662323
channel-6994,1324548,30296450,30296463,13,2025-02-25 02:05:00.049814,2025-02-25 02:05:16.744442,16.694628
channel-6994,1324549,30296462,30296472,10,2025-02-25 02:05:15.616184,2025-02-25 02:05:28.222161,12.605977
channel-6994,1324550,30296506,30296519,13,2025-02-25 02:06:11.989857,2025-02-25 02:06:28.945614,16.955757
channel-6994,1324551,30296520,30296530,10,2025-02-25 02:06:30.014657,2025-02-25 02:06:47.565286,17.550629
channel-6994,1324552,30296571,30296581,10,2025-02-25 02:07:41.627244,2025-02-25 02:07:55.912565,14.285321
channel-6994,1324553,30296600,30296627,27,2025-02-25 02:08:18.285092,2025-02-25 02:08:54.647821,36.362729
channel-6994,1324554,30296611,30296622,11,2025-02-25 02:08:30.924032,2025-02-25 02:08:46.639009,15.714977
channel-6994,1324555,30296650,30296675,25,2025-02-25 02:09:26.329232,2025-02-25 02:10:01.115740,34.786508
channel-6994,1324556,30296665,30296675,10,2025-02-25 02:09:43.853912,2025-02-25 02:10:01.115740,17.261828
channel-6994,1324557,30296678,30296690,12,2025-02-25 02:10:05.193031,2025-02-25 02:10:19.853224,14.660193
channel-6994,1324558,30296836,30296848,12,2025-02-25 02:13:34.752101,2025-02-25 02:13:52.525375,17.773274
channel-6994,1324559,30296865,30296874,9,2025-02-25 02:14:16.613267,2025-02-25 02:14:28.707620,12.094353
channel-6994,1324560,30296876,30296903,27,2025-02-25 02:14:31.508840,2025-02-25 02:15:07.871919,36.363079
channel-6994,1324561,30296878,30296887,9,2025-02-25 02:14:34.841165,2025-02-25 02:14:45.149691,10.308526
channel-6994,1324562,30296883,30296892,9,2025-02-25 02:14:40.429054,2025-02-25 02:14:55.033504,14.60445
channel-6994,1324563,30296978,30296990,12,2025-02-25 02:16:51.347289,2025-02-25 02:17:05.822749,14.47546
channel-6994,1324564,30297004,30297014,10,2025-02-25 02:17:23.326837,2025-02-25 02:17:37.098588,13.771751
channel-6994,1324565,30297050,30297060,10,2025-02-25 02:18:21.398254,2025-02-25 02:18:38.933254,17.535
channel-6994,1324566,30297121,30297159,38,2025-02-25 02:19:55.482721,2025-02-25 02:20:48.782851,53.30013
channel-6994,1324567,30297159,30297173,14,2025-02-25 02:20:48.782851,2025-02-25 02:21:11.270454,22.487603
channel-6994,1324568,30297159,30297173,14,2025-02-25 02:20:48.782851,2025-02-25 02:21:11.270454,22.487603
channel-6994,1324569,30297169,30297182,13,2025-02-25 02:21:05.047865,2025-02-25 02:21:21.988262,16.940397
channel-6994,1324570,30297180,30297222,42,2025-02-25 02:21:19.505390,2025-02-25 02:22:12.574185,53.068795
channel-6994,1324571,30297240,30297252,12,2025-02-25 02:22:38.682396,2025-02-25 02:22:55.584006,16.90161
channel-6994,1324572,30297243,30297279,36,2025-02-25 02:22:42.033631,2025-02-25 02:23:29.764078,47.730447
channel-6994,1324573,30297296,30297306,10,2025-02-25 02:23:50.276908,2025-02-25 02:24:03.411845,13.134937
channel-6994,1324574,30297308,30297348,40,2025-02-25 02:24:05.783501,2025-02-25 02:25:00.836776,55.053275
channel-6994,1324575,30297347,30297356,9,2025-02-25 02:24:58.648289,2025-02-25 02:25:13.771353,15.123064
channel-6994,1324576,30297367,30297414,47,2025-02-25 02:25:27.964183,2025-02-25 02:26:30.905807,62.941624
channel-6994,1324577,30297377,30297388,11,2025-02-25 02:25:42.148268,2025-02-25 02:25:55.944319,13.796051
channel-6994,1324578,30297427,30297468,41,2025-02-25 02:26:46.844919,2025-02-25 02:27:38.019739,51.17482
channel-6994,1324579,30297491,30297530,39,2025-02-25 02:28:07.576814,2025-02-25 02:28:56.349873,48.773059
channel-6994,1324580,30297555,30297589,34,2025-02-25 02:29:27.266320,2025-02-25 02:30:16.204525,48.938205
channel-6994,1324581,30297564,30297571,7,2025-02-25 02:29:39.663154,2025-02-25 02:29:51.506479,11.843325
channel-6994,1324582,30297570,30297580,10,2025-02-25 02:29:50.245995,2025-02-25 02:30:04.332676,14.086681
channel-6994,1324583,30297597,30297607,10,2025-02-25 02:30:25.733956,2025-02-25 02:30:38.666919,12.932963
channel-6994,1324584,30297616,30297656,40,2025-02-25 02:30:49.346982,2025-02-25 02:31:39.867637,50.520655
channel-6994,1324585,30297691,30297703,12,2025-02-25 02:32:25.845131,2025-02-25 02:32:42.641341,16.79621
channel-6994,1324586,30297725,30297734,9,2025-02-25 02:33:11.687526,2025-02-25 02:33:24.056344,12.368818
channel-6994,1324587,30297867,30297877,10,2025-02-25 02:36:22.455314,2025-02-25 02:36:35.198258,12.742944
channel-6994,1324588,30297922,30297931,9,2025-02-25 02:37:30.738985,2025-02-25 02:37:44.137070,13.398085
channel-6994,1324589,30298027,30298039,12,2025-02-25 02:39:52.945849,2025-02-25 02:40:09.093398,16.147549
channel-6994,1324590,30298037,30298051,14,2025-02-25 02:40:06.577917,2025-02-25 02:40:22.634912,16.056995
channel-6994,1324591,30298040,30298056,16,2025-02-25 02:40:10.227777,2025-02-25 02:40:28.394274,18.166497
channel-6994,1324592,30298119,30298129,10,2025-02-25 02:41:51.815747,2025-02-25 02:42:05.073270,13.257523
channel-6994,1324593,30298139,30298153,14,2025-02-25 02:42:18.732843,2025-02-25 02:42:37.783411,19.050568
channel-6994,1324594,30298167,30298176,9,2025-02-25 02:42:56.270978,2025-02-25 02:43:08.023655,11.752677
channel-6994,1324595,30298259,30298269,10,2025-02-25 02:44:58.448225,2025-02-25 02:45:12.071056,13.622831
channel-6994,1324596,30298417,30298426,9,2025-02-25 02:48:28.582800,2025-02-25 02:48:40.089511,11.506711
channel-6994,1324597,30298449,30298459,10,2025-02-25 02:49:08.183425,2025-02-25 02:49:22.117443,13.934018
channel-6994,1324598,30298473,30298500,27,2025-02-25 02:49:41.180053,2025-02-25 02:50:18.884499,37.704446
channel-6994,1324599,30298540,30298568,28,2025-02-25 02:51:12.198955,2025-02-25 02:51:48.724121,36.525166
channel-6994,1324600,30298588,30298600,12,2025-02-25 02:52:16.400874,2025-02-25 02:52:30.948716,14.547842
channel-6994,1324601,30298628,30298640,12,2025-02-25 02:53:14.940847,2025-02-25 02:53:30.243738,15.302891
channel-6994,1324602,30298660,30298667,7,2025-02-25 02:53:56.667760,2025-02-25 02:54:09.223923,12.556163
channel-6994,1324603,30298711,30298743,32,2025-02-25 02:55:10.153561,2025-02-25 02:55:51.018743,40.865182
channel-6994,1324604,30298729,30298743,14,2025-02-25 02:55:33.410414,2025-02-25 02:55:51.018743,17.608329
channel-6994,1324605,30298839,30298870,31,2025-02-25 02:58:18.731775,2025-02-25 02:58:58.233292,39.501517
channel-6994,1324606,30298842,30298854,12,2025-02-25 02:58:23.686653,2025-02-25 02:58:39.226994,15.540341
channel-6994,1324607,30298879,30298903,24,2025-02-25 02:59:08.888115,2025-02-25 02:59:45.291197,36.403082
channel-6994,1324608,30298880,30298891,11,2025-02-25 02:59:10.991673,2025-02-25 02:59:28.056248,17.064575
channel-6994,1324609,30298898,30298908,10,2025-02-25 02:59:38.654810,2025-02-25 02:59:52.871826,14.217016
channel-6994,1324610,30298926,30298936,10,2025-02-25 03:00:22.853858,2025-02-25 03:00:34.702281,11.848423
channel-6994,1324611,30298982,30298991,9,2025-02-25 03:01:36.737366,2025-02-25 03:01:51.157192,14.419826
channel-6994,1324612,30299010,30299023,13,2025-02-25 03:02:19.440268,2025-02-25 03:02:38.217229,18.776961
channel-6994,1324613,30299023,30299036,13,2025-02-25 03:02:38.217229,2025-02-25 03:02:57.624047,19.406818
channel-6994,1324614,30299023,30299036,13,2025-02-25 03:02:38.217229,2025-02-25 03:02:57.624047,19.406818
channel-6994,1324615,30299105,30299119,14,2025-02-25 03:04:24.885403,2025-02-25 03:04:43.165830,18.280427
channel-6994,1324616,30299158,30299168,10,2025-02-25 03:05:37.340630,2025-02-25 03:05:49.629157,12.288527
channel-6994,1324617,30299222,30299232,10,2025-02-25 03:06:58.527624,2025-02-25 03:07:15.969837,17.442213
channel-6994,1324618,30299373,30299382,9,2025-02-25 03:10:22.035839,2025-02-25 03:10:34.794182,12.758343
channel-6994,1324619,30299383,30299389,6,2025-02-25 03:10:39.366253,2025-02-25 03:10:47.917553,8.5513
channel-6994,1324620,30299494,30299498,4,2025-02-25 03:13:25.464562,2025-02-25 03:13:39.903316,14.438754
channel-6994,1324621,30299498,30299508,10,2025-02-25 03:13:39.903316,2025-02-25 03:13:58.253028,18.349712
channel-6994,1324622,30299501,30299512,11,2025-02-25 03:13:48.105625,2025-02-25 03:14:03.376059,15.270434
channel-6994,1324623,30299541,30299563,22,2025-02-25 03:14:41.084939,2025-02-25 03:15:13.584080,32.499141
channel-6994,1324624,30299803,30299814,11,2025-02-25 03:21:10.144866,2025-02-25 03:21:24.221219,14.076353
channel-6994,1324625,30299843,30299869,26,2025-02-25 03:22:09.626842,2025-02-25 03:22:45.117887,35.491045
channel-6994,1324626,30299869,30299907,38,2025-02-25 03:22:45.117887,2025-02-25 03:23:36.030095,50.912208
channel-6994,1324627,30299891,30299916,25,2025-02-25 03:23:16.618018,2025-02-25 03:23:48.167317,31.549299
channel-6994,1324628,30299893,30299907,14,2025-02-25 03:23:18.863671,2025-02-25 03:23:36.030095,17.166424
channel-6994,1324629,30299895,30299907,12,2025-02-25 03:23:21.237564,2025-02-25 03:23:36.030095,14.792531
channel-6994,1324630,30299934,30299981,47,2025-02-25 03:24:10.410888,2025-02-25 03:25:12.716750,62.305862
channel-6994,1324631,30299945,30299966,21,2025-02-25 03:24:27.931539,2025-02-25 03:24:54.050899,26.11936
channel-6994,1324632,30300003,30300048,45,2025-02-25 03:25:40.962097,2025-02-25 03:26:39.621306,58.659209
channel-6994,1324633,30300062,30300107,45,2025-02-25 03:26:56.642781,2025-02-25 03:27:59.479781,62.837
channel-6994,1324634,30300121,30300159,38,2025-02-25 03:28:16.601310,2025-02-25 03:29:04.109788,47.508478
channel-6994,1324635,30300197,30300208,11,2025-02-25 03:29:57.277974,2025-02-25 03:30:10.991166,13.713192
channel-6994,1324636,30300225,30300271,46,2025-02-25 03:30:31.171199,2025-02-25 03:31:39.092872,67.921673
channel-6994,1324637,30300264,30300288,24,2025-02-25 03:31:24.333554,2025-02-25 03:32:01.601348,37.267794
channel-6994,1324638,30300375,30300384,9,2025-02-25 03:33:51.951847,2025-02-25 03:34:04.511051,12.559204
channel-6994,1324639,30300384,30300396,12,2025-02-25 03:34:04.511051,2025-02-25 03:34:24.189809,19.678758
channel-6994,1324640,30300417,30300430,13,2025-02-25 03:34:49.954852,2025-02-25 03:35:04.716129,14.761277
channel-6994,1324641,30300429,30300476,47,2025-02-25 03:35:03.647487,2025-02-25 03:36:02.944026,59.296539
channel-6994,1324642,30300431,30300459,28,2025-02-25 03:35:05.867995,2025-02-25 03:35:43.188796,37.320801
channel-6994,1324643,30300442,30300454,12,2025-02-25 03:35:22.646023,2025-02-25 03:35:37.318169,14.672146
channel-6994,1324644,30300469,30300497,28,2025-02-25 03:35:54.396916,2025-02-25 03:36:36.562073,42.165157
channel-6994,1324645,30300495,30300534,39,2025-02-25 03:36:30.168401,2025-02-25 03:37:25.153823,54.985422
channel-6994,1324646,30300554,30300594,40,2025-02-25 03:37:49.866243,2025-02-25 03:38:40.425740,50.559497
channel-6994,1324647,30300579,30300589,10,2025-02-25 03:38:21.649981,2025-02-25 03:38:34.134929,12.484948
channel-6994,1324648,30300582,30300610,28,2025-02-25 03:38:25.201839,2025-02-25 03:39:03.450260,38.248421
channel-6994,1324649,30300610,30300625,15,2025-02-25 03:39:03.450260,2025-02-25 03:39:22.888090,19.43783
channel-6994,1324650,30300617,30300659,42,2025-02-25 03:39:13.872826,2025-02-25 03:40:05.673602,51.800776
channel-6994,1324651,30300618,30300631,13,2025-02-25 03:39:15.034904,2025-02-25 03:39:30.764292,15.729388
channel-6994,1324652,30300688,30300727,39,2025-02-25 03:40:41.672590,2025-02-25 03:41:38.005885,56.333295
channel-6994,1324653,30300743,30300781,38,2025-02-25 03:41:58.184965,2025-02-25 03:42:45.428478,47.243513
channel-6994,1324654,30300806,30300845,39,2025-02-25 03:43:18.370846,2025-02-25 03:44:12.580789,54.209943
channel-6994,1324655,30300861,30300884,23,2025-02-25 03:44:32.371507,2025-02-25 03:45:06.064075,33.692568
channel-6994,1324656,30300870,30300913,43,2025-02-25 03:44:43.365286,2025-02-25 03:45:41.930932,58.565646
channel-6994,1324657,30300889,30300901,12,2025-02-25 03:45:12.435669,2025-02-25 03:45:27.295098,14.859429
channel-6994,1324658,30300908,30300923,15,2025-02-25 03:45:36.261261,2025-02-25 03:45:54.328108,18.066847
channel-6994,1324659,30300924,30300937,13,2025-02-25 03:45:55.471905,2025-02-25 03:46:13.147911,17.676006
channel-6994,1324660,30300932,30300965,33,2025-02-25 03:46:05.089461,2025-02-25 03:46:53.160570,48.071109
channel-6994,1324661,30300992,30301035,43,2025-02-25 03:47:26.649291,2025-02-25 03:48:21.138125,54.488834
channel-6994,1324662,30301211,30301224,13,2025-02-25 03:52:12.413335,2025-02-25 03:52:30.314209,17.900874
channel-6994,1324663,30301244,30301253,9,2025-02-25 03:52:54.395478,2025-02-25 03:53:04.936571,10.541093
channel-6994,1324664,30301406,30301419,13,2025-02-25 03:56:25.865129,2025-02-25 03:56:40.777825,14.912696
channel-6994,1324665,30301449,30301476,27,2025-02-25 03:57:19.791976,2025-02-25 03:57:54.125473,34.333497
channel-6994,1324666,30301460,30301495,35,2025-02-25 03:57:33.439909,2025-02-25 03:58:22.707931,49.268022
channel-6994,1324667,30301477,30301491,14,2025-02-25 03:57:59.427560,2025-02-25 03:58:16.644013,17.216453
channel-6994,1324668,30301482,30301495,13,2025-02-25 03:58:06.463195,2025-02-25 03:58:22.707931,16.244736
channel-6994,1324669,30301521,30301531,10,2025-02-25 03:58:55.676568,2025-02-25 03:59:11.295121,15.618553
channel-6994,1324670,30301532,30301579,47,2025-02-25 03:59:12.419500,2025-02-25 04:00:12.298633,59.879133
channel-6994,1324671,30301551,30301570,19,2025-02-25 03:59:34.282649,2025-02-25 04:00:00.067770,25.785121
channel-6994,1324672,30301556,30301566,10,2025-02-25 03:59:41.215468,2025-02-25 03:59:53.750385,12.534917
channel-6994,1324673,30301585,30301598,13,2025-02-25 04:00:20.131538,2025-02-25 04:00:36.545563,16.414025
channel-6994,1324674,30301587,30301598,11,2025-02-25 04:00:22.282159,2025-02-25 04:00:36.545563,14.263404
channel-6994,1324675,30301601,30301628,27,2025-02-25 04:00:40.987578,2025-02-25 04:01:13.556953,32.569375
channel-6994,1324676,30301616,30301670,54,2025-02-25 04:00:58.554842,2025-02-25 04:02:06.095146,67.540304
channel-6994,1324677,30301635,30301656,21,2025-02-25 04:01:22.396282,2025-02-25 04:01:49.096102,26.69982
channel-6994,1324678,30301665,30301676,11,2025-02-25 04:02:00.218958,2025-02-25 04:02:12.977326,12.758368
channel-6994,1324679,30301677,30301703,26,2025-02-25 04:02:14.090590,2025-02-25 04:02:48.936984,34.846394
channel-6994,1324680,30301684,30301717,33,2025-02-25 04:02:23.005883,2025-02-25 04:03:06.920215,43.914332
channel-6994,1324681,30301691,30301742,51,2025-02-25 04:02:32.950796,2025-02-25 04:03:43.262529,70.311733
channel-6994,1324682,30301723,30301734,11,2025-02-25 04:03:13.886533,2025-02-25 04:03:31.668576,17.782043
channel-6994,1324683,30301725,30341221,39496,2025-02-25 04:03:16.667539,2025-02-25 18:28:58.757156,51942.089617
channel-6994,1324684,30301743,30301773,30,2025-02-25 04:03:45.595542,2025-02-25 04:04:21.306924,35.711382
channel-6994,1324685,30301754,30301812,58,2025-02-25 04:03:58.047492,2025-02-25 04:05:09.388242,71.34075
channel-6994,1324686,30301820,30301877,57,2025-02-25 04:05:20.960824,2025-02-25 04:06:32.094098,71.133274
channel-6994,1324687,30301842,30301852,10,2025-02-25 04:05:49.803877,2025-02-25 04:06:01.362158,11.558281
channel-6994,1324688,30301889,30301945,56,2025-02-25 04:06:47.312640,2025-02-25 04:08:01.390931,74.078291
channel-6994,1324689,30301896,30301909,13,2025-02-25 04:06:56.488970,2025-02-25 04:07:14.447226,17.958256
channel-6994,1324690,30301948,30302003,55,2025-02-25 04:08:08.894421,2025-02-25 04:09:16.644110,67.749689
channel-6994,1324691,30302009,30302031,22,2025-02-25 04:09:24.375761,2025-02-25 04:09:53.945493,29.569732
channel-6994,1324692,30302013,30302056,43,2025-02-25 04:09:29.879323,2025-02-25 04:10:24.099559,54.220236
channel-6994,1324693,30302048,30302060,12,2025-02-25 04:10:14.698197,2025-02-25 04:10:29.627867,14.92967
channel-6994,1324694,30302065,30302085,20,2025-02-25 04:10:35.776132,2025-02-25 04:11:01.072004,25.295872
channel-6994,1324695,30302090,30302104,14,2025-02-25 04:11:08.746071,2025-02-25 04:11:24.787245,16.041174
channel-6994,1324696,30302112,30302122,10,2025-02-25 04:11:34.304782,2025-02-25 04:11:48.341499,14.036717
channel-6994,1324697,30302118,30302139,21,2025-02-25 04:11:42.085468,2025-02-25 04:12:13.554551,31.469083
channel-6994,1324698,30302119,30302148,29,2025-02-25 04:11:43.328774,2025-02-25 04:12:23.832565,40.503791
channel-6994,1324699,30302120,30302190,70,2025-02-25 04:11:45.066491,2025-02-25 04:13:17.668277,92.601786
channel-6994,1324700,30302164,30302190,26,2025-02-25 04:12:43.597541,2025-02-25 04:13:17.668277,34.070736
channel-6994,1324701,30302172,30302220,48,2025-02-25 04:12:54.695823,2025-02-25 04:13:55.820057,61.124234
channel-6994,1324702,30302226,30302266,40,2025-02-25 04:14:04.515356,2025-02-25 04:14:55.560126,51.04477
channel-6994,1324703,30302230,30302349,119,2025-02-25 04:14:10.007402,2025-02-25 04:16:41.436245,151.428843
channel-6994,1324705,30302361,30302409,48,2025-02-25 04:16:59.787066,2025-02-25 04:17:59.568827,59.781761
channel-6994,1324706,30302400,30302414,14,2025-02-25 04:17:49.238403,2025-02-25 04:18:05.495837,16.257434
channel-6994,1324707,30302423,30302471,48,2025-02-25 04:18:17.540681,2025-02-25 04:19:18.130998,60.590317
channel-6994,1324708,30302484,30302527,43,2025-02-25 04:19:34.064612,2025-02-25 04:20:30.060458,55.995846
channel-6994,1324709,30302518,30302531,13,2025-02-25 04:20:19.855532,2025-02-25 04:20:35.037409,15.181877
channel-6994,1324710,30302541,30302600,59,2025-02-25 04:20:48.239340,2025-02-25 04:22:05.377665,77.138325
channel-6994,1324711,30302591,30302606,15,2025-02-25 04:21:55.031450,2025-02-25 04:22:11.994920,16.96347
channel-6994,1324712,30302606,30302616,10,2025-02-25 04:22:11.994920,2025-02-25 04:22:31.634210,19.63929
channel-6994,1324713,30302623,30302636,13,2025-02-25 04:22:39.613502,2025-02-25 04:22:55.586011,15.972509
channel-6994,1324714,30302657,30302666,9,2025-02-25 04:23:20.680673,2025-02-25 04:23:32.666477,11.985804
channel-6994,1324715,30302906,30302920,14,2025-02-25 04:28:44.688420,2025-02-25 04:29:00.968153,16.279733
channel-6994,1324716,30302908,30302920,12,2025-02-25 04:28:46.838682,2025-02-25 04:29:00.968153,14.129471
channel-6994,1324717,30302953,30302964,11,2025-02-25 04:29:43.028080,2025-02-25 04:29:55.733474,12.705394
channel-6994,1324718,30303008,30303044,36,2025-02-25 04:30:55.035601,2025-02-25 04:31:44.013822,48.978221
channel-6994,1324719,30303068,30303092,24,2025-02-25 04:32:12.483330,2025-02-25 04:32:45.748983,33.265653
channel-6994,1324720,30303070,30303114,44,2025-02-25 04:32:15.838986,2025-02-25 04:33:12.966939,57.127953
channel-6994,1324721,30303103,30303114,11,2025-02-25 04:32:59.938742,2025-02-25 04:33:12.966939,13.028197
channel-6994,1324722,30303134,30303193,59,2025-02-25 04:33:37.602615,2025-02-25 04:34:54.133609,76.530994
channel-6994,1324723,30303160,30303172,12,2025-02-25 04:34:11.380145,2025-02-25 04:34:25.316702,13.936557
channel-6994,1324724,30303198,30303241,43,2025-02-25 04:35:02.034115,2025-02-25 04:35:55.906086,53.871971
channel-6994,1324725,30303218,30303231,13,2025-02-25 04:35:28.120155,2025-02-25 04:35:43.597304,15.477149
channel-6994,1324726,30303267,30303313,46,2025-02-25 04:36:27.587989,2025-02-25 04:37:28.496224,60.908235
channel-6994,1324727,30303315,30303326,11,2025-02-25 04:37:30.744410,2025-02-25 04:37:45.457343,14.712933
channel-6994,1324728,30303325,30303336,11,2025-02-25 04:37:44.279393,2025-02-25 04:37:58.135919,13.856526
channel-6994,1324729,30303328,30303351,23,2025-02-25 04:37:47.798988,2025-02-25 04:38:18.239312,30.440324
channel-6994,1324730,30303339,30303380,41,2025-02-25 04:38:01.442692,2025-02-25 04:38:53.186940,51.744248
channel-6994,1324731,30303365,30303374,9,2025-02-25 04:38:35.653612,2025-02-25 04:38:46.641962,10.98835
channel-6994,1324732,30303406,30303453,47,2025-02-25 04:39:31.513323,2025-02-25 04:40:29.860969,58.347646
channel-6994,1324733,30303475,30303518,43,2025-02-25 04:40:58.584066,2025-02-25 04:41:53.728868,55.144802
channel-6994,1324734,30303535,30303573,38,2025-02-25 04:42:16.014703,2025-02-25 04:43:03.393099,47.378396
channel-6994,1324735,30303536,30303550,14,2025-02-25 04:42:17.203139,2025-02-25 04:42:34.029958,16.826819
channel-6994,1324736,30303538,30303550,12,2025-02-25 04:42:20.004114,2025-02-25 04:42:34.029958,14.025844
channel-6994,1324737,30303677,30303688,11,2025-02-25 04:45:18.471862,2025-02-25 04:45:32.288441,13.816579
channel-6994,1324738,30303727,30303763,36,2025-02-25 04:46:19.744889,2025-02-25 04:47:08.507133,48.762244
channel-6994,1324739,30303776,30303787,11,2025-02-25 04:47:23.756748,2025-02-25 04:47:37.951379,14.194631
channel-6994,1324740,30303778,30303792,14,2025-02-25 04:47:27.295385,2025-02-25 04:47:43.747325,16.45194
channel-6994,1324741,30303793,30303836,43,2025-02-25 04:47:44.791354,2025-02-25 04:48:44.102082,59.310728
channel-6994,1324742,30303796,30303811,15,2025-02-25 04:47:48.503088,2025-02-25 04:48:07.748052,19.244964
channel-6994,1324743,30303857,30303902,45,2025-02-25 04:49:09.884044,2025-02-25 04:50:07.506710,57.622666
channel-6994,1324744,30303968,30303982,14,2025-02-25 04:51:33.115986,2025-02-25 04:51:50.626769,17.510783
channel-6994,1324745,30303982,30303991,9,2025-02-25 04:51:50.626769,2025-02-25 04:52:01.173185,10.546416
channel-6994,1324746,30304119,30304135,16,2025-02-25 04:54:48.342736,2025-02-25 04:55:06.975550,18.632814
channel-6994,1324747,30304149,30304159,10,2025-02-25 04:55:24.250902,2025-02-25 04:55:37.829017,13.578115
channel-6994,1324748,30304174,30304188,14,2025-02-25 04:55:59.430355,2025-02-25 04:56:15.256066,15.825711
channel-6994,1324749,30304193,30304204,11,2025-02-25 04:56:20.605605,2025-02-25 04:56:34.977569,14.371964
channel-6994,1324750,30304211,30304225,14,2025-02-25 04:56:43.063094,2025-02-25 04:57:01.212329,18.149235
channel-6994,1324751,30304290,30304322,32,2025-02-25 04:58:27.764185,2025-02-25 04:59:09.888905,42.12472
channel-6994,1324752,30304290,30304303,13,2025-02-25 04:58:27.764185,2025-02-25 04:58:45.473102,17.708917
channel-6994,1324753,30304358,30304383,25,2025-02-25 04:59:55.410727,2025-02-25 05:00:28.168030,32.757303
channel-6994,1324754,30304373,30304411,38,2025-02-25 05:00:15.574477,2025-02-25 05:01:04.763424,49.188947
channel-6994,1324755,30304418,30304428,10,2025-02-25 05:01:12.894564,2025-02-25 05:01:30.167245,17.272681
channel-6994,1324756,30304430,30304472,42,2025-02-25 05:01:32.442834,2025-02-25 05:02:24.507862,52.065028
channel-6994,1324757,30304493,30304530,37,2025-02-25 05:02:49.724049,2025-02-25 05:03:41.715915,51.991866
channel-6994,1324758,30304553,30304598,45,2025-02-25 05:04:10.152082,2025-02-25 05:05:06.212814,56.060732
channel-6994,1324759,30304574,30304589,15,2025-02-25 05:04:35.799318,2025-02-25 05:04:54.233454,18.434136
channel-6994,1324760,30304582,30304594,12,2025-02-25 05:04:45.283859,2025-02-25 05:05:00.579323,15.295464
channel-6994,1324761,30304624,30304634,10,2025-02-25 05:05:38.419656,2025-02-25 05:05:51.004375,12.584719
channel-6994,1324762,30304645,30304654,9,2025-02-25 05:06:09.621942,2025-02-25 05:06:21.116828,11.494886
channel-6994,1324763,30304707,30304717,10,2025-02-25 05:07:29.790006,2025-02-25 05:07:42.078449,12.288443
channel-6994,1324764,30304713,30304726,13,2025-02-25 05:07:36.421086,2025-02-25 05:07:53.994838,17.573752
channel-6994,1324765,30304807,30304819,12,2025-02-25 05:09:37.119617,2025-02-25 05:09:52.112594,14.992977
channel-6994,1324766,30304842,30304852,10,2025-02-25 05:10:21.451498,2025-02-25 05:10:37.002634,15.551136
channel-6994,1324767,30304892,30304902,10,2025-02-25 05:11:28.801286,2025-02-25 05:11:40.820903,12.019617
channel-6994,1324768,30305004,30305011,7,2025-02-25 05:13:51.583582,2025-02-25 05:14:01.753868,10.170286
channel-6994,1324769,30305147,30305157,10,2025-02-25 05:17:04.901277,2025-02-25 05:17:17.904912,13.003635
channel-6994,1324770,30305177,30305187,10,2025-02-25 05:17:41.896240,2025-02-25 05:17:54.363696,12.467456
channel-6994,1324771,30305277,30305288,11,2025-02-25 05:19:53.749111,2025-02-25 05:20:06.740833,12.991722
channel-6994,1324772,30305361,30305373,12,2025-02-25 05:21:43.998716,2025-02-25 05:21:59.925993,15.927277
channel-6994,1324773,30305554,30305567,13,2025-02-25 05:25:53.086169,2025-02-25 05:26:11.880186,18.794017
channel-6994,1324774,30305612,30305626,14,2025-02-25 05:27:08.111564,2025-02-25 05:27:25.889775,17.778211
channel-6994,1324775,30305699,30305712,13,2025-02-25 05:29:00.081898,2025-02-25 05:29:17.530207,17.448309
channel-6994,1324776,30305739,30305749,10,2025-02-25 05:29:51.644974,2025-02-25 05:30:03.353541,11.708567
channel-6994,1324777,30305763,30305773,10,2025-02-25 05:30:22.239171,2025-02-25 05:30:37.149822,14.910651
channel-6994,1324778,30305798,30305807,9,2025-02-25 05:31:09.221836,2025-02-25 05:31:20.993254,11.771418
channel-6994,1324779,30305865,30305878,13,2025-02-25 05:32:34.287488,2025-02-25 05:32:49.185002,14.897514
channel-6994,1324780,30306090,30306098,8,2025-02-25 05:37:22.808923,2025-02-25 05:37:34.312939,11.504016
channel-6994,1324781,30306130,30306140,10,2025-02-25 05:38:16.676342,2025-02-25 05:38:28.850753,12.174411
channel-6994,1324782,30306232,30306243,11,2025-02-25 05:40:23.564665,2025-02-25 05:40:38.041503,14.476838
channel-6994,1324783,30306249,30306261,12,2025-02-25 05:40:48.831190,2025-02-25 05:41:02.314331,13.483141
channel-6994,1324784,30306432,30306442,10,2025-02-25 05:44:44.244121,2025-02-25 05:44:59.740590,15.496469
channel-6994,1324785,30306475,30306485,10,2025-02-25 05:45:40.293381,2025-02-25 05:45:53.007101,12.71372
channel-6994,1324786,30306522,30306532,10,2025-02-25 05:46:43.859288,2025-02-25 05:46:57.282865,13.423577
channel-6994,1324787,30306528,30306541,13,2025-02-25 05:46:51.549602,2025-02-25 05:47:08.029470,16.479868
channel-6994,1324788,30306618,30306627,9,2025-02-25 05:48:45.197270,2025-02-25 05:48:57.273391,12.076121
channel-6994,1324789,30306647,30306661,14,2025-02-25 05:49:23.460134,2025-02-25 05:49:40.796437,17.336303
channel-6994,1324790,30306750,30306763,13,2025-02-25 05:51:38.774639,2025-02-25 05:51:57.379749,18.60511
channel-6994,1324791,30306903,30306913,10,2025-02-25 05:54:54.688931,2025-02-25 05:55:06.726379,12.037448
channel-6994,1324792,30307047,30307058,11,2025-02-25 05:58:05.057776,2025-02-25 05:58:18.892542,13.834766
channel-6994,1324793,30307054,30307062,8,2025-02-25 05:58:13.218472,2025-02-25 05:58:24.894222,11.67575
channel-6994,1324794,30307124,30307134,10,2025-02-25 05:59:46.760578,2025-02-25 05:59:58.825875,12.065297
channel-6994,1324795,30307136,30307145,9,2025-02-25 06:00:02.170190,2025-02-25 06:00:17.310505,15.140315
channel-6994,1324796,30307201,30307216,15,2025-02-25 06:01:30.684787,2025-02-25 06:01:49.991074,19.306287
channel-6994,1324797,30307219,30307229,10,2025-02-25 06:01:53.572361,2025-02-25 06:02:06.423666,12.851305
channel-6994,1324798,30307302,30307313,11,2025-02-25 06:03:41.410874,2025-02-25 06:03:56.180115,14.769241
channel-6994,1324799,30307326,30307337,11,2025-02-25 06:04:11.164457,2025-02-25 06:04:26.805593,15.641136
channel-6994,1324800,30307364,30307373,9,2025-02-25 06:05:03.535014,2025-02-25 06:05:16.930143,13.395129
channel-6994,1324801,30307368,30307378,10,2025-02-25 06:05:08.664969,2025-02-25 06:05:22.636723,13.971754
channel-6994,1324802,30307381,30307392,11,2025-02-25 06:05:27.153136,2025-02-25 06:05:40.837117,13.683981
channel-6994,1324803,30307400,30307416,16,2025-02-25 06:05:51.913123,2025-02-25 06:06:12.741962,20.828839
channel-6994,1324804,30307416,30307450,34,2025-02-25 06:06:12.741962,2025-02-25 06:06:53.129916,40.387954
channel-6994,1324805,30307430,30307442,12,2025-02-25 06:06:28.855755,2025-02-25 06:06:42.589952,13.734197
channel-6994,1324806,30307571,30307583,12,2025-02-25 06:09:30.566398,2025-02-25 06:09:45.779194,15.212796
channel-6994,1324807,30307586,30307598,12,2025-02-25 06:09:49.150048,2025-02-25 06:10:06.110426,16.960378
channel-6994,1324808,30307650,30307702,52,2025-02-25 06:11:13.532195,2025-02-25 06:12:17.207313,63.675118
channel-6994,1324809,30307678,30307689,11,2025-02-25 06:11:45.946702,2025-02-25 06:12:00.949237,15.002535
channel-6994,1324810,30307722,30307761,39,2025-02-25 06:12:46.724658,2025-02-25 06:13:41.570643,54.845985
channel-6994,1324811,30307875,30307890,15,2025-02-25 06:16:07.107078,2025-02-25 06:16:25.238025,18.130947
channel-6994,1324812,30307882,30307924,42,2025-02-25 06:16:16.160314,2025-02-25 06:17:08.886140,52.725826
channel-6994,1324813,30307949,30307985,36,2025-02-25 06:17:40.667231,2025-02-25 06:18:30.540378,49.873147
channel-6994,1324814,30307980,30307990,10,2025-02-25 06:18:23.511943,2025-02-25 06:18:36.344608,12.832665
channel-6994,1324815,30307981,30308011,30,2025-02-25 06:18:25.828307,2025-02-25 06:19:01.374702,35.546395
channel-6994,1324816,30308042,30308057,15,2025-02-25 06:19:41.063290,2025-02-25 06:19:59.625882,18.562592
channel-6994,1324817,30308074,30308085,11,2025-02-25 06:20:21.604647,2025-02-25 06:20:36.507642,14.902995
channel-6994,1324818,30308121,30308133,12,2025-02-25 06:21:20.532484,2025-02-25 06:21:36.287945,15.755461
channel-6994,1324819,30308127,30308137,10,2025-02-25 06:21:29.469181,2025-02-25 06:21:41.764315,12.295134
channel-6994,1324820,30308175,30308187,12,2025-02-25 06:22:30.009253,2025-02-25 06:22:48.787378,18.778125
channel-6994,1324821,30308197,30308209,12,2025-02-25 06:23:00.567780,2025-02-25 06:23:15.584494,15.016714
channel-6994,1324822,30308227,30308238,11,2025-02-25 06:23:37.890838,2025-02-25 06:23:50.830962,12.940124
channel-6994,1324823,30308383,30308390,7,2025-02-25 06:26:57.378451,2025-02-25 06:27:09.504253,12.125802
channel-6994,1324824,30308395,30308445,50,2025-02-25 06:27:16.047066,2025-02-25 06:28:18.595533,62.548467
channel-6994,1324825,30308425,30308445,20,2025-02-25 06:27:55.338842,2025-02-25 06:28:18.595533,23.256691
channel-6994,1324826,30308426,30308445,19,2025-02-25 06:27:56.571177,2025-02-25 06:28:18.595533,22.024356
channel-6994,1324827,30308460,30308500,40,2025-02-25 06:28:37.536751,2025-02-25 06:29:29.094198,51.557447
channel-6994,1324828,30308549,30308591,42,2025-02-25 06:30:33.448835,2025-02-25 06:31:33.227409,59.778574
channel-6994,1324829,30308595,30308608,13,2025-02-25 06:31:38.854324,2025-02-25 06:31:54.212731,15.358407
channel-6994,1324830,30308641,30308682,41,2025-02-25 06:32:34.180659,2025-02-25 06:33:27.156881,52.976222
channel-6994,1324831,30308657,30308667,10,2025-02-25 06:32:55.450874,2025-02-25 06:33:08.437227,12.986353
channel-6994,1324832,30308702,30308726,24,2025-02-25 06:33:50.461954,2025-02-25 06:34:22.221490,31.759536
channel-6994,1324833,30308708,30308751,43,2025-02-25 06:33:59.689622,2025-02-25 06:34:53.305162,53.61554
channel-6994,1324834,30308738,30308751,13,2025-02-25 06:34:38.406267,2025-02-25 06:34:53.305162,14.898895
channel-6994,1324835,30308773,30308811,38,2025-02-25 06:35:23.805277,2025-02-25 06:36:15.125701,51.320424
channel-6994,1324836,30308790,30308800,10,2025-02-25 06:35:46.147724,2025-02-25 06:35:57.417788,11.270064
channel-6994,1324837,30308800,30308807,7,2025-02-25 06:35:57.417788,2025-02-25 06:36:09.809472,12.391684
channel-6994,1324838,30308831,30308872,41,2025-02-25 06:36:40.000823,2025-02-25 06:37:33.335868,53.335045
channel-6994,1324839,30308877,30308888,11,2025-02-25 06:37:40.118335,2025-02-25 06:37:54.367480,14.249145
channel-6994,1324840,30308898,30308950,52,2025-02-25 06:38:08.115704,2025-02-25 06:39:15.315737,67.200033
channel-6994,1324841,30308903,30308959,56,2025-02-25 06:38:14.913132,2025-02-25 06:39:26.592877,71.679745
channel-6994,1324842,30309037,30309062,25,2025-02-25 06:41:07.885791,2025-02-25 06:41:39.826420,31.940629
channel-6994,1324843,30309181,30309190,9,2025-02-25 06:44:10.785996,2025-02-25 06:44:23.715927,12.929931
channel-6994,1324844,30309272,30309284,12,2025-02-25 06:46:12.722306,2025-02-25 06:46:28.329999,15.607693
channel-6994,1324845,30309291,30309301,10,2025-02-25 06:46:38.004239,2025-02-25 06:46:49.998733,11.994494
channel-6994,1324846,30309330,30309341,11,2025-02-25 06:47:26.349089,2025-02-25 06:47:42.044383,15.695294
channel-6994,1324847,30309350,30309362,12,2025-02-25 06:47:52.439640,2025-02-25 06:48:07.831243,15.391603
channel-6994,1324848,30309416,30309425,9,2025-02-25 06:49:17.371870,2025-02-25 06:49:30.827314,13.455444
channel-6994,1324849,30309420,30309429,9,2025-02-25 06:49:21.913106,2025-02-25 06:49:36.499365,14.586259
channel-6994,1324850,30309441,30309456,15,2025-02-25 06:49:51.637292,2025-02-25 06:50:14.098532,22.46124
channel-6994,1324851,30309450,30309460,10,2025-02-25 06:50:06.145597,2025-02-25 06:50:18.808712,12.663115
channel-6994,1324852,30309517,30309527,10,2025-02-25 06:51:30.586974,2025-02-25 06:51:43.068089,12.481115
channel-6994,1324853,30309548,30309562,14,2025-02-25 06:52:10.399206,2025-02-25 06:52:26.308362,15.909156
channel-6994,1324854,30309597,30309610,13,2025-02-25 06:53:12.834241,2025-02-25 06:53:28.245010,15.410769
channel-6994,1324855,30309639,30309648,9,2025-02-25 06:54:08.091822,2025-02-25 06:54:21.799129,13.707307
channel-6994,1324856,30309671,30309681,10,2025-02-25 06:54:51.863004,2025-02-25 06:55:04.064523,12.201519
channel-6994,1324857,30309736,30309748,12,2025-02-25 06:56:11.307479,2025-02-25 06:56:28.350239,17.04276
channel-6994,1324858,30309819,30309831,12,2025-02-25 06:57:59.485144,2025-02-25 06:58:13.677715,14.192571
channel-6994,1324859,30309832,30309844,12,2025-02-25 06:58:14.792728,2025-02-25 06:58:29.629084,14.836356
channel-6994,1324860,30309851,30309890,39,2025-02-25 06:58:41.558919,2025-02-25 06:59:33.019769,51.46085
channel-6994,1324861,30309860,30309871,11,2025-02-25 06:58:52.683557,2025-02-25 06:59:08.868108,16.184551
channel-6994,1324862,30309861,30309886,25,2025-02-25 06:58:53.788800,2025-02-25 06:59:28.544201,34.755401
channel-6994,1324863,30309873,30309886,13,2025-02-25 06:59:11.940148,2025-02-25 06:59:28.544201,16.604053
channel-6994,1324864,30309890,30309912,22,2025-02-25 06:59:33.019769,2025-02-25 07:00:00.558928,27.539159
channel-6994,1324865,30309894,30309923,29,2025-02-25 06:59:37.706972,2025-02-25 07:00:14.605722,36.89875
channel-6994,1324866,30309915,30309979,64,2025-02-25 07:00:04.093058,2025-02-25 07:01:29.395474,85.302416
channel-6994,1324867,30309944,30309955,11,2025-02-25 07:00:41.841079,2025-02-25 07:00:56.292742,14.451663
channel-6994,1324868,30309949,30310005,56,2025-02-25 07:00:47.507331,2025-02-25 07:02:01.220797,73.713466
channel-6994,1324869,30309952,30309979,27,2025-02-25 07:00:50.854437,2025-02-25 07:01:29.395474,38.541037
channel-6994,1324870,30309953,30309979,26,2025-02-25 07:00:52.977194,2025-02-25 07:01:29.395474,36.41828
channel-6994,1324871,30309970,30309984,14,2025-02-25 07:01:17.453091,2025-02-25 07:01:35.440204,17.987113
channel-6994,1324873,30310010,30310041,31,2025-02-25 07:02:09.003671,2025-02-25 07:02:46.790434,37.786763
channel-6994,1324874,30310010,30310024,14,2025-02-25 07:02:09.003671,2025-02-25 07:02:26.375753,17.372082
channel-6994,1324875,30310032,30310057,25,2025-02-25 07:02:35.933229,2025-02-25 07:03:08.423772,32.490543
channel-6994,1324876,30310050,30310074,24,2025-02-25 07:03:00.489966,2025-02-25 07:03:35.208571,34.718605
channel-6994,1324877,30310053,30310119,66,2025-02-25 07:03:03.875649,2025-02-25 07:04:31.399381,87.523732
channel-6994,1324878,30310056,30310065,9,2025-02-25 07:03:07.285183,2025-02-25 07:03:23.212313,15.92713
channel-6994,1324879,30310067,30310095,28,2025-02-25 07:03:25.505681,2025-02-25 07:04:01.043738,35.538057
channel-6994,1324880,30310069,30310088,19,2025-02-25 07:03:28.016505,2025-02-25 07:03:53.016827,25.000322
channel-6994,1324881,30310072,30310100,28,2025-02-25 07:03:32.913028,2025-02-25 07:04:06.835575,33.922547
channel-6994,1324882,30310072,30310100,28,2025-02-25 07:03:32.913028,2025-02-25 07:04:06.835575,33.922547
channel-6994,1324883,30310102,30310114,12,2025-02-25 07:04:09.631963,2025-02-25 07:04:25.625368,15.993405
channel-6994,1324884,30310109,30310119,10,2025-02-25 07:04:19.846218,2025-02-25 07:04:31.399381,11.553163
channel-6994,1324885,30310114,30310142,28,2025-02-25 07:04:25.625368,2025-02-25 07:05:01.624351,35.998983
channel-6994,1324886,30310119,30310175,56,2025-02-25 07:04:31.399381,2025-02-25 07:05:44.080413,72.681032
channel-6994,1324887,30310133,30310146,13,2025-02-25 07:04:50.508250,2025-02-25 07:05:07.748036,17.239786
channel-6994,1324888,30310135,30310149,14,2025-02-25 07:04:52.946619,2025-02-25 07:05:12.857147,19.910528
channel-6994,1324889,30310158,30310184,26,2025-02-25 07:05:24.326565,2025-02-25 07:05:55.853555,31.52699
channel-6994,1324890,30310193,30310246,53,2025-02-25 07:06:05.959780,2025-02-25 07:07:19.103906,73.144126
channel-6994,1324891,30310197,30310205,8,2025-02-25 07:06:10.885655,2025-02-25 07:06:22.176896,11.291241
channel-6994,1324892,30310197,30310229,32,2025-02-25 07:06:10.885655,2025-02-25 07:06:55.134719,44.249064
channel-6994,1324893,30310236,30341221,30985,2025-02-25 07:07:05.894832,2025-02-25 18:28:58.757156,40912.862324
channel-6994,1324894,30310247,30310271,24,2025-02-25 07:07:20.335230,2025-02-25 07:07:54.987375,34.652145
channel-6994,1324895,30310249,30310275,26,2025-02-25 07:07:22.675950,2025-02-25 07:08:00.712631,38.036681
channel-6994,1324897,30310293,30310304,11,2025-02-25 07:08:22.528823,2025-02-25 07:08:38.218317,15.689494
channel-6994,1324898,30310332,30310378,46,2025-02-25 07:09:15.758774,2025-02-25 07:10:11.353478,55.594704
channel-6994,1324899,30310353,30310362,9,2025-02-25 07:09:41.634099,2025-02-25 07:09:52.098818,10.464719
channel-6994,1324900,30310405,30310444,39,2025-02-25 07:10:47.064934,2025-02-25 07:11:39.931277,52.866343
channel-6994,1324901,30310419,30310431,12,2025-02-25 07:11:07.247244,2025-02-25 07:11:22.753827,15.506583
channel-6994,1324902,30310431,30310444,13,2025-02-25 07:11:22.753827,2025-02-25 07:11:39.931277,17.17745
channel-6994,1324903,30310444,30310458,14,2025-02-25 07:11:39.931277,2025-02-25 07:11:58.413138,18.481861
channel-6994,1324904,30310449,30310477,28,2025-02-25 07:11:46.881082,2025-02-25 07:12:24.083807,37.202725
channel-6994,1324906,30310480,30310491,11,2025-02-25 07:12:27.795018,2025-02-25 07:12:42.022532,14.227514
channel-6994,1324907,30310487,30310495,8,2025-02-25 07:12:35.809500,2025-02-25 07:12:48.217421,12.407921
channel-6994,1324908,30310490,30310512,22,2025-02-25 07:12:39.342514,2025-02-25 07:13:09.203576,29.861062
channel-6994,1324909,30310523,30310546,23,2025-02-25 07:13:22.837689,2025-02-25 07:13:53.131788,30.294099
channel-6994,1324910,30310536,30310602,66,2025-02-25 07:13:38.417407,2025-02-25 07:15:05.090735,86.673328
channel-6994,1324911,30310543,30310558,15,2025-02-25 07:13:49.534915,2025-02-25 07:14:06.733283,17.198368
channel-6994,1324912,30310555,30310570,15,2025-02-25 07:14:03.281531,2025-02-25 07:14:21.268174,17.986643
channel-6994,1324913,30310579,30310592,13,2025-02-25 07:14:34.507442,2025-02-25 07:14:51.839390,17.331948
channel-6994,1324914,30310609,30310622,13,2025-02-25 07:15:14.525681,2025-02-25 07:15:29.726381,15.2007
channel-6994,1324915,30310618,30310631,13,2025-02-25 07:15:24.703932,2025-02-25 07:15:40.573618,15.869686
channel-6994,1324916,30310618,30310670,52,2025-02-25 07:15:24.703932,2025-02-25 07:16:31.357926,66.653994
channel-6994,1324917,30310647,30310661,14,2025-02-25 07:16:01.213162,2025-02-25 07:16:19.377701,18.164539
channel-6994,1324918,30310675,30310687,12,2025-02-25 07:16:41.456941,2025-02-25 07:16:58.117110,16.660169
channel-6994,1324919,30310764,30310776,12,2025-02-25 07:18:37.759537,2025-02-25 07:18:53.753229,15.993692
channel-6994,1324920,30310798,30310811,13,2025-02-25 07:19:21.298215,2025-02-25 07:19:37.068964,15.770749
channel-6994,1324921,30310945,30310956,11,2025-02-25 07:22:34.557451,2025-02-25 07:22:47.138780,12.581329
channel-6994,1324922,30310960,30310971,11,2025-02-25 07:22:53.250301,2025-02-25 07:23:06.366833,13.116532
channel-6994,1324923,30311044,30311067,23,2025-02-25 07:24:40.083469,2025-02-25 07:25:11.931069,31.8476
channel-6994,1324924,30311044,30311055,11,2025-02-25 07:24:40.083469,2025-02-25 07:24:52.771403,12.687934
channel-6994,1324925,30311054,30311096,42,2025-02-25 07:24:51.751545,2025-02-25 07:25:56.291971,64.540426
channel-6994,1324926,30311061,30311072,11,2025-02-25 07:25:04.462832,2025-02-25 07:25:17.817908,13.355076
channel-6994,1324927,30311080,30311091,11,2025-02-25 07:25:30.590398,2025-02-25 07:25:49.699421,19.109023
channel-6994,1324928,30311084,30311096,12,2025-02-25 07:25:39.437997,2025-02-25 07:25:56.291971,16.853974
channel-6994,1324930,30311133,30311146,13,2025-02-25 07:26:44.514835,2025-02-25 07:27:00.580808,16.065973
channel-6994,1324931,30311147,30311159,12,2025-02-25 07:27:02.691265,2025-02-25 07:27:17.116997,14.425732
channel-6994,1324932,30311162,30311176,14,2025-02-25 07:27:20.606326,2025-02-25 07:27:37.690342,17.084016
channel-6994,1324933,30311188,30311242,54,2025-02-25 07:27:53.027395,2025-02-25 07:29:05.625145,72.59775
channel-6994,1324934,30311201,30311214,13,2025-02-25 07:28:09.526378,2025-02-25 07:28:28.134982,18.608604
channel-6994,1324935,30311227,30311242,15,2025-02-25 07:28:47.428599,2025-02-25 07:29:05.625145,18.196546
channel-6994,1324936,30311292,30311337,45,2025-02-25 07:30:09.234750,2025-02-25 07:31:08.596530,59.36178
channel-6994,1324937,30311340,30311352,12,2025-02-25 07:31:11.926438,2025-02-25 07:31:26.185254,14.258816
channel-6994,1324938,30311369,30311383,14,2025-02-25 07:31:52.428617,2025-02-25 07:32:09.962915,17.534298
channel-6994,1324939,30311370,30311383,13,2025-02-25 07:31:53.573895,2025-02-25 07:32:09.962915,16.38902
channel-6994,1324940,30311385,30311401,16,2025-02-25 07:32:12.533833,2025-02-25 07:32:32.428578,19.894745
channel-6994,1324941,30311419,30311431,12,2025-02-25 07:32:56.022403,2025-02-25 07:33:10.233727,14.211324
channel-6994,1324942,30311428,30311478,50,2025-02-25 07:33:06.612951,2025-02-25 07:34:11.661489,65.048538
channel-6994,1324943,30311441,30311468,27,2025-02-25 07:33:22.745503,2025-02-25 07:34:00.284681,37.539178
channel-6994,1324944,30311455,30311464,9,2025-02-25 07:33:40.771219,2025-02-25 07:33:54.557804,13.786585
channel-6994,1324945,30311457,30311469,12,2025-02-25 07:33:44.133860,2025-02-25 07:34:01.497711,17.363851
channel-6994,1324946,30311500,30311566,66,2025-02-25 07:34:38.702971,2025-02-25 07:36:09.103124,90.400153
channel-6994,1324947,30311551,30311582,31,2025-02-25 07:35:47.964897,2025-02-25 07:36:28.535436,40.570539
channel-6994,1324948,30311568,30311582,14,2025-02-25 07:36:11.864764,2025-02-25 07:36:28.535436,16.670672
channel-6994,1324949,30311577,30311592,15,2025-02-25 07:36:22.083183,2025-02-25 07:36:41.886055,19.802872
channel-6994,1324950,30311587,30311597,10,2025-02-25 07:36:36.286141,2025-02-25 07:36:48.036585,11.750444
channel-6994,1324951,30311628,30311659,31,2025-02-25 07:37:29.951114,2025-02-25 07:38:09.232968,39.281854
channel-6994,1324952,30311638,30311693,55,2025-02-25 07:37:41.370088,2025-02-25 07:38:52.414920,71.044832
channel-6994,1324953,30311655,30311683,28,2025-02-25 07:38:04.180288,2025-02-25 07:38:40.562456,36.382168
channel-6994,1324954,30311751,30311766,15,2025-02-25 07:40:15.029494,2025-02-25 07:40:32.530295,17.500801
channel-6994,1324955,30311756,30311771,15,2025-02-25 07:40:20.680408,2025-02-25 07:40:39.413690,18.733282
channel-6994,1324956,30311818,30311849,31,2025-02-25 07:41:41.116625,2025-02-25 07:42:24.389813,43.273188
channel-6994,1324957,30311833,30311844,11,2025-02-25 07:42:02.233267,2025-02-25 07:42:16.828928,14.595661
channel-6994,1324958,30311871,30311897,26,2025-02-25 07:42:49.590333,2025-02-25 07:43:26.142196,36.551863
channel-6994,1324959,30311907,30311918,11,2025-02-25 07:43:38.504867,2025-02-25 07:43:51.178125,12.673258
channel-6994,1324960,30311935,30311943,8,2025-02-25 07:44:13.902618,2025-02-25 07:44:24.995983,11.093365
channel-6994,1324961,30312001,30312013,12,2025-02-25 07:45:41.141521,2025-02-25 07:45:56.264209,15.122688
channel-6994,1324962,30312011,30312022,11,2025-02-25 07:45:53.924741,2025-02-25 07:46:07.653627,13.728886
channel-6994,1324963,30312082,30312094,12,2025-02-25 07:47:28.741906,2025-02-25 07:47:44.144415,15.402509
channel-6994,1324964,30312122,30312148,26,2025-02-25 07:48:17.617705,2025-02-25 07:48:57.742301,40.124596
channel-6994,1324965,30312162,30312173,11,2025-02-25 07:49:16.141893,2025-02-25 07:49:29.747573,13.60568
channel-6994,1324966,30312292,30312303,11,2025-02-25 07:52:04.960036,2025-02-25 07:52:18.910184,13.950148
channel-6994,1324967,30312322,30312335,13,2025-02-25 07:52:46.442520,2025-02-25 07:53:04.704053,18.261533
channel-6994,1324968,30312416,30312427,11,2025-02-25 07:54:51.012132,2025-02-25 07:55:04.953147,13.941015
channel-6994,1324969,30312528,30312539,11,2025-02-25 07:57:14.534987,2025-02-25 07:57:27.145393,12.610406
channel-6994,1324970,30312542,30312559,17,2025-02-25 07:57:32.104228,2025-02-25 07:57:54.778101,22.673873
channel-6994,1324971,30312563,30312572,9,2025-02-25 07:58:00.328269,2025-02-25 07:58:12.468598,12.140329
channel-6994,1324972,30312565,30312578,13,2025-02-25 07:58:02.745929,2025-02-25 07:58:21.341007,18.595078
channel-6994,1324973,30312673,30312702,29,2025-02-25 08:00:23.594313,2025-02-25 08:00:58.732098,35.137785
channel-6994,1324974,30312706,30312731,25,2025-02-25 08:01:03.229932,2025-02-25 08:01:37.232098,34.002166
channel-6994,1324975,30312735,30312744,9,2025-02-25 08:01:41.713808,2025-02-25 08:01:57.340611,15.626803
channel-6994,1324976,30312820,30312830,10,2025-02-25 08:03:38.684462,2025-02-25 08:03:51.011367,12.326905
channel-6994,1324977,30312882,30312894,12,2025-02-25 08:05:01.798859,2025-02-25 08:05:17.157968,15.359109
channel-6994,1324978,30312887,30312899,12,2025-02-25 08:05:07.871743,2025-02-25 08:05:22.795061,14.923318
channel-6994,1324979,30312914,30312928,14,2025-02-25 08:05:43.584529,2025-02-25 08:06:02.110633,18.526104
channel-6994,1324980,30312969,30312982,13,2025-02-25 08:06:55.775757,2025-02-25 08:07:12.159766,16.384009
channel-6994,1324981,30312990,30313001,11,2025-02-25 08:07:21.679960,2025-02-25 08:07:35.089708,13.409748
channel-6994,1324982,30313011,30313022,11,2025-02-25 08:07:49.836793,2025-02-25 08:08:02.493966,12.657173
channel-6994,1324983,30313089,30313104,15,2025-02-25 08:09:27.758505,2025-02-25 08:09:49.881424,22.122919
channel-6994,1324984,30313111,30313123,12,2025-02-25 08:10:00.378575,2025-02-25 08:10:15.282028,14.903453
channel-6994,1324985,30313296,30313311,15,2025-02-25 08:14:02.670350,2025-02-25 08:14:21.934101,19.263751
channel-6994,1324986,30313374,30313385,11,2025-02-25 08:15:46.736133,2025-02-25 08:15:59.605561,12.869428
channel-6994,1324987,30313404,30313418,14,2025-02-25 08:16:25.787207,2025-02-25 08:16:42.482407,16.6952
channel-6994,1324988,30313457,30313472,15,2025-02-25 08:17:32.358057,2025-02-25 08:17:51.932730,19.574673
channel-6994,1324989,30313474,30313486,12,2025-02-25 08:17:54.294253,2025-02-25 08:18:09.053063,14.75881
channel-6994,1324990,30313623,30313634,11,2025-02-25 08:21:09.722006,2025-02-25 08:21:22.893817,13.171811
channel-6994,1324991,30313643,30313654,11,2025-02-25 08:21:35.301425,2025-02-25 08:21:49.071564,13.770139
channel-6994,1324992,30313651,30313689,38,2025-02-25 08:21:45.664607,2025-02-25 08:22:34.773875,49.109268
channel-6994,1324993,30313719,30313730,11,2025-02-25 08:23:15.697706,2025-02-25 08:23:30.917725,15.220019
channel-6994,1324994,30313764,30313774,10,2025-02-25 08:24:12.207446,2025-02-25 08:24:25.207814,13.000368
channel-6994,1324995,30313790,30313817,27,2025-02-25 08:24:49.905778,2025-02-25 08:25:23.754540,33.848762
channel-6994,1324996,30313882,30313893,11,2025-02-25 08:26:47.166251,2025-02-25 08:27:00.903092,13.736841
channel-6994,1324997,30313919,30313941,22,2025-02-25 08:27:33.846041,2025-02-25 08:28:01.611845,27.765804
channel-6994,1324998,30313924,30313936,12,2025-02-25 08:27:39.830247,2025-02-25 08:27:55.599891,15.769644
channel-6994,1324999,30313966,30313983,17,2025-02-25 08:28:35.747124,2025-02-25 08:28:56.128881,20.381757
channel-6994,1325000,30314017,30314028,11,2025-02-25 08:29:38.666267,2025-02-25 08:29:56.746933,18.080666
channel-6994,1325001,30314057,30314071,14,2025-02-25 08:30:36.391524,2025-02-25 08:30:54.479833,18.088309
channel-6994,1325002,30314081,30314091,10,2025-02-25 08:31:06.305532,2025-02-25 08:31:18.469735,12.164203
channel-6994,1325003,30314085,30314096,11,2025-02-25 08:31:11.740604,2025-02-25 08:31:24.928126,13.187522
channel-6994,1325004,30314123,30314135,12,2025-02-25 08:31:59.110305,2025-02-25 08:32:14.841743,15.731438
channel-6994,1325005,30314290,30314301,11,2025-02-25 08:35:39.001900,2025-02-25 08:35:52.324935,13.323035
channel-6994,1325006,30314370,30314381,11,2025-02-25 08:37:21.103821,2025-02-25 08:37:34.735056,13.631235
channel-6994,1325007,30314410,30314422,12,2025-02-25 08:38:12.882264,2025-02-25 08:38:32.537825,19.655561
channel-6994,1325008,30314650,30314659,9,2025-02-25 08:43:28.921383,2025-02-25 08:43:43.306262,14.384879
channel-6994,1325009,30314663,30314677,14,2025-02-25 08:43:47.846986,2025-02-25 08:44:03.949963,16.102977
channel-6994,1325010,30314679,30314712,33,2025-02-25 08:44:06.407369,2025-02-25 08:44:50.577430,44.170061
channel-6994,1325011,30314761,30314771,10,2025-02-25 08:45:53.200502,2025-02-25 08:46:04.614850,11.414348
channel-6994,1325012,30314768,30314781,13,2025-02-25 08:46:01.211538,2025-02-25 08:46:18.340932,17.129394
channel-6994,1325013,30314833,30314845,12,2025-02-25 08:47:26.794256,2025-02-25 08:47:42.652187,15.857931
channel-6994,1325014,30314901,30314914,13,2025-02-25 08:48:51.749120,2025-02-25 08:49:10.919237,19.170117
channel-6994,1325015,30314904,30314914,10,2025-02-25 08:48:56.287194,2025-02-25 08:49:10.919237,14.632043
channel-6994,1325016,30315006,30315016,10,2025-02-25 08:51:09.486708,2025-02-25 08:51:22.723757,13.237049
channel-6994,1325017,30315014,30315040,26,2025-02-25 08:51:19.835033,2025-02-25 08:51:55.302737,35.467704
channel-6994,1325018,30315036,30315051,15,2025-02-25 08:51:50.728262,2025-02-25 08:52:08.787862,18.0596
channel-6994,1325019,30315257,30315271,14,2025-02-25 08:56:35.283893,2025-02-25 08:56:56.054125,20.770232
channel-6994,1325020,30315303,30315316,13,2025-02-25 08:57:37.372590,2025-02-25 08:57:54.622618,17.250028
channel-6994,1325021,30315554,30315566,12,2025-02-25 09:03:02.222909,2025-02-25 09:03:17.741041,15.518132
channel-6994,1325022,30315561,30315571,10,2025-02-25 09:03:11.125154,2025-02-25 09:03:24.326167,13.201013
channel-6994,1325023,30315685,30315696,11,2025-02-25 09:05:50.382445,2025-02-25 09:06:08.147959,17.765514
channel-6994,1325024,30315707,30315718,11,2025-02-25 09:06:21.831889,2025-02-25 09:06:37.580215,15.748326
channel-6994,1325025,30315723,30315735,12,2025-02-25 09:06:44.274692,2025-02-25 09:06:57.565873,13.291181
channel-6994,1325026,30315740,30315751,11,2025-02-25 09:07:03.200604,2025-02-25 09:07:17.322374,14.12177
channel-6994,1325027,30315784,30315794,10,2025-02-25 09:08:01.901882,2025-02-25 09:08:13.454079,11.552197
channel-6994,1325028,30315860,30315868,8,2025-02-25 09:09:40.288928,2025-02-25 09:09:53.279733,12.990805
channel-6994,1325029,30315890,30315903,13,2025-02-25 09:10:22.925830,2025-02-25 09:10:38.448420,15.52259
channel-6994,1325030,30315971,30315984,13,2025-02-25 09:12:10.091450,2025-02-25 09:12:26.701219,16.609769
channel-6994,1325031,30316092,30316104,12,2025-02-25 09:14:48.178939,2025-02-25 09:15:04.794434,16.615495
channel-6994,1325032,30316139,30316151,12,2025-02-25 09:15:47.192912,2025-02-25 09:16:02.795986,15.603074
channel-6994,1325033,30316189,30316202,13,2025-02-25 09:16:51.634781,2025-02-25 09:17:09.783586,18.148805
channel-6994,1325034,30316198,30316217,19,2025-02-25 09:17:04.963214,2025-02-25 09:17:39.479352,34.516138
channel-6994,1325035,30316210,30316217,7,2025-02-25 09:17:21.041511,2025-02-25 09:17:39.479352,18.437841
channel-6994,1325036,30316234,30316247,13,2025-02-25 09:17:59.457870,2025-02-25 09:18:15.285581,15.827711
channel-6994,1325037,30316318,30316332,14,2025-02-25 09:19:50.289204,2025-02-25 09:20:07.344659,17.055455
channel-6994,1325038,30316319,30316332,13,2025-02-25 09:19:51.370280,2025-02-25 09:20:07.344659,15.974379
channel-6994,1325039,30316365,30316380,15,2025-02-25 09:20:48.559660,2025-02-25 09:21:12.212608,23.652948
channel-6994,1325040,30316365,30316380,15,2025-02-25 09:20:48.559660,2025-02-25 09:21:12.212608,23.652948
channel-6994,1325041,30316449,30316459,10,2025-02-25 09:22:41.226533,2025-02-25 09:22:53.084867,11.858334
channel-6994,1325042,30316457,30316510,53,2025-02-25 09:22:50.700029,2025-02-25 09:24:03.310080,72.610051
channel-6994,1325043,30316488,30316501,13,2025-02-25 09:23:33.431601,2025-02-25 09:23:52.093992,18.662391
channel-6994,1325044,30316529,30316540,11,2025-02-25 09:24:27.250457,2025-02-25 09:24:41.742980,14.492523
channel-6994,1325045,30316534,30316545,11,2025-02-25 09:24:33.305025,2025-02-25 09:24:47.685577,14.380552
channel-6994,1325046,30316543,30316556,13,2025-02-25 09:24:45.214558,2025-02-25 09:25:00.388238,15.17368
channel-6994,1325047,30316648,30316661,13,2025-02-25 09:27:05.747418,2025-02-25 09:27:21.715367,15.967949
channel-6994,1325048,30316853,30316864,11,2025-02-25 09:31:32.076103,2025-02-25 09:31:45.423871,13.347768
channel-6994,1325049,30316895,30316911,16,2025-02-25 09:32:24.484156,2025-02-25 09:32:46.635122,22.150966
channel-6994,1325050,30316924,30316935,11,2025-02-25 09:33:10.534946,2025-02-25 09:33:23.781608,13.246662
channel-6994,1325051,30316930,30316941,11,2025-02-25 09:33:18.211144,2025-02-25 09:33:30.674518,12.463374
channel-6994,1325052,30316966,30316981,15,2025-02-25 09:34:02.800426,2025-02-25 09:34:22.439683,19.639257
channel-6994,1325053,30317144,30317156,12,2025-02-25 09:37:59.803488,2025-02-25 09:38:15.660177,15.856689
channel-6994,1325054,30317157,30317168,11,2025-02-25 09:38:16.764176,2025-02-25 09:38:33.724066,16.95989
channel-6994,1325055,30317248,30317256,8,2025-02-25 09:40:11.354312,2025-02-25 09:40:23.275179,11.920867
channel-6994,1325056,30317280,30317297,17,2025-02-25 09:40:54.274026,2025-02-25 09:41:14.949559,20.675533
channel-6994,1325057,30317361,30317373,12,2025-02-25 09:42:42.721971,2025-02-25 09:42:56.654825,13.932854
channel-6994,1325058,30317387,30317397,10,2025-02-25 09:43:14.215733,2025-02-25 09:43:26.210115,11.994382
channel-6994,1325059,30317410,30317422,12,2025-02-25 09:43:43.002644,2025-02-25 09:43:58.611355,15.608711
channel-6994,1325060,30317424,30317435,11,2025-02-25 09:44:01.469421,2025-02-25 09:44:17.922813,16.453392
channel-6994,1325061,30317451,30317464,13,2025-02-25 09:44:38.748087,2025-02-25 09:44:55.562795,16.814708
channel-6994,1325062,30317477,30317489,12,2025-02-25 09:45:11.474558,2025-02-25 09:45:26.273830,14.799272
channel-6994,1325063,30317491,30317504,13,2025-02-25 09:45:29.041354,2025-02-25 09:45:45.753139,16.711785
channel-6994,1325064,30317546,30317558,12,2025-02-25 09:46:39.395408,2025-02-25 09:46:56.277030,16.881622
channel-6994,1325065,30317636,30317653,17,2025-02-25 09:48:34.377585,2025-02-25 09:48:56.833118,22.455533
channel-6994,1325066,30317656,30317667,11,2025-02-25 09:49:00.912163,2025-02-25 09:49:14.532977,13.620814
channel-6994,1325067,30317663,30317673,10,2025-02-25 09:49:09.981095,2025-02-25 09:49:22.328842,12.347747
channel-6994,1325068,30317682,30317693,11,2025-02-25 09:49:32.617755,2025-02-25 09:49:48.298259,15.680504
channel-6994,1325069,30317693,30317702,9,2025-02-25 09:49:48.298259,2025-02-25 09:50:00.862157,12.563898
channel-6994,1325070,30317744,30317755,11,2025-02-25 09:50:57.628783,2025-02-25 09:51:14.840410,17.211627
channel-6994,1325071,30317787,30317798,11,2025-02-25 09:51:59.670571,2025-02-25 09:52:15.643694,15.973123
channel-6994,1325072,30317794,30317844,50,2025-02-25 09:52:08.716735,2025-02-25 09:53:13.015566,64.298831
channel-6994,1325073,30317945,30317954,9,2025-02-25 09:55:36.206635,2025-02-25 09:55:47.689547,11.482912
channel-6994,1325074,30317966,30317979,13,2025-02-25 09:56:02.417023,2025-02-25 09:56:18.548085,16.131062
channel-6994,1325075,30317984,30317996,12,2025-02-25 09:56:25.240483,2025-02-25 09:56:42.624185,17.383702
channel-6994,1325076,30317999,30318011,12,2025-02-25 09:56:46.433607,2025-02-25 09:57:03.972120,17.538513
channel-6994,1325077,30318060,30318075,15,2025-02-25 09:58:09.965607,2025-02-25 09:58:28.389592,18.423985
channel-6994,1325078,30318226,30318264,38,2025-02-25 10:01:57.016275,2025-02-25 10:02:51.610286,54.594011
channel-6994,1325079,30318262,30318274,12,2025-02-25 10:02:49.305533,2025-02-25 10:03:03.605338,14.299805
channel-6994,1325080,30318297,30318310,13,2025-02-25 10:03:34.924683,2025-02-25 10:03:49.206444,14.281761
channel-6994,1325081,30318427,30318439,12,2025-02-25 10:06:29.682290,2025-02-25 10:06:43.822364,14.140074
channel-6994,1325082,30318434,30318442,8,2025-02-25 10:06:37.808554,2025-02-25 10:06:47.777577,9.969023
channel-6994,1325083,30318439,30318446,7,2025-02-25 10:06:43.822364,2025-02-25 10:06:53.683447,9.861083
channel-6994,1325084,30318441,30318450,9,2025-02-25 10:06:46.335224,2025-02-25 10:06:59.471258,13.136034
channel-6994,1325085,30318482,30318492,10,2025-02-25 10:07:45.160899,2025-02-25 10:07:56.636907,11.476008
channel-6994,1325086,30318484,30318496,12,2025-02-25 10:07:47.367209,2025-02-25 10:08:01.365618,13.998409
channel-6994,1325087,30318504,30318513,9,2025-02-25 10:08:11.649399,2025-02-25 10:08:22.597959,10.94856
channel-6994,1325088,30318532,30318540,8,2025-02-25 10:08:47.887919,2025-02-25 10:08:58.150602,10.262683
channel-6994,1325089,30318536,30318544,8,2025-02-25 10:08:53.428325,2025-02-25 10:09:02.866552,9.438227
channel-6994,1325090,30318585,30318595,10,2025-02-25 10:10:09.442271,2025-02-25 10:10:21.164860,11.722589
channel-6994,1325091,30318614,30318623,9,2025-02-25 10:10:45.111145,2025-02-25 10:10:56.743644,11.632499
channel-6994,1325092,30318690,30318728,38,2025-02-25 10:12:23.801754,2025-02-25 10:13:17.284886,53.483132
channel-6994,1325093,30318701,30318712,11,2025-02-25 10:12:41.466635,2025-02-25 10:12:56.108551,14.641916
channel-6994,1325094,30318722,30318732,10,2025-02-25 10:13:10.685904,2025-02-25 10:13:22.091673,11.405769
channel-6994,1325095,30318761,30318771,10,2025-02-25 10:14:00.071682,2025-02-25 10:14:12.046369,11.974687
channel-6994,1325096,30319030,30319038,8,2025-02-25 10:20:04.971243,2025-02-25 10:20:17.699504,12.728261
channel-6994,1325097,30319080,30319088,8,2025-02-25 10:21:15.588186,2025-02-25 10:21:25.540670,9.952484
channel-6994,1325098,30319083,30319114,31,2025-02-25 10:21:19.750752,2025-02-25 10:22:00.966035,41.215283
channel-6994,1325099,30319140,30319173,33,2025-02-25 10:22:32.679148,2025-02-25 10:23:23.104434,50.425286
channel-6994,1325100,30319215,30319224,9,2025-02-25 10:24:18.981201,2025-02-25 10:24:30.981594,12.000393
channel-6994,1325101,30319237,30319245,8,2025-02-25 10:24:47.041182,2025-02-25 10:24:56.077401,9.036219
channel-6994,1325102,30319375,30319386,11,2025-02-25 10:27:49.670452,2025-02-25 10:28:07.004010,17.333558
channel-6994,1325103,30319444,30319457,13,2025-02-25 10:29:30.446530,2025-02-25 10:29:46.962441,16.515911
channel-6994,1325104,30319450,30319460,10,2025-02-25 10:29:38.559645,2025-02-25 10:29:50.672956,12.113311
channel-6994,1325105,30319459,30319471,12,2025-02-25 10:29:49.469951,2025-02-25 10:30:05.866868,16.396917
channel-6994,1325106,30319587,30319596,9,2025-02-25 10:32:47.027272,2025-02-25 10:32:59.030485,12.003213
channel-6994,1325107,30319620,30319631,11,2025-02-25 10:33:33.743592,2025-02-25 10:33:52.162737,18.419145
channel-6994,1325108,30319630,30319641,11,2025-02-25 10:33:51.017517,2025-02-25 10:34:05.996364,14.978847
channel-6994,1325109,30319641,30319652,11,2025-02-25 10:34:05.996364,2025-02-25 10:34:20.399309,14.402945
channel-6994,1325110,30319641,30319652,11,2025-02-25 10:34:05.996364,2025-02-25 10:34:20.399309,14.402945
channel-6994,1325111,30319648,30319661,13,2025-02-25 10:34:15.728158,2025-02-25 10:34:32.124557,16.396399
channel-6994,1325112,30319677,30319689,12,2025-02-25 10:34:55.928789,2025-02-25 10:35:11.502345,15.573556
channel-6994,1325113,30319682,30319694,12,2025-02-25 10:35:03.203794,2025-02-25 10:35:18.101799,14.898005
channel-6994,1325114,30319705,30319717,12,2025-02-25 10:35:31.307210,2025-02-25 10:35:46.186551,14.879341
channel-6994,1325115,30319726,30319734,8,2025-02-25 10:36:03.457089,2025-02-25 10:36:13.586380,10.129291
channel-6994,1325116,30319758,30319769,11,2025-02-25 10:36:43.502102,2025-02-25 10:36:59.864367,16.362265
channel-6994,1325117,30319791,30319801,10,2025-02-25 10:37:27.852745,2025-02-25 10:37:41.273556,13.420811
channel-6994,1325118,30319836,30319845,9,2025-02-25 10:38:27.804827,2025-02-25 10:38:43.643576,15.838749
channel-6994,1325119,30319842,30319853,11,2025-02-25 10:38:39.130172,2025-02-25 10:38:55.782069,16.651897
channel-6994,1325120,30319843,30319853,10,2025-02-25 10:38:41.220111,2025-02-25 10:38:55.782069,14.561958
channel-6994,1325121,30319877,30319885,8,2025-02-25 10:39:25.650746,2025-02-25 10:39:36.181594,10.530848
channel-6994,1325122,30319958,30319971,13,2025-02-25 10:41:13.767385,2025-02-25 10:41:30.817447,17.050062
channel-6994,1325123,30320038,30320048,10,,2025-02-25 10:43:11.588777,
channel-6994,1325124,30320042,30320052,10,,2025-02-25 10:43:16.168511,
channel-6994,1325125,30320067,30320078,11,,2025-02-25 10:43:55.195326,
channel-6994,1325126,30320079,30320087,8,,2025-02-25 10:44:05.631303,
channel-6994,1325127,30320080,30320104,24,,2025-02-25 10:44:27.038731,
channel-6994,1325128,30320114,30320126,12,,2025-02-25 10:44:56.221414,
channel-6994,1325129,30320117,30320131,14,,2025-02-25 10:45:02.774316,
channel-6994,1325130,30320133,30320145,12,,2025-02-25 10:45:20.611166,
channel-6994,1325131,30320159,30320165,6,,2025-02-25 10:45:48.489224,
channel-6994,1325132,30320190,30320215,25,,2025-02-25 10:46:57.144979,
channel-6994,1325133,30320227,30320237,10,,2025-02-25 10:47:27.459479,
channel-6994,1325134,30320300,30320311,11,,2025-02-25 10:49:06.836466,
channel-6994,1325135,30320336,30320348,12,,2025-02-25 10:49:51.011336,
channel-6994,1325136,30320346,30320356,10,,2025-02-25 10:50:02.795524,
channel-6994,1325137,30320347,30320356,9,,2025-02-25 10:50:02.795524,
channel-6994,1325138,30320355,30320366,11,,2025-02-25 10:50:15.097175,
channel-6994,1325139,30320356,30320369,13,2025-02-25 10:50:02.795524,2025-02-25 10:50:19.587877,16.792353
channel-6994,1325140,30320374,30320388,14,2025-02-25 10:50:27.224306,2025-02-25 10:50:43.421821,16.197515
channel-6994,1325141,30320380,30320392,12,2025-02-25 10:50:34.303046,2025-02-25 10:50:49.567749,15.264703
channel-6994,1325142,30320399,30320408,9,2025-02-25 10:50:58.084248,2025-02-25 10:51:10.556106,12.471858
channel-6994,1325143,30320401,30320412,11,2025-02-25 10:51:01.069119,2025-02-25 10:51:16.219506,15.150387
channel-6994,1325144,30320441,30320449,8,2025-02-25 10:51:54.639030,2025-02-25 10:52:07.380628,12.741598
channel-6994,1325145,30320469,30320478,9,2025-02-25 10:52:35.113898,2025-02-25 10:52:46.233847,11.119949
channel-6994,1325146,30320469,30320478,9,2025-02-25 10:52:35.113898,2025-02-25 10:52:46.233847,11.119949
channel-6994,1325147,30320470,30320483,13,2025-02-25 10:52:36.252627,2025-02-25 10:52:51.954485,15.701858
channel-6994,1325148,30320492,30320501,9,2025-02-25 10:53:03.660051,2025-02-25 10:53:15.401473,11.741422
channel-6994,1325149,30320492,30320501,9,2025-02-25 10:53:03.660051,2025-02-25 10:53:15.401473,11.741422
channel-6994,1325150,30320525,30320535,10,2025-02-25 10:53:48.304906,2025-02-25 10:54:03.116510,14.811604
channel-6994,1325151,30320531,30320538,7,2025-02-25 10:53:55.239050,2025-02-25 10:54:07.632212,12.393162
channel-6994,1325152,30320534,30320542,8,2025-02-25 10:53:58.710982,2025-02-25 10:54:12.358944,13.647962
channel-6994,1325153,30320534,30320542,8,2025-02-25 10:53:58.710982,2025-02-25 10:54:12.358944,13.647962
channel-6994,1325154,30320550,30320559,9,2025-02-25 10:54:24.264496,2025-02-25 10:54:35.490656,11.22616
channel-6994,1325155,30320575,30320585,10,2025-02-25 10:54:55.205425,2025-02-25 10:55:07.620853,12.415428
channel-6994,1325156,30320593,30320602,9,2025-02-25 10:55:17.249249,2025-02-25 10:55:29.727317,12.478068
channel-6994,1325157,30320612,30320621,9,2025-02-25 10:55:41.996110,2025-02-25 10:55:53.250941,11.254831
channel-6994,1325158,30320615,30320625,10,2025-02-25 10:55:45.657037,2025-02-25 10:55:58.223789,12.566752
channel-6994,1325159,30320616,30320625,9,2025-02-25 10:55:46.986479,2025-02-25 10:55:58.223789,11.23731
channel-6994,1325160,30320648,30320656,8,2025-02-25 10:56:29.488116,2025-02-25 10:56:45.789689,16.301573
channel-6994,1325161,30320699,30320711,12,2025-02-25 10:57:40.627345,2025-02-25 10:57:55.352242,14.724897
channel-6994,1325162,30320710,30320718,8,2025-02-25 10:57:54.252148,2025-02-25 10:58:06.274337,12.022189
channel-6994,1325163,30320718,30320727,9,2025-02-25 10:58:06.274337,2025-02-25 10:58:17.941813,11.667476
channel-6994,1325164,30320743,30320757,14,2025-02-25 10:58:39.226893,2025-02-25 10:58:56.084338,16.857445
channel-6994,1325165,30320806,30320816,10,2025-02-25 11:00:04.281818,2025-02-25 11:00:16.149338,11.86752
channel-6994,1325166,30320820,30320828,8,2025-02-25 11:00:21.805212,2025-02-25 11:00:32.632598,10.827386
channel-6994,1325167,30320838,30320850,12,2025-02-25 11:00:44.391612,2025-02-25 11:01:00.591764,16.200152
channel-6994,1325168,30320856,30320867,11,2025-02-25 11:01:08.926442,2025-02-25 11:01:21.732245,12.805803
channel-6994,1325169,30320877,30320888,11,2025-02-25 11:01:38.266072,2025-02-25 11:01:57.304370,19.038298
channel-6994,1325170,30320877,30320888,11,2025-02-25 11:01:38.266072,2025-02-25 11:01:57.304370,19.038298
channel-6994,1325171,30320877,30320906,29,2025-02-25 11:01:38.266072,2025-02-25 11:02:19.973746,41.707674
channel-6994,1325172,30320884,30320893,9,2025-02-25 11:01:49.514139,2025-02-25 11:02:03.144897,13.630758
channel-6994,1325173,30320955,30320973,18,2025-02-25 11:03:21.680582,2025-02-25 11:03:46.488200,24.807618
channel-6994,1325174,30321002,30321011,9,2025-02-25 11:04:30.477427,2025-02-25 11:04:40.755612,10.278185
channel-6994,1325175,30321007,30321017,10,2025-02-25 11:04:36.102446,2025-02-25 11:04:49.164282,13.061836
channel-6994,1325176,30321011,30321021,10,2025-02-25 11:04:40.755612,2025-02-25 11:04:54.485666,13.730054
channel-6994,1325177,30321175,30321187,12,2025-02-25 11:08:22.415146,2025-02-25 11:08:37.860448,15.445302
channel-6994,1325178,30321182,30321192,10,2025-02-25 11:08:30.469838,2025-02-25 11:08:43.407155,12.937317
channel-6994,1325179,30321206,30321216,10,2025-02-25 11:08:59.677313,2025-02-25 11:09:12.442030,12.764717
channel-6994,1325180,30321274,30321295,21,2025-02-25 11:10:35.304051,2025-02-25 11:11:02.321955,27.017904
channel-6994,1325181,30321282,30321290,8,2025-02-25 11:10:45.123053,2025-02-25 11:10:56.445096,11.322043
channel-6994,1325182,30321282,30321290,8,2025-02-25 11:10:45.123053,2025-02-25 11:10:56.445096,11.322043
channel-6994,1325183,30321349,30321358,9,2025-02-25 11:12:13.883335,2025-02-25 11:12:25.913187,12.029852
channel-6994,1325184,30321453,30321480,27,2025-02-25 11:14:25.699882,2025-02-25 11:15:03.508352,37.80847
channel-6994,1325185,30321540,30321547,7,2025-02-25 11:16:22.830206,2025-02-25 11:16:34.335541,11.505335
channel-6994,1325186,30321554,30321564,10,2025-02-25 11:16:42.336932,2025-02-25 11:16:58.821043,16.484111
channel-6994,1325187,30321568,30321577,9,2025-02-25 11:17:08.011573,2025-02-25 11:17:19.648445,11.636872
channel-6994,1325188,30321722,30321734,12,2025-02-25 11:20:33.305963,2025-02-25 11:20:48.544059,15.238096
channel-6994,1325189,30321739,30321748,9,2025-02-25 11:20:54.283715,2025-02-25 11:21:06.519052,12.235337
channel-6994,1325190,30321815,30321825,10,2025-02-25 11:22:41.511756,2025-02-25 11:22:53.402850,11.891094
channel-6994,1325191,30321840,30321852,12,2025-02-25 11:23:11.024562,2025-02-25 11:23:27.331744,16.307182
channel-6994,1325192,30321872,30321903,31,2025-02-25 11:23:52.222349,2025-02-25 11:24:34.680215,42.457866
channel-6994,1325193,30321893,30321899,6,2025-02-25 11:24:19.314002,2025-02-25 11:24:29.880096,10.566094
channel-6994,1325194,30321927,30321936,9,2025-02-25 11:25:10.757323,2025-02-25 11:25:22.944761,12.187438
channel-6994,1325195,30321982,30321996,14,2025-02-25 11:26:19.527465,2025-02-25 11:26:36.640994,17.113529
channel-6994,1325196,30321997,30322008,11,2025-02-25 11:26:37.702035,2025-02-25 11:26:53.759285,16.05725
channel-6994,1325197,30322019,30322053,34,2025-02-25 11:27:09.050310,2025-02-25 11:27:56.169681,47.119371
channel-6994,1325198,30322026,30322038,12,2025-02-25 11:27:20.781748,2025-02-25 11:27:35.484687,14.702939
channel-6994,1325199,30322038,30322046,8,2025-02-25 11:27:35.484687,2025-02-25 11:27:45.586153,10.101466
channel-6994,1325200,30322187,30322194,7,2025-02-25 11:30:53.645909,2025-02-25 11:31:07.237501,13.591592
channel-6994,1325201,30322192,30322201,9,2025-02-25 11:31:03.828191,2025-02-25 11:31:16.318782,12.490591
channel-6994,1325202,30322218,30322228,10,2025-02-25 11:31:39.160004,2025-02-25 11:31:51.599305,12.439301
channel-6994,1325203,30322249,30322260,11,2025-02-25 11:32:17.864130,2025-02-25 11:32:30.279977,12.415847
channel-6994,1325204,30322326,30322336,10,2025-02-25 11:34:03.729477,2025-02-25 11:34:17.085011,13.355534
channel-6994,1325205,30322395,30322404,9,2025-02-25 11:35:37.350777,2025-02-25 11:35:47.871765,10.520988
channel-6994,1325206,30322435,30322444,9,2025-02-25 11:36:27.412760,2025-02-25 11:36:39.365534,11.952774
channel-6994,1325207,30322527,30322536,9,2025-02-25 11:38:30.493921,2025-02-25 11:38:44.078385,13.584464
channel-6994,1325208,30322548,30322560,12,2025-02-25 11:39:00.736358,2025-02-25 11:39:14.611983,13.875625
channel-6994,1325209,30322562,30322574,12,2025-02-25 11:39:17.011313,2025-02-25 11:39:32.121797,15.110484
channel-6994,1325210,30322596,30322606,10,2025-02-25 11:39:58.434268,2025-02-25 11:40:12.816841,14.382573
channel-6994,1325211,30322617,30322627,10,2025-02-25 11:40:28.657087,2025-02-25 11:40:46.758563,18.101476
channel-6994,1325212,30322702,30322711,9,2025-02-25 11:42:23.095175,2025-02-25 11:42:38.231824,15.136649
channel-6994,1325213,30322742,30322755,13,2025-02-25 11:43:24.514531,2025-02-25 11:43:40.662086,16.147555
channel-6994,1325214,30322792,30322800,8,2025-02-25 11:44:28.091945,2025-02-25 11:44:41.712457,13.620512
channel-6994,1325215,30322836,30322849,13,2025-02-25 11:45:26.270103,2025-02-25 11:45:47.056903,20.7868
channel-6994,1325216,30322853,30322863,10,2025-02-25 11:45:52.539141,2025-02-25 11:46:05.438587,12.899446
channel-6994,1325217,30322859,30322868,9,2025-02-25 11:45:59.722821,2025-02-25 11:46:11.624190,11.901369
channel-6994,1325218,30322911,30322921,10,2025-02-25 11:47:10.242090,2025-02-25 11:47:22.787923,12.545833
channel-6994,1325219,30322956,30322967,11,2025-02-25 11:48:12.140740,2025-02-25 11:48:28.468027,16.327287
channel-6994,1325220,30322997,30323007,10,2025-02-25 11:49:07.672005,2025-02-25 11:49:21.098474,13.426469
channel-6994,1325221,30323025,30323034,9,2025-02-25 11:49:43.456168,2025-02-25 11:49:54.820538,11.36437
channel-6994,1325222,30323074,30323087,13,2025-02-25 11:50:48.020952,2025-02-25 11:51:03.898170,15.877218
channel-6994,1325223,30323199,30323208,9,2025-02-25 11:53:31.004654,2025-02-25 11:53:41.455623,10.450969
channel-6994,1325224,30323239,30323251,12,2025-02-25 11:54:25.731915,2025-02-25 11:54:40.756497,15.024582
channel-6994,1325225,30323261,30323273,12,2025-02-25 11:54:54.329322,2025-02-25 11:55:09.194319,14.864997
channel-6994,1325226,30323301,30323314,13,2025-02-25 11:55:45.093454,2025-02-25 11:56:02.071373,16.977919
channel-6994,1325227,30323330,30323340,10,2025-02-25 11:56:23.175555,2025-02-25 11:56:35.003159,11.827604
channel-6994,1325228,30323385,30323398,13,2025-02-25 11:57:33.900765,2025-02-25 11:57:50.733677,16.832912
channel-6994,1325229,30323395,30323405,10,2025-02-25 11:57:46.745760,2025-02-25 11:58:00.916921,14.171161
channel-6994,1325230,30323448,30323455,7,2025-02-25 11:58:53.824279,2025-02-25 11:59:04.471169,10.64689
channel-6994,1325231,30323475,30323492,17,2025-02-25 11:59:29.024817,2025-02-25 11:59:50.893307,21.86849
channel-6994,1325232,30323561,30323571,10,2025-02-25 12:01:18.521356,2025-02-25 12:01:34.079800,15.558444
channel-6994,1325233,30323586,30323597,11,2025-02-25 12:01:54.201480,2025-02-25 12:02:08.507534,14.306054
channel-6994,1325234,30323589,30323601,12,2025-02-25 12:01:57.623682,2025-02-25 12:02:13.191981,15.568299
channel-6994,1325235,30323648,30323660,12,2025-02-25 12:03:13.461948,2025-02-25 12:03:27.538916,14.076968
channel-6994,1325236,30323650,30323660,10,2025-02-25 12:03:15.629992,2025-02-25 12:03:27.538916,11.908924
channel-6994,1325237,30323669,30323679,10,2025-02-25 12:03:40.791365,2025-02-25 12:03:54.794998,14.003633
channel-6994,1325238,30323723,30323735,12,2025-02-25 12:04:51.500595,2025-02-25 12:05:06.162972,14.662377
channel-6994,1325239,30323788,30323796,8,2025-02-25 12:06:14.403039,2025-02-25 12:06:27.273358,12.870319
channel-6994,1325240,30323811,30323824,13,2025-02-25 12:06:44.764285,2025-02-25 12:07:01.097734,16.333449
channel-6994,1325241,30323847,30323861,14,2025-02-25 12:07:32.371553,2025-02-25 12:07:49.486297,17.114744
channel-6994,1325242,30323885,30323895,10,2025-02-25 12:08:18.299706,2025-02-25 12:08:30.560247,12.260541
channel-6994,1325243,30323910,30323918,8,2025-02-25 12:08:48.582363,2025-02-25 12:08:57.799679,9.217316
channel-6994,1325244,30323943,30323954,11,2025-02-25 12:09:36.934373,2025-02-25 12:09:51.161183,14.22681
channel-6994,1325245,30323984,30323997,13,2025-02-25 12:10:33.141551,2025-02-25 12:10:48.372353,15.230802
channel-6994,1325246,30323985,30324011,26,2025-02-25 12:10:34.260626,2025-02-25 12:11:06.220271,31.959645
channel-6994,1325247,30324104,30324113,9,2025-02-25 12:13:04.987370,2025-02-25 12:13:17.753869,12.766499
channel-6994,1325248,30324123,30324131,8,2025-02-25 12:13:30.219819,2025-02-25 12:13:42.634599,12.41478
channel-6994,1325249,30324128,30324141,13,2025-02-25 12:13:37.978143,2025-02-25 12:13:54.098719,16.120576
channel-6994,1325250,30324136,30324147,11,2025-02-25 12:13:48.407567,2025-02-25 12:14:01.903623,13.496056
channel-6994,1325251,30324165,30324172,7,2025-02-25 12:14:24.996915,2025-02-25 12:14:34.155853,9.158938
channel-6994,1325252,30324176,30324185,9,2025-02-25 12:14:38.998200,2025-02-25 12:14:52.433226,13.435026
channel-6994,1325253,30324179,30324189,10,2025-02-25 12:14:43.713376,2025-02-25 12:14:57.379025,13.665649
channel-6994,1325254,30324207,30324218,11,2025-02-25 12:15:20.998562,2025-02-25 12:15:33.376468,12.377906
channel-6994,1325255,30324211,30324222,11,2025-02-25 12:15:25.490395,2025-02-25 12:15:38.640864,13.150469
channel-6994,1325256,30324267,30324277,10,2025-02-25 12:16:38.485551,2025-02-25 12:16:53.049206,14.563655
channel-6994,1325257,30324307,30324319,12,2025-02-25 12:17:29.834540,2025-02-25 12:17:44.352572,14.518032
channel-6994,1325258,30324321,30324332,11,2025-02-25 12:17:48.019828,2025-02-25 12:18:00.577885,12.558057
channel-6994,1325259,30324343,30324351,8,2025-02-25 12:18:13.090078,2025-02-25 12:18:23.930586,10.840508
channel-6994,1325260,30324343,30324351,8,2025-02-25 12:18:13.090078,2025-02-25 12:18:23.930586,10.840508
channel-6994,1325261,30324353,30324361,8,2025-02-25 12:18:26.327020,2025-02-25 12:18:41.133317,14.806297
channel-6994,1325262,30324401,30324409,8,2025-02-25 12:19:34.047769,2025-02-25 12:19:46.646925,12.599156
channel-6994,1325263,30324560,30324569,9,2025-02-25 12:22:57.918596,2025-02-25 12:23:09.558362,11.639766
channel-6994,1325264,30324604,30324616,12,2025-02-25 12:23:58.298444,2025-02-25 12:24:14.623166,16.324722
channel-6994,1325265,30324620,30324628,8,2025-02-25 12:24:20.730557,2025-02-25 12:24:30.243930,9.513373
channel-6994,1325266,30324696,30324704,8,2025-02-25 12:25:58.159173,2025-02-25 12:26:11.509630,13.350457
channel-6994,1325267,30324701,30324711,10,2025-02-25 12:26:05.151943,2025-02-25 12:26:22.382503,17.23056
channel-6994,1325268,30324703,30324711,8,2025-02-25 12:26:10.116183,2025-02-25 12:26:22.382503,12.26632
channel-6994,1325269,30324729,30324738,9,2025-02-25 12:26:43.961173,2025-02-25 12:26:56.210093,12.24892
channel-6994,1325270,30324747,30324757,10,2025-02-25 12:27:08.135567,2025-02-25 12:27:20.076010,11.940443
channel-6994,1325271,30324773,30324782,9,2025-02-25 12:27:40.739500,2025-02-25 12:27:51.681960,10.94246
channel-6994,1325272,30324808,30324817,9,2025-02-25 12:28:26.578104,2025-02-25 12:28:39.156512,12.578408
channel-6994,1325273,30324811,30324821,10,2025-02-25 12:28:31.433372,2025-02-25 12:28:45.016747,13.583375
channel-6994,1325274,30324952,30324962,10,2025-02-25 12:31:32.008161,2025-02-25 12:31:43.952749,11.944588
channel-6994,1325275,30324965,30324976,11,2025-02-25 12:31:47.393284,2025-02-25 12:32:01.418009,14.024725
channel-6994,1325276,30324972,30324980,8,2025-02-25 12:31:56.839897,2025-02-25 12:32:06.714411,9.874514
channel-6994,1325277,30325002,30325012,10,2025-02-25 12:32:34.674006,2025-02-25 12:32:48.762023,14.088017
channel-6994,1325278,30325006,30325053,47,2025-02-25 12:32:39.326974,2025-02-25 12:33:45.584760,66.257786
channel-6994,1325279,30325021,30325033,12,2025-02-25 12:33:03.413834,2025-02-25 12:33:17.036395,13.622561
channel-6994,1325280,30325078,30325091,13,2025-02-25 12:34:16.830788,2025-02-25 12:34:32.693526,15.862738
channel-6994,1325281,30325368,30325378,10,2025-02-25 12:40:31.677602,2025-02-25 12:40:43.600418,11.922816
channel-6994,1325282,30325410,30325419,9,2025-02-25 12:41:23.993162,2025-02-25 12:41:34.376083,10.382921
channel-6994,1325283,30325517,30325528,11,2025-02-25 12:43:46.920784,2025-02-25 12:43:59.747677,12.826893
channel-6994,1325284,30325550,30325562,12,2025-02-25 12:44:27.880445,2025-02-25 12:44:44.716491,16.836046
channel-6994,1325285,30325587,30325596,9,2025-02-25 12:45:17.077444,2025-02-25 12:45:30.184436,13.106992
channel-6994,1325286,30325879,30325888,9,2025-02-25 12:51:38.864110,2025-02-25 12:51:50.476210,11.6121
channel-6994,1325287,30325922,30325931,9,2025-02-25 12:52:33.106765,2025-02-25 12:52:44.802784,11.696019
channel-6994,1325288,30325933,30325944,11,2025-02-25 12:52:48.065247,2025-02-25 12:53:02.277577,14.21233
channel-6994,1325289,30325990,30326000,10,2025-02-25 12:54:00.585377,2025-02-25 12:54:12.199780,11.614403
channel-6994,1325290,30326008,30326018,10,2025-02-25 12:54:21.531497,2025-02-25 12:54:38.277970,16.746473
channel-6994,1325291,30326049,30326057,8,2025-02-25 12:55:16.728617,2025-02-25 12:55:30.435661,13.707044
channel-6994,1325292,30326077,30326086,9,2025-02-25 12:55:55.761926,2025-02-25 12:56:07.195135,11.433209
channel-6994,1325293,30326099,30326108,9,2025-02-25 12:56:26.745707,2025-02-25 12:56:36.726987,9.98128
channel-6994,1325294,30326119,30326131,12,2025-02-25 12:56:51.293593,2025-02-25 12:57:07.732674,16.439081
channel-6994,1325295,30326121,30326131,10,2025-02-25 12:56:53.660753,2025-02-25 12:57:07.732674,14.071921
channel-6994,1325296,30326189,30326202,13,2025-02-25 12:58:20.193093,2025-02-25 12:58:36.834030,16.640937
channel-6994,1325297,30326215,30326227,12,2025-02-25 12:58:55.744025,2025-02-25 12:59:10.735088,14.991063
channel-6994,1325298,30326224,30326237,13,2025-02-25 12:59:07.353448,2025-02-25 12:59:22.964061,15.610613
channel-6994,1325299,30326257,30326265,8,2025-02-25 12:59:52.784269,2025-02-25 13:00:02.670760,9.886491
channel-6994,1325300,30326286,30326299,13,2025-02-25 13:00:34.542368,2025-02-25 13:00:50.192010,15.649642
channel-6994,1325301,30326378,30326390,12,2025-02-25 13:02:30.919833,2025-02-25 13:02:45.240890,14.321057
channel-6994,1325302,30326416,30326424,8,2025-02-25 13:03:20.199833,2025-02-25 13:03:30.738793,10.53896
channel-6994,1325303,30326553,30326562,9,2025-02-25 13:06:16.364748,2025-02-25 13:06:27.561002,11.196254
channel-6994,1325304,30326561,30326569,8,2025-02-25 13:06:26.449121,2025-02-25 13:06:36.977695,10.528574
channel-6994,1325305,30326568,30326578,10,2025-02-25 13:06:35.918728,2025-02-25 13:06:47.708969,11.790241
channel-6994,1325306,30326568,30326578,10,2025-02-25 13:06:35.918728,2025-02-25 13:06:47.708969,11.790241
channel-6994,1325307,30326579,30326590,11,2025-02-25 13:06:50.291788,2025-02-25 13:07:03.103575,12.811787
channel-6994,1325308,30326625,30326632,7,2025-02-25 13:07:48.626192,2025-02-25 13:07:59.373458,10.747266
channel-6994,1325309,30326680,30326688,8,2025-02-25 13:09:01.893982,2025-02-25 13:09:11.518153,9.624171
channel-6994,1325310,30326773,30326780,7,2025-02-25 13:11:01.236157,2025-02-25 13:11:09.135753,7.899596
channel-6994,1325311,30326775,30326785,10,2025-02-25 13:11:03.470618,2025-02-25 13:11:16.307178,12.83656
channel-6994,1325312,30326798,30326810,12,2025-02-25 13:11:33.255864,2025-02-25 13:11:48.620501,15.364637
channel-6994,1325313,30326803,30326814,11,2025-02-25 13:11:39.826079,2025-02-25 13:11:53.347797,13.521718
channel-6994,1325314,30326834,30326842,8,2025-02-25 13:12:17.500974,2025-02-25 13:12:27.573179,10.072205
channel-6994,1325315,30326842,30326851,9,2025-02-25 13:12:27.573179,2025-02-25 13:12:40.548003,12.974824
channel-6994,1325316,30326852,30326863,11,2025-02-25 13:12:42.762594,2025-02-25 13:12:56.172327,13.409733
channel-6994,1325317,30326883,30326894,11,2025-02-25 13:13:23.415206,2025-02-25 13:13:37.731671,14.316465
channel-6994,1325318,30326885,30326894,9,2025-02-25 13:13:25.619371,2025-02-25 13:13:37.731671,12.1123
channel-6994,1325319,30326889,30326895,6,2025-02-25 13:13:31.429341,2025-02-25 13:13:42.186201,10.75686
channel-6994,1325320,30326909,30326920,11,2025-02-25 13:13:58.633477,2025-02-25 13:14:12.461205,13.827728
channel-6994,1325321,30326911,30326932,21,2025-02-25 13:14:00.950160,2025-02-25 13:14:28.070663,27.120503
channel-6994,1325322,30326953,30326963,10,2025-02-25 13:14:56.753776,2025-02-25 13:15:10.519486,13.76571
channel-6994,1325323,30326992,30327003,11,2025-02-25 13:15:46.460770,2025-02-25 13:15:59.165875,12.705105
channel-6994,1325324,30327034,30327044,10,2025-02-25 13:16:38.468590,2025-02-25 13:16:50.591801,12.123211
channel-6994,1325325,30327051,30327060,9,2025-02-25 13:17:01.066242,2025-02-25 13:17:12.865993,11.799751
channel-6994,1325326,30327057,30327068,11,2025-02-25 13:17:09.504884,2025-02-25 13:17:23.127820,13.622936
channel-6994,1325327,30327092,30327103,11,2025-02-25 13:17:55.450378,2025-02-25 13:18:08.627785,13.177407
channel-6994,1325328,30327146,30327156,10,2025-02-25 13:19:05.646386,2025-02-25 13:19:18.100568,12.454182
channel-6994,1325329,30327190,30327204,14,2025-02-25 13:20:03.797884,2025-02-25 13:20:19.792233,15.994349
channel-6994,1325330,30327263,30327272,9,2025-02-25 13:21:34.498647,2025-02-25 13:21:45.619031,11.120384
channel-6994,1325331,30327344,30327355,11,2025-02-25 13:23:20.246441,2025-02-25 13:23:34.475960,14.229519
channel-6994,1325332,30327351,30327360,9,2025-02-25 13:23:29.587634,2025-02-25 13:23:40.458477,10.870843
channel-6994,1325333,30327373,30327384,11,2025-02-25 13:23:57.599996,2025-02-25 13:24:11.543496,13.9435
channel-6994,1325334,30327405,30327415,10,2025-02-25 13:24:40.350331,2025-02-25 13:24:51.908772,11.558441
channel-6994,1325335,30327432,30327444,12,2025-02-25 13:25:13.983207,2025-02-25 13:25:27.958832,13.975625
channel-6994,1325336,30327436,30327449,13,2025-02-25 13:25:18.584534,2025-02-25 13:25:33.569886,14.985352
channel-6994,1325337,30327451,30327463,12,2025-02-25 13:25:36.449577,2025-02-25 13:25:50.769981,14.320404
channel-6994,1325338,30327483,30327494,11,2025-02-25 13:26:19.354061,2025-02-25 13:26:35.302934,15.948873
channel-6994,1325339,30327491,30327503,12,2025-02-25 13:26:30.858317,2025-02-25 13:26:46.867632,16.009315
channel-6994,1325340,30327573,30327582,9,2025-02-25 13:28:21.167003,2025-02-25 13:28:31.674735,10.507732
channel-6994,1325341,30327658,30327690,32,2025-02-25 13:30:09.975487,2025-02-25 13:30:49.778873,39.803386
channel-6994,1325342,30327702,30327711,9,2025-02-25 13:31:04.599529,2025-02-25 13:31:17.451486,12.851957
channel-6994,1325343,30327721,30327732,11,2025-02-25 13:31:29.801045,2025-02-25 13:31:45.998090,16.197045
channel-6994,1325344,30327746,30327756,10,2025-02-25 13:32:04.929308,2025-02-25 13:32:18.928413,13.999105
channel-6994,1325345,30327765,30327775,10,2025-02-25 13:32:30.589014,2025-02-25 13:32:42.217931,11.628917
channel-6994,1325346,30327776,30327798,22,2025-02-25 13:32:43.300046,2025-02-25 13:33:09.690939,26.390893
channel-6994,1325347,30327841,30327850,9,2025-02-25 13:34:07.281823,2025-02-25 13:34:18.015802,10.733979
channel-6994,1325348,30327883,30327925,42,2025-02-25 13:34:59.091442,2025-02-25 13:35:52.620968,53.529526
channel-6994,1325349,30327890,30327903,13,2025-02-25 13:35:06.980147,2025-02-25 13:35:24.206273,17.226126
channel-6994,1325350,30327898,30327908,10,2025-02-25 13:35:17.381052,2025-02-25 13:35:29.639936,12.258884
channel-6994,1325351,30327901,30327913,12,2025-02-25 13:35:21.921925,2025-02-25 13:35:35.228321,13.306396
channel-6994,1325352,30327983,30327995,12,2025-02-25 13:37:09.935113,2025-02-25 13:37:25.516322,15.581209
channel-6994,1325353,30327983,30327995,12,2025-02-25 13:37:09.935113,2025-02-25 13:37:25.516322,15.581209
channel-6994,1325354,30328047,30328056,9,2025-02-25 13:38:32.324168,2025-02-25 13:38:44.327635,12.003467
channel-6994,1325355,30328083,30328093,10,2025-02-25 13:39:18.344915,2025-02-25 13:39:31.344066,12.999151
channel-6994,1325356,30328117,30328158,41,2025-02-25 13:40:04.189100,2025-02-25 13:40:58.678674,54.489574
channel-6994,1325357,30328119,30328143,24,2025-02-25 13:40:06.506915,2025-02-25 13:40:39.540259,33.033344
channel-6994,1325358,30328224,30328237,13,2025-02-25 13:42:20.905641,2025-02-25 13:42:35.930855,15.025214
channel-6994,1325359,30328225,30328237,12,2025-02-25 13:42:22.055994,2025-02-25 13:42:35.930855,13.874861
channel-6994,1325360,30328234,30328244,10,2025-02-25 13:42:32.580832,2025-02-25 13:42:47.684041,15.103209
channel-6994,1325361,30328243,30328253,10,2025-02-25 13:42:46.000467,2025-02-25 13:42:59.864492,13.864025
channel-6994,1325362,30328315,30328324,9,2025-02-25 13:44:17.848099,2025-02-25 13:44:28.758000,10.909901
channel-6994,1325363,30328346,30328355,9,2025-02-25 13:44:56.286461,2025-02-25 13:45:09.537566,13.251105
channel-6994,1325364,30328365,30328376,11,2025-02-25 13:45:25.419601,2025-02-25 13:45:39.869168,14.449567
channel-6994,1325365,30328391,30328400,9,2025-02-25 13:45:58.773992,2025-02-25 13:46:09.141637,10.367645
channel-6994,1325366,30328411,30328422,11,2025-02-25 13:46:22.135407,2025-02-25 13:46:37.123600,14.988193
channel-6994,1325367,30328462,30328475,13,2025-02-25 13:47:30.064834,2025-02-25 13:47:47.253153,17.188319
channel-6994,1325368,30328550,30328571,21,2025-02-25 13:49:21.036715,2025-02-25 13:49:51.765491,30.728776
channel-6994,1325369,30328750,30328774,24,2025-02-25 13:53:42.802191,2025-02-25 13:54:15.177772,32.375581
channel-6994,1325370,30328767,30328778,11,2025-02-25 13:54:05.712751,2025-02-25 13:54:20.989210,15.276459
channel-6994,1325371,30328812,30328825,13,2025-02-25 13:55:04.763067,2025-02-25 13:55:20.624025,15.860958
channel-6994,1325372,30328841,30328854,13,2025-02-25 13:55:39.677842,2025-02-25 13:55:55.818569,16.140727
channel-6994,1325373,30328881,30328891,10,2025-02-25 13:56:31.388513,2025-02-25 13:56:45.021204,13.632691
channel-6994,1325374,30329008,30329019,11,2025-02-25 13:59:21.793668,2025-02-25 13:59:35.593312,13.799644
channel-6994,1325375,30329052,30329063,11,2025-02-25 14:00:18.021207,2025-02-25 14:00:31.998351,13.977144
channel-6994,1325376,30329112,30329122,10,2025-02-25 14:01:36.120594,2025-02-25 14:01:49.830404,13.70981
channel-6994,1325377,30329141,30329153,12,2025-02-25 14:02:15.135193,2025-02-25 14:02:29.283635,14.148442
channel-6994,1325378,30329200,30329211,11,2025-02-25 14:03:31.561399,2025-02-25 14:03:46.532936,14.971537
channel-6994,1325379,30329327,30329335,8,2025-02-25 14:06:12.199216,2025-02-25 14:06:23.193161,10.993945
channel-6994,1325380,30329383,30329395,12,2025-02-25 14:07:25.342776,2025-02-25 14:07:41.671985,16.329209
channel-6994,1325381,30329403,30329414,11,2025-02-25 14:07:55.128666,2025-02-25 14:08:09.072325,13.943659
channel-6994,1325382,30329412,30329427,15,2025-02-25 14:08:06.850170,2025-02-25 14:08:25.481529,18.631359
channel-6994,1325383,30329437,30329457,20,2025-02-25 14:08:39.686558,2025-02-25 14:09:04.536617,24.850059
channel-6994,1325384,30329444,30329452,8,2025-02-25 14:08:47.824222,2025-02-25 14:08:58.938697,11.114475
channel-6994,1325385,30329466,30329475,9,2025-02-25 14:09:15.834730,2025-02-25 14:09:27.667272,11.832542
channel-6994,1325386,30329472,30329484,12,2025-02-25 14:09:22.608116,2025-02-25 14:09:37.927108,15.318992
channel-6994,1325387,30329474,30329484,10,2025-02-25 14:09:26.598693,2025-02-25 14:09:37.927108,11.328415
channel-6994,1325388,30329479,30329489,10,2025-02-25 14:09:32.199987,2025-02-25 14:09:43.628556,11.428569
channel-6994,1325389,30329489,30329499,10,2025-02-25 14:09:43.628556,2025-02-25 14:09:56.806969,13.178413
channel-6994,1325390,30329499,30329511,12,2025-02-25 14:09:56.806969,2025-02-25 14:10:12.633874,15.826905
channel-6994,1325391,30329526,30329536,10,2025-02-25 14:10:29.744589,2025-02-25 14:10:42.564832,12.820243
channel-6994,1325392,30329567,30329576,9,2025-02-25 14:11:27.016818,2025-02-25 14:11:37.448267,10.431449
channel-6994,1325393,30329569,30329581,12,2025-02-25 14:11:29.297841,2025-02-25 14:11:43.319836,14.021995
channel-6994,1325394,30329600,30329611,11,2025-02-25 14:12:11.509463,2025-02-25 14:12:24.415648,12.906185
channel-6994,1325395,30329639,30329647,8,2025-02-25 14:12:59.511151,2025-02-25 14:13:11.408321,11.89717
channel-6994,1325396,30329661,30329672,11,2025-02-25 14:13:30.227223,2025-02-25 14:13:43.799786,13.572563
channel-6994,1325397,30329671,30329683,12,2025-02-25 14:13:42.637390,2025-02-25 14:13:57.812091,15.174701
channel-6994,1325398,30329726,30329736,10,2025-02-25 14:14:53.569203,2025-02-25 14:15:07.855913,14.28671
channel-6994,1325399,30329765,30329784,19,2025-02-25 14:15:45.543605,2025-02-25 14:16:08.377333,22.833728
channel-6994,1325400,30329804,30329812,8,2025-02-25 14:16:34.516542,2025-02-25 14:16:48.249997,13.733455
channel-6994,1325401,30329834,30329847,13,2025-02-25 14:17:16.922728,2025-02-25 14:17:33.082468,16.15974
channel-6994,1325402,30329853,30329866,13,2025-02-25 14:17:40.226602,2025-02-25 14:17:56.774064,16.547462
channel-6994,1325403,30329894,30329904,10,2025-02-25 14:18:34.365969,2025-02-25 14:18:46.225645,11.859676
channel-6994,1325404,30329959,30329971,12,2025-02-25 14:19:56.135636,2025-02-25 14:20:11.401249,15.265613
channel-6994,1325405,30330041,30330053,12,2025-02-25 14:21:46.082963,2025-02-25 14:22:01.410287,15.327324
channel-6994,1325406,30330100,30330113,13,2025-02-25 14:23:03.216025,2025-02-25 14:23:17.945472,14.729447
channel-6994,1325407,30330196,30330207,11,2025-02-25 14:25:03.493351,2025-02-25 14:25:17.398608,13.905257
channel-6994,1325408,30330224,30330240,16,2025-02-25 14:25:38.977979,2025-02-25 14:26:03.550100,24.572121
channel-6994,1325409,30330233,30330245,12,2025-02-25 14:25:53.955400,2025-02-25 14:26:09.506142,15.550742
channel-6994,1325410,30330238,30330250,12,2025-02-25 14:26:00.126896,2025-02-25 14:26:16.230548,16.103652
channel-6994,1325411,30330241,30330250,9,2025-02-25 14:26:04.682773,2025-02-25 14:26:16.230548,11.547775
channel-6994,1325412,30330254,30330266,12,2025-02-25 14:26:24.972933,2025-02-25 14:26:39.501120,14.528187
channel-6994,1325413,30330277,30330289,12,2025-02-25 14:26:53.032081,2025-02-25 14:27:09.432747,16.400666
channel-6994,1325414,30330321,30330330,9,2025-02-25 14:27:47.967890,2025-02-25 14:28:00.780086,12.812196
channel-6994,1325415,30330342,30330352,10,2025-02-25 14:28:19.262743,2025-02-25 14:28:31.053979,11.791236
channel-6994,1325416,30330386,30330397,11,2025-02-25 14:29:15.524589,2025-02-25 14:29:29.690459,14.16587
channel-6994,1325417,30330394,30330409,15,2025-02-25 14:29:25.416699,2025-02-25 14:29:43.414482,17.997783
channel-6994,1325418,30330440,30330454,14,2025-02-25 14:30:27.731609,2025-02-25 14:30:45.387715,17.656106
channel-6994,1325419,30330476,30330487,11,2025-02-25 14:31:14.124884,2025-02-25 14:31:26.819667,12.694783
channel-6994,1325420,30330496,30330507,11,2025-02-25 14:31:37.732936,2025-02-25 14:31:52.185405,14.452469
channel-6994,1325421,30330507,30330541,34,2025-02-25 14:31:52.185405,2025-02-25 14:32:35.770551,43.585146
channel-6994,1325422,30330509,30330519,10,2025-02-25 14:31:54.410054,2025-02-25 14:32:08.842296,14.432242
channel-6994,1325423,30330539,30330550,11,2025-02-25 14:32:33.265698,2025-02-25 14:32:47.102150,13.836452
channel-6994,1325424,30330589,30330625,36,2025-02-25 14:33:37.728515,2025-02-25 14:34:27.360933,49.632418
channel-6994,1325425,30330599,30330609,10,2025-02-25 14:33:50.245146,2025-02-25 14:34:05.760551,15.515405
channel-6994,1325426,30330603,30330613,10,2025-02-25 14:33:56.516162,2025-02-25 14:34:11.379824,14.863662
channel-6994,1325427,30330642,30330652,10,2025-02-25 14:34:50.924481,2025-02-25 14:35:02.388145,11.463664
channel-6994,1325428,30330663,30330675,12,2025-02-25 14:35:16.701357,2025-02-25 14:35:30.286719,13.585362
channel-6994,1325429,30330695,30330706,11,2025-02-25 14:35:58.067807,2025-02-25 14:36:10.647274,12.579467
channel-6994,1325430,30330804,30330817,13,2025-02-25 14:38:18.835690,2025-02-25 14:38:34.908100,16.07241
channel-6994,1325431,30330814,30330828,14,2025-02-25 14:38:30.998046,2025-02-25 14:38:49.056163,18.058117
channel-6994,1325432,30330820,30330832,12,2025-02-25 14:38:39.506707,2025-02-25 14:38:53.671418,14.164711
channel-6994,1325433,30330848,30330885,37,2025-02-25 14:39:16.204251,2025-02-25 14:40:04.760278,48.556027
channel-6994,1325434,30330914,30330958,44,2025-02-25 14:40:42.847435,2025-02-25 14:41:44.128518,61.281083
channel-6994,1325435,30330934,30330945,11,2025-02-25 14:41:07.224147,2025-02-25 14:41:22.267392,15.043245
channel-6994,1325436,30330937,30330945,8,2025-02-25 14:41:10.727831,2025-02-25 14:41:22.267392,11.539561
channel-6994,1325437,30330959,30330974,15,2025-02-25 14:41:45.398773,2025-02-25 14:42:02.853579,17.454806
channel-6994,1325438,30330990,30331036,46,2025-02-25 14:42:23.097144,2025-02-25 14:43:20.472610,57.375466
channel-6994,1325439,30331017,30331027,10,2025-02-25 14:42:58.773119,2025-02-25 14:43:10.464909,11.69179
channel-6994,1325440,30331068,30331076,8,2025-02-25 14:44:09.165479,2025-02-25 14:44:19.500258,10.334779
channel-6994,1325441,30331163,30331173,10,2025-02-25 14:46:10.720164,2025-02-25 14:46:24.856679,14.136515
channel-6994,1325442,30331225,30331239,14,2025-02-25 14:47:33.548472,2025-02-25 14:47:49.625058,16.076586
channel-6994,1325443,30331226,30331239,13,2025-02-25 14:47:34.610489,2025-02-25 14:47:49.625058,15.014569
channel-6994,1325444,30331238,30331247,9,2025-02-25 14:47:48.521652,2025-02-25 14:48:01.205078,12.683426
channel-6994,1325445,30331280,30331290,10,2025-02-25 14:48:47.039727,2025-02-25 14:48:59.128225,12.088498
channel-6994,1325446,30331286,30331294,8,2025-02-25 14:48:54.189355,2025-02-25 14:49:04.827881,10.638526
channel-6994,1325447,30331286,30331294,8,2025-02-25 14:48:54.189355,2025-02-25 14:49:04.827881,10.638526
channel-6994,1325448,30331297,30331309,12,2025-02-25 14:49:09.780922,2025-02-25 14:49:23.268075,13.487153
channel-6994,1325449,30331310,30331351,41,2025-02-25 14:49:25.352742,2025-02-25 14:50:16.800536,51.447794
channel-6994,1325450,30331326,30331337,11,2025-02-25 14:49:44.692011,2025-02-25 14:49:57.875172,13.183161
channel-6994,1325451,30331330,30331346,16,2025-02-25 14:49:49.392794,2025-02-25 14:50:11.066774,21.67398
channel-6994,1325452,30331335,30331346,11,2025-02-25 14:49:55.642375,2025-02-25 14:50:11.066774,15.424399
channel-6994,1325453,30331341,30331351,10,2025-02-25 14:50:04.562950,2025-02-25 14:50:16.800536,12.237586
channel-6994,1325454,30331346,30331355,9,2025-02-25 14:50:11.066774,2025-02-25 14:50:21.647568,10.580794
channel-6994,1325455,30331371,30331381,10,2025-02-25 14:50:42.582234,2025-02-25 14:50:55.830328,13.248094
channel-6994,1325456,30331388,30331426,38,2025-02-25 14:51:06.581623,2025-02-25 14:51:56.330844,49.749221
channel-6994,1325457,30331391,30331402,11,2025-02-25 14:51:12.075435,2025-02-25 14:51:26.501045,14.42561
channel-6994,1325458,30331428,30331438,10,2025-02-25 14:51:58.592705,2025-02-25 14:52:12.204019,13.611314
channel-6994,1325459,30331453,30331488,35,2025-02-25 14:52:30.189852,2025-02-25 14:53:17.760030,47.570178
channel-6994,1325460,30331531,30331564,33,2025-02-25 14:54:15.143353,2025-02-25 14:54:58.389566,43.246213
channel-6994,1325461,30331599,30331612,13,2025-02-25 14:55:45.126040,2025-02-25 14:56:00.950928,15.824888
channel-6994,1325462,30331600,30331612,12,2025-02-25 14:55:46.285930,2025-02-25 14:56:00.950928,14.664998
channel-6994,1325463,30331720,30331728,8,2025-02-25 14:58:20.923194,2025-02-25 14:58:33.342755,12.419561
channel-6994,1325464,30331859,30331893,34,2025-02-25 15:01:24.068059,2025-02-25 15:02:12.199784,48.131725
channel-6994,1325465,30331896,30331923,27,2025-02-25 15:02:15.809713,2025-02-25 15:02:50.553082,34.743369
channel-6994,1325466,30331899,30331910,11,2025-02-25 15:02:19.080258,2025-02-25 15:02:33.942410,14.862152
channel-6994,1325467,30331934,30331945,11,2025-02-25 15:03:04.455650,2025-02-25 15:03:18.999688,14.544038
channel-6994,1325468,30331935,30331945,10,2025-02-25 15:03:05.573387,2025-02-25 15:03:18.999688,13.426301
channel-6994,1325469,30331942,30331976,34,2025-02-25 15:03:15.595216,2025-02-25 15:03:56.804731,41.209515
channel-6994,1325470,30331966,30331976,10,2025-02-25 15:03:43.270004,2025-02-25 15:03:56.804731,13.534727
channel-6994,1325471,30332019,30332031,12,2025-02-25 15:04:55.984262,2025-02-25 15:05:11.299137,15.314875
channel-6994,1325472,30332080,30332091,11,2025-02-25 15:06:17.307418,2025-02-25 15:06:31.502347,14.194929
channel-6994,1325473,30332180,30332191,11,2025-02-25 15:08:29.726224,2025-02-25 15:08:43.922171,14.195947
channel-6994,1325474,30332196,30332206,10,2025-02-25 15:08:49.511309,2025-02-25 15:09:01.919787,12.408478
channel-6994,1325475,30332232,30332244,12,2025-02-25 15:09:34.988014,2025-02-25 15:09:49.111241,14.123227
channel-6994,1325476,30332264,30332272,8,2025-02-25 15:10:19.866684,2025-02-25 15:10:30.932837,11.066153
channel-6994,1325477,30332290,30332299,9,2025-02-25 15:10:52.514682,2025-02-25 15:11:06.375538,13.860856
channel-6994,1325478,30332375,30332386,11,2025-02-25 15:12:45.198403,2025-02-25 15:12:59.938865,14.740462
channel-6994,1325479,30332417,30332427,10,2025-02-25 15:13:41.657531,2025-02-25 15:13:52.830246,11.172715
channel-6994,1325480,30332510,30332521,11,2025-02-25 15:15:44.516685,2025-02-25 15:16:02.497140,17.980455
channel-6994,1325481,30332524,30332535,11,2025-02-25 15:16:05.837740,2025-02-25 15:16:18.987345,13.149605
channel-6994,1325482,30332597,30332609,12,2025-02-25 15:17:43.030255,2025-02-25 15:17:57.169839,14.139584
channel-6994,1325483,30332601,30332614,13,2025-02-25 15:17:48.106090,2025-02-25 15:18:03.377202,15.271112
channel-6994,1325484,30332719,30332730,11,2025-02-25 15:20:19.968926,2025-02-25 15:20:38.374448,18.405522
channel-6994,1325485,30332722,30332730,8,2025-02-25 15:20:26.846789,2025-02-25 15:20:38.374448,11.527659
channel-6994,1325486,30332727,30332740,13,2025-02-25 15:20:34.362659,2025-02-25 15:20:50.548230,16.185571
channel-6994,1325487,30332727,30332740,13,2025-02-25 15:20:34.362659,2025-02-25 15:20:50.548230,16.185571
channel-6994,1325488,30332735,30332743,8,2025-02-25 15:20:44.626569,2025-02-25 15:20:55.388898,10.762329
channel-6994,1325489,30332764,30332772,8,2025-02-25 15:21:22.486215,2025-02-25 15:21:34.383211,11.896996
channel-6994,1325490,30332829,30332837,8,2025-02-25 15:22:45.968493,2025-02-25 15:22:55.424255,9.455762
channel-6994,1325491,30332855,30332863,8,2025-02-25 15:23:17.716976,2025-02-25 15:23:32.065339,14.348363
channel-6994,1325492,30332858,30332867,9,2025-02-25 15:23:22.706926,2025-02-25 15:23:37.413060,14.706134
channel-6994,1325493,30332881,30332892,11,2025-02-25 15:23:55.643153,2025-02-25 15:24:09.354515,13.711362
channel-6994,1325494,30332896,30332910,14,2025-02-25 15:24:14.791072,2025-02-25 15:24:31.760596,16.969524
channel-6994,1325495,30332896,30332910,14,2025-02-25 15:24:14.791072,2025-02-25 15:24:31.760596,16.969524
channel-6994,1325496,30332905,30332915,10,2025-02-25 15:24:26.107513,2025-02-25 15:24:38.721207,12.613694
channel-6994,1325497,30332947,30332956,9,2025-02-25 15:25:24.565669,2025-02-25 15:25:36.028615,11.462946
channel-6994,1325498,30332995,30333007,12,2025-02-25 15:26:24.570951,2025-02-25 15:26:40.515564,15.944613
channel-6994,1325499,30333006,30333016,10,2025-02-25 15:26:38.342520,2025-02-25 15:26:52.629868,14.287348
channel-6994,1325500,30333129,30333137,8,2025-02-25 15:29:18.563458,2025-02-25 15:29:33.972038,15.40858
channel-6994,1325501,30333130,30333137,7,2025-02-25 15:29:20.862508,2025-02-25 15:29:33.972038,13.10953
channel-6994,1325502,30333166,30333177,11,2025-02-25 15:30:08.963183,2025-02-25 15:30:23.857291,14.894108
channel-6994,1325503,30333211,30333232,21,2025-02-25 15:31:13.575192,2025-02-25 15:31:40.426629,26.851437
channel-6994,1325504,30333279,30333290,11,2025-02-25 15:32:39.088984,2025-02-25 15:32:51.941564,12.85258
channel-6994,1325505,30333290,30333298,8,2025-02-25 15:32:51.941564,2025-02-25 15:33:04.139073,12.197509
channel-6994,1325506,30333313,30333325,12,2025-02-25 15:33:22.761822,2025-02-25 15:33:38.929181,16.167359
channel-6994,1325507,30333346,30333357,11,2025-02-25 15:34:07.807501,2025-02-25 15:34:24.376547,16.569046
channel-6994,1325508,30333375,30333389,14,2025-02-25 15:34:47.982627,2025-02-25 15:35:05.228603,17.245976
channel-6994,1325509,30333397,30333406,9,2025-02-25 15:35:17.388103,2025-02-25 15:35:29.463722,12.075619
channel-6994,1325510,30333432,30333443,11,2025-02-25 15:36:02.465655,2025-02-25 15:36:15.887478,13.421823
channel-6994,1325511,30333439,30333448,9,2025-02-25 15:36:10.583231,2025-02-25 15:36:22.783444,12.200213
channel-6994,1325512,30333443,30333451,8,2025-02-25 15:36:15.887478,2025-02-25 15:36:27.205888,11.31841
channel-6994,1325513,30333447,30333455,8,2025-02-25 15:36:21.456405,2025-02-25 15:36:32.935242,11.478837
channel-6994,1325514,30333504,30333513,9,2025-02-25 15:37:38.668448,2025-02-25 15:37:51.179979,12.511531
channel-6994,1325515,30333505,30333517,12,2025-02-25 15:37:40.858002,2025-02-25 15:37:56.814708,15.956706
channel-6994,1325516,30333529,30333542,13,2025-02-25 15:38:15.210195,2025-02-25 15:38:30.426652,15.216457
channel-6994,1325517,30333530,30333547,17,2025-02-25 15:38:16.344742,2025-02-25 15:38:36.984332,20.63959
channel-6994,1325518,30333540,30333550,10,2025-02-25 15:38:28.165449,2025-02-25 15:38:41.423578,13.258129
channel-6994,1325519,30333586,30333597,11,2025-02-25 15:39:32.512408,2025-02-25 15:39:47.263259,14.750851
channel-6994,1325520,30333625,30333634,9,2025-02-25 15:40:23.129332,2025-02-25 15:40:39.373420,16.244088
channel-6994,1325521,30333633,30333643,10,2025-02-25 15:40:34.057886,2025-02-25 15:40:49.795402,15.737516
channel-6994,1325522,30333653,30333662,9,2025-02-25 15:41:01.279775,2025-02-25 15:41:13.476468,12.196693
channel-6994,1325523,30333677,30333686,9,2025-02-25 15:41:32.333879,2025-02-25 15:41:43.130127,10.796248
channel-6994,1325524,30333772,30333783,11,2025-02-25 15:43:41.502205,2025-02-25 15:43:54.415738,12.913533
channel-6994,1325525,30333806,30333816,10,2025-02-25 15:44:22.228980,2025-02-25 15:44:35.044359,12.815379
channel-6994,1325526,30333849,30333860,11,2025-02-25 15:45:20.885781,2025-02-25 15:45:39.528996,18.643215
channel-6994,1325527,30333874,30333885,11,2025-02-25 15:46:00.120941,2025-02-25 15:46:15.034086,14.913145
channel-6994,1325528,30333874,30333885,11,2025-02-25 15:46:00.120941,2025-02-25 15:46:15.034086,14.913145
channel-6994,1325529,30333877,30333889,12,2025-02-25 15:46:04.477321,2025-02-25 15:46:20.956396,16.479075
channel-6994,1325530,30333952,30333974,22,2025-02-25 15:47:41.265675,2025-02-25 15:48:15.220821,33.955146
channel-6994,1325531,30333956,30333962,6,2025-02-25 15:47:47.629928,2025-02-25 15:47:54.514211,6.884283
channel-6994,1325532,30334057,30334069,12,2025-02-25 15:50:03.634491,2025-02-25 15:50:17.879360,14.244869
channel-6994,1325533,30334129,30334138,9,2025-02-25 15:51:35.415237,2025-02-25 15:51:46.773207,11.35797
channel-6994,1325534,30334151,30334160,9,2025-02-25 15:52:03.476542,2025-02-25 15:52:15.737325,12.260783
channel-6994,1325535,30334174,30334185,11,2025-02-25 15:52:34.809272,2025-02-25 15:52:51.076988,16.267716
channel-6994,1325536,30334195,30334205,10,2025-02-25 15:53:05.217795,2025-02-25 15:53:21.825133,16.607338
channel-6994,1325537,30334195,30334205,10,2025-02-25 15:53:05.217795,2025-02-25 15:53:21.825133,16.607338
channel-6994,1325538,30334223,30334230,7,2025-02-25 15:53:43.957922,2025-02-25 15:53:56.490808,12.532886
channel-6994,1325539,30334230,30334248,18,2025-02-25 15:53:56.490808,2025-02-25 15:54:20.085136,23.594328
channel-6994,1325540,30334254,30334267,13,2025-02-25 15:54:27.599395,2025-02-25 15:54:44.661884,17.062489
channel-6994,1325541,30334273,30334283,10,2025-02-25 15:54:51.783158,2025-02-25 15:55:05.335876,13.552718
channel-6994,1325542,30334296,30334308,12,2025-02-25 15:55:21.943210,2025-02-25 15:55:36.801248,14.858038
channel-6994,1325543,30334327,30334340,13,2025-02-25 15:56:04.179983,2025-02-25 15:56:22.027584,17.847601
channel-6994,1325544,30334348,30334358,10,2025-02-25 15:56:32.039353,2025-02-25 15:56:46.917696,14.878343
channel-6994,1325545,30334429,30334439,10,2025-02-25 15:58:24.093989,2025-02-25 15:58:36.787656,12.693667
channel-6994,1325546,30334469,30334481,12,2025-02-25 15:59:12.589679,2025-02-25 15:59:28.304872,15.715193
channel-6994,1325547,30334509,30334519,10,2025-02-25 16:00:05.234097,2025-02-25 16:00:18.726623,13.492526
channel-6994,1325548,30334543,30334552,9,2025-02-25 16:00:52.443870,2025-02-25 16:01:05.805822,13.361952
channel-6994,1325549,30334587,30334596,9,2025-02-25 16:01:50.761813,2025-02-25 16:02:06.434753,15.67294
channel-6994,1325550,30334610,30334619,9,2025-02-25 16:02:23.299758,2025-02-25 16:02:34.844455,11.544697
channel-6994,1325551,30334639,30334650,11,2025-02-25 16:03:01.237893,2025-02-25 16:03:15.743638,14.505745
channel-6994,1325552,30334683,30334690,7,2025-02-25 16:03:57.824215,2025-02-25 16:04:09.916904,12.092689
channel-6994,1325553,30334707,30334719,12,2025-02-25 16:04:31.553962,2025-02-25 16:04:45.462528,13.908566
channel-6994,1325554,30334730,30334742,12,2025-02-25 16:04:59.684680,2025-02-25 16:05:14.407905,14.723225
channel-6994,1325555,30334756,30334765,9,2025-02-25 16:05:31.391527,2025-02-25 16:05:48.128376,16.736849
channel-6994,1325556,30334764,30334774,10,2025-02-25 16:05:46.844136,2025-02-25 16:05:59.568359,12.724223
channel-6994,1325557,30334767,30334778,11,2025-02-25 16:05:50.394013,2025-02-25 16:06:04.547981,14.153968
channel-6994,1325558,30334794,30334804,10,2025-02-25 16:06:24.188918,2025-02-25 16:06:39.855462,15.666544
channel-6994,1325559,30334870,30334880,10,2025-02-25 16:08:07.829255,2025-02-25 16:08:19.888598,12.059343
channel-6994,1325560,30334943,30334967,24,2025-02-25 16:09:41.588427,2025-02-25 16:10:12.871794,31.283367
channel-6994,1325561,30334946,30334953,7,2025-02-25 16:09:46.128258,2025-02-25 16:09:55.166711,9.038453
channel-6994,1325562,30335056,30335066,10,2025-02-25 16:12:12.366339,2025-02-25 16:12:26.738237,14.371898
channel-6994,1325563,30335095,30335103,8,2025-02-25 16:13:03.487988,2025-02-25 16:13:13.821688,10.3337
channel-6994,1325564,30335105,30335114,9,2025-02-25 16:13:16.035361,2025-02-25 16:13:29.968745,13.933384
channel-6994,1325565,30335135,30335147,12,2025-02-25 16:13:56.184061,2025-02-25 16:14:12.240023,16.055962
channel-6994,1325566,30335147,30335157,10,2025-02-25 16:14:12.240023,2025-02-25 16:14:23.801923,11.5619
channel-6994,1325567,30335178,30335187,9,2025-02-25 16:14:50.962006,2025-02-25 16:15:05.161775,14.199769
channel-6994,1325568,30335198,30335208,10,2025-02-25 16:15:19.575039,2025-02-25 16:15:32.476475,12.901436
channel-6994,1325569,30335232,30335245,13,2025-02-25 16:16:06.248923,2025-02-25 16:16:23.020606,16.771683
channel-6994,1325570,30335247,30335257,10,2025-02-25 16:16:25.383624,2025-02-25 16:16:37.941640,12.558016
channel-6994,1325571,30335270,30335282,12,2025-02-25 16:16:56.046269,2025-02-25 16:17:11.896384,15.850115
channel-6994,1325572,30335286,30335297,11,2025-02-25 16:17:16.812976,2025-02-25 16:17:30.463466,13.65049
channel-6994,1325573,30335306,30335315,9,2025-02-25 16:17:42.485998,2025-02-25 16:17:53.078883,10.592885
channel-6994,1325574,30335347,30335355,8,2025-02-25 16:18:33.261622,2025-02-25 16:18:45.670479,12.408857
channel-6994,1325575,30335361,30335372,11,2025-02-25 16:18:54.751281,2025-02-25 16:19:09.821301,15.07002
channel-6994,1325576,30335433,30335442,9,2025-02-25 16:20:29.379000,2025-02-25 16:20:41.359822,11.980822
channel-6994,1325577,30335445,30335454,9,2025-02-25 16:20:44.955514,2025-02-25 16:20:58.493889,13.538375
channel-6994,1325578,30335476,30335486,10,2025-02-25 16:21:25.992440,2025-02-25 16:21:37.321853,11.329413
channel-6994,1325579,30335478,30335505,27,2025-02-25 16:21:28.327392,2025-02-25 16:22:03.921939,35.594547
channel-6994,1325580,30335514,30335521,7,2025-02-25 16:22:14.903492,2025-02-25 16:22:26.566507,11.663015
channel-6994,1325581,30335515,30335527,12,2025-02-25 16:22:15.997843,2025-02-25 16:22:33.473870,17.476027
channel-6994,1325582,30335527,30335537,10,2025-02-25 16:22:33.473870,2025-02-25 16:22:45.645367,12.171497
channel-6994,1325583,30335545,30335555,10,2025-02-25 16:22:56.739106,2025-02-25 16:23:09.304405,12.565299
channel-6994,1325584,30335548,30335559,11,2025-02-25 16:23:01.415349,2025-02-25 16:23:14.871238,13.455889
channel-6994,1325585,30335563,30335573,10,2025-02-25 16:23:19.390675,2025-02-25 16:23:33.072837,13.682162
channel-6994,1325586,30335566,30335576,10,2025-02-25 16:23:23.121051,2025-02-25 16:23:37.379477,14.258426
channel-6994,1325587,30335673,30335684,11,2025-02-25 16:25:48.418394,2025-02-25 16:26:00.773463,12.355069
channel-6994,1325588,30335697,30335707,10,2025-02-25 16:26:19.849151,2025-02-25 16:26:33.451206,13.602055
channel-6994,1325589,30335719,30335728,9,2025-02-25 16:26:48.523868,2025-02-25 16:27:01.154736,12.630868
channel-6994,1325590,30335817,30335828,11,2025-02-25 16:28:52.910181,2025-02-25 16:29:07.815799,14.905618
channel-6994,1325591,30335824,30335837,13,2025-02-25 16:29:02.161244,2025-02-25 16:29:18.647605,16.486361
channel-6994,1325592,30335910,30335921,11,2025-02-25 16:30:59.951780,2025-02-25 16:31:12.546773,12.594993
channel-6994,1325593,30335932,30335943,11,2025-02-25 16:31:26.230800,2025-02-25 16:31:41.281216,15.050416
channel-6994,1325594,30335954,30335963,9,2025-02-25 16:31:54.710924,2025-02-25 16:32:05.281262,10.570338
channel-6994,1325595,30335974,30335983,9,2025-02-25 16:32:18.446823,2025-02-25 16:32:32.749802,14.302979
channel-6994,1325596,30335992,30336009,17,2025-02-25 16:32:44.763120,2025-02-25 16:33:05.915517,21.152397
channel-6994,1325597,30336010,30336018,8,2025-02-25 16:33:07.168110,2025-02-25 16:33:20.776342,13.608232
channel-6994,1325598,30336020,30336031,11,2025-02-25 16:33:23.076505,2025-02-25 16:33:38.608843,15.532338
channel-6994,1325599,30336077,30336088,11,2025-02-25 16:34:38.996494,2025-02-25 16:34:53.292886,14.296392
channel-6994,1325600,30336081,30336093,12,2025-02-25 16:34:44.834970,2025-02-25 16:34:58.887102,14.052132
channel-6994,1325601,30336086,30336097,11,2025-02-25 16:34:50.952166,2025-02-25 16:35:04.175237,13.223071
channel-6994,1325602,30336091,30336102,11,2025-02-25 16:34:56.717257,2025-02-25 16:35:11.199575,14.482318
channel-6994,1325603,30336151,30336163,12,2025-02-25 16:36:13.692111,2025-02-25 16:36:27.623137,13.931026
channel-6994,1325604,30336161,30336172,11,2025-02-25 16:36:25.432235,2025-02-25 16:36:39.490047,14.057812
channel-6994,1325605,30336179,30336188,9,2025-02-25 16:36:48.819881,2025-02-25 16:37:03.310781,14.4909
channel-6994,1325606,30336189,30336202,13,2025-02-25 16:37:04.479179,2025-02-25 16:37:22.052100,17.572921
channel-6994,1325607,30336207,30336220,13,2025-02-25 16:37:28.810235,2025-02-25 16:37:43.540749,14.730514
channel-6994,1325608,30336237,30336246,9,2025-02-25 16:38:05.168908,2025-02-25 16:38:16.809301,11.640393
channel-6994,1325609,30336242,30336253,11,2025-02-25 16:38:10.807658,2025-02-25 16:38:29.693812,18.886154
channel-6994,1325610,30336249,30336258,9,2025-02-25 16:38:21.312875,2025-02-25 16:38:35.689192,14.376317
channel-6994,1325611,30336259,30336271,12,2025-02-25 16:38:36.741097,2025-02-25 16:38:52.197450,15.456353
channel-6994,1325612,30336267,30336295,28,2025-02-25 16:38:47.570255,2025-02-25 16:39:22.482099,34.911844
channel-6994,1325613,30336273,30336285,12,2025-02-25 16:38:54.596642,2025-02-25 16:39:09.939660,15.343018
channel-6994,1325614,30336275,30336285,10,2025-02-25 16:38:57.119976,2025-02-25 16:39:09.939660,12.819684
channel-6994,1325615,30336311,30336322,11,2025-02-25 16:39:42.994102,2025-02-25 16:39:56.684933,13.690831
channel-6994,1325616,30336340,30336349,9,2025-02-25 16:40:27.108167,2025-02-25 16:40:40.689646,13.581479
channel-6994,1325617,30336356,30336366,10,2025-02-25 16:40:50.137214,2025-02-25 16:41:02.319101,12.181887
channel-6994,1325618,30336379,30336389,10,2025-02-25 16:41:18.105841,2025-02-25 16:41:31.558534,13.452693
channel-6994,1325619,30336385,30336394,9,2025-02-25 16:41:25.565349,2025-02-25 16:41:37.968200,12.402851
channel-6994,1325620,30336406,30336415,9,2025-02-25 16:41:51.640897,2025-02-25 16:42:04.724797,13.0839
channel-6994,1325621,30336418,30336432,14,2025-02-25 16:42:09.323209,2025-02-25 16:42:26.349172,17.025963
channel-6994,1325622,30336426,30336435,9,2025-02-25 16:42:18.775039,2025-02-25 16:42:31.085528,12.310489
channel-6994,1325623,30336433,30336444,11,2025-02-25 16:42:27.503825,2025-02-25 16:42:42.055638,14.551813
channel-6994,1325624,30336435,30336449,14,2025-02-25 16:42:31.085528,2025-02-25 16:42:47.922170,16.836642
channel-6994,1325625,30336435,30336449,14,2025-02-25 16:42:31.085528,2025-02-25 16:42:47.922170,16.836642
channel-6994,1325626,30336437,30336460,23,2025-02-25 16:42:33.165933,2025-02-25 16:43:05.405902,32.239969
channel-6994,1325627,30336464,30336473,9,2025-02-25 16:43:09.876673,2025-02-25 16:43:22.766540,12.889867
channel-6994,1325628,30336510,30336520,10,2025-02-25 16:44:11.312389,2025-02-25 16:44:25.221464,13.909075
channel-6994,1325629,30336541,30336552,11,2025-02-25 16:44:56.698195,2025-02-25 16:45:08.920822,12.222627
channel-6994,1325630,30336561,30336571,10,2025-02-25 16:45:19.978414,2025-02-25 16:45:32.779476,12.801062
channel-6994,1325631,30336585,30336598,13,2025-02-25 16:45:51.950563,2025-02-25 16:46:09.464855,17.514292
channel-6994,1325632,30336586,30336612,26,2025-02-25 16:45:53.053820,2025-02-25 16:46:25.572514,32.518694
channel-6994,1325633,30336606,30336616,10,2025-02-25 16:46:18.684922,2025-02-25 16:46:31.604345,12.919423
channel-6994,1325634,30336607,30336639,32,2025-02-25 16:46:19.808024,2025-02-25 16:47:00.412089,40.604065
channel-6994,1325635,30336662,30336673,11,2025-02-25 16:47:29.360732,2025-02-25 16:47:43.359686,13.998954
channel-6994,1325636,30336673,30336683,10,2025-02-25 16:47:43.359686,2025-02-25 16:48:02.399119,19.039433
channel-6994,1325637,30336685,30336694,9,2025-02-25 16:48:04.865598,2025-02-25 16:48:19.124853,14.259255
channel-6994,1325638,30336690,30336699,9,2025-02-25 16:48:13.914406,2025-02-25 16:48:24.990579,11.076173
channel-6994,1325639,30336717,30336729,12,2025-02-25 16:48:48.213019,2025-02-25 16:49:05.163854,16.950835
channel-6994,1325640,30336720,30336729,9,2025-02-25 16:48:52.663285,2025-02-25 16:49:05.163854,12.500569
channel-6994,1325641,30336741,30336753,12,2025-02-25 16:49:19.822892,2025-02-25 16:49:33.851477,14.028585
channel-6994,1325642,30336769,30336779,10,2025-02-25 16:49:56.869332,2025-02-25 16:50:08.302957,11.433625
channel-6994,1325643,30336780,30336789,9,2025-02-25 16:50:09.452563,2025-02-25 16:50:19.929535,10.476972
channel-6994,1325644,30336792,30336803,11,2025-02-25 16:50:24.847445,2025-02-25 16:50:39.216062,14.368617
channel-6994,1325645,30336803,30336813,10,2025-02-25 16:50:39.216062,2025-02-25 16:50:52.888695,13.672633
channel-6994,1325646,30336816,30336827,11,2025-02-25 16:50:56.157262,2025-02-25 16:51:09.672719,13.515457
channel-6994,1325647,30336843,30336852,9,2025-02-25 16:51:37.689820,2025-02-25 16:51:49.200240,11.51042
channel-6994,1325648,30336855,30336866,11,2025-02-25 16:51:53.679952,2025-02-25 16:52:07.414412,13.73446
channel-6994,1325649,30336858,30336870,12,2025-02-25 16:51:58.159602,2025-02-25 16:52:12.292667,14.133065
channel-6994,1325650,30336858,30336870,12,2025-02-25 16:51:58.159602,2025-02-25 16:52:12.292667,14.133065
channel-6994,1325651,30336882,30336891,9,2025-02-25 16:52:29.277434,2025-02-25 16:52:39.905947,10.628513
channel-6994,1325652,30336893,30336903,10,2025-02-25 16:52:43.369491,2025-02-25 16:52:56.324364,12.954873
channel-6994,1325653,30336904,30336914,10,2025-02-25 16:52:57.416556,2025-02-25 16:53:09.186747,11.770191
channel-6994,1325654,30336904,30336914,10,2025-02-25 16:52:57.416556,2025-02-25 16:53:09.186747,11.770191
channel-6994,1325655,30336925,30336936,11,2025-02-25 16:53:22.728652,2025-02-25 16:53:37.452185,14.723533
channel-6994,1325656,30336943,30336953,10,2025-02-25 16:53:45.529491,2025-02-25 16:53:59.897890,14.368399
channel-6994,1325657,30336952,30336962,10,2025-02-25 16:53:57.749781,2025-02-25 16:54:11.600900,13.851119
channel-6994,1325658,30336962,30336971,9,2025-02-25 16:54:11.600900,2025-02-25 16:54:23.200889,11.599989
channel-6994,1325659,30336973,30336985,12,2025-02-25 16:54:25.404474,2025-02-25 16:54:40.781663,15.377189
channel-6994,1325660,30337001,30337012,11,2025-02-25 16:55:02.531569,2025-02-25 16:55:15.951902,13.420333
channel-6994,1325661,30337042,30337051,9,2025-02-25 16:55:57.227834,2025-02-25 16:56:08.900812,11.672978
channel-6994,1325662,30337043,30337104,61,2025-02-25 16:55:58.278021,2025-02-25 16:57:19.404173,81.126152
channel-6994,1325663,30337057,30337069,12,2025-02-25 16:56:16.305772,2025-02-25 16:56:31.225399,14.919627
channel-6994,1325664,30337064,30337077,13,2025-02-25 16:56:24.511773,2025-02-25 16:56:41.488258,16.976485
channel-6994,1325665,30337066,30337108,42,2025-02-25 16:56:27.794521,2025-02-25 16:57:27.870754,60.076233
channel-6994,1325666,30337072,30337082,10,2025-02-25 16:56:34.815554,2025-02-25 16:56:48.341607,13.526053
channel-6994,1325667,30337075,30337084,9,2025-02-25 16:56:39.183869,2025-02-25 16:56:53.909253,14.725384
channel-6994,1325668,30337083,30337093,10,2025-02-25 16:56:49.509654,2025-02-25 16:57:05.388038,15.878384
channel-6994,1325669,30337096,30337104,8,2025-02-25 16:57:09.179368,2025-02-25 16:57:19.404173,10.224805
channel-6994,1325670,30337101,30337108,7,2025-02-25 16:57:15.972697,2025-02-25 16:57:27.870754,11.898057
channel-6994,1325671,30337105,30337120,15,2025-02-25 16:57:24.693930,2025-02-25 16:57:42.632880,17.93895
channel-6994,1325672,30337106,30337120,14,2025-02-25 16:57:25.744222,2025-02-25 16:57:42.632880,16.888658
channel-6994,1325673,30337132,30337142,10,2025-02-25 16:57:58.140186,2025-02-25 16:58:11.006461,12.866275
channel-6994,1325674,30337144,30337214,70,2025-02-25 16:58:14.477309,2025-02-25 16:59:49.194195,94.716886
channel-6994,1325675,30337152,30337161,9,2025-02-25 16:58:23.532504,2025-02-25 16:58:34.688555,11.156051
channel-6994,1325676,30337168,30337179,11,2025-02-25 16:58:44.187455,2025-02-25 16:59:00.561522,16.374067
channel-6994,1325677,30337184,30337191,7,2025-02-25 16:59:06.236007,2025-02-25 16:59:14.682732,8.446725
channel-6994,1325678,30337194,30337203,9,2025-02-25 16:59:24.178276,2025-02-25 16:59:35.485590,11.307314
channel-6994,1325679,30337212,30337221,9,2025-02-25 16:59:46.875065,2025-02-25 16:59:58.659785,11.78472
channel-6994,1325680,30337214,30337226,12,2025-02-25 16:59:49.194195,2025-02-25 17:00:04.930404,15.736209
channel-6994,1325681,30337244,30337257,13,2025-02-25 17:00:30.558503,2025-02-25 17:00:46.586916,16.028413
channel-6994,1325682,30337257,30337279,22,2025-02-25 17:00:46.586916,2025-02-25 17:01:14.946175,28.359259
channel-6994,1325683,30337266,30337275,9,2025-02-25 17:00:56.693860,2025-02-25 17:01:08.269966,11.576106
channel-6994,1325684,30337267,30337279,12,2025-02-25 17:00:57.870815,2025-02-25 17:01:14.946175,17.07536
channel-6994,1325685,30337273,30337283,10,2025-02-25 17:01:05.972360,2025-02-25 17:01:20.926205,14.953845
channel-6994,1325686,30337310,30337321,11,2025-02-25 17:01:58.170516,2025-02-25 17:02:11.913055,13.742539
channel-6994,1325687,30337320,30337329,9,2025-02-25 17:02:10.729392,2025-02-25 17:02:23.697433,12.968041
channel-6994,1325688,30337348,30337358,10,2025-02-25 17:02:49.646053,2025-02-25 17:03:01.607932,11.961879
channel-6994,1325689,30337358,30337367,9,2025-02-25 17:03:01.607932,2025-02-25 17:03:13.341087,11.733155
channel-6994,1325690,30337376,30337385,9,2025-02-25 17:03:23.636675,2025-02-25 17:03:34.625316,10.988641
channel-6994,1325691,30337384,30337394,10,2025-02-25 17:03:32.931376,2025-02-25 17:03:47.828865,14.897489
channel-6994,1325692,30337384,30337394,10,2025-02-25 17:03:32.931376,2025-02-25 17:03:47.828865,14.897489
channel-6994,1325693,30337388,30337399,11,2025-02-25 17:03:40.010833,2025-02-25 17:03:54.091261,14.080428
channel-6994,1325694,30337399,30337409,10,2025-02-25 17:03:54.091261,2025-02-25 17:04:05.549169,11.457908
channel-6994,1325695,30337408,30337435,27,2025-02-25 17:04:04.442274,2025-02-25 17:04:37.920456,33.478182
channel-6994,1325696,30337410,30337422,12,2025-02-25 17:04:06.850478,2025-02-25 17:04:21.834220,14.983742
channel-6994,1325697,30337410,30337422,12,2025-02-25 17:04:06.850478,2025-02-25 17:04:21.834220,14.983742
channel-6994,1325698,30337423,30337433,10,2025-02-25 17:04:23.022426,2025-02-25 17:04:34.558490,11.536064
channel-6994,1325699,30337425,30337436,11,2025-02-25 17:04:25.410878,2025-02-25 17:04:38.948948,13.53807
channel-6994,1325700,30337434,30337444,10,2025-02-25 17:04:35.690921,2025-02-25 17:04:50.420061,14.72914
channel-6994,1325701,30337444,30337453,9,2025-02-25 17:04:50.420061,2025-02-25 17:05:03.275307,12.855246
channel-6994,1325702,30337447,30337476,29,2025-02-25 17:04:54.059926,2025-02-25 17:05:31.063591,37.003665
channel-6994,1325703,30337571,30337584,13,2025-02-25 17:07:40.120153,2025-02-25 17:07:56.670862,16.550709
channel-6994,1325704,30337620,30337632,12,2025-02-25 17:08:41.838388,2025-02-25 17:08:57.987130,16.148742
channel-6994,1325705,30337632,30337643,11,2025-02-25 17:08:57.987130,2025-02-25 17:09:11.406238,13.419108
channel-6994,1325706,30337678,30337687,9,2025-02-25 17:09:58.357413,2025-02-25 17:10:09.336470,10.979057
channel-6994,1325707,30337679,30337703,24,2025-02-25 17:10:00.092332,2025-02-25 17:10:32.310758,32.218426
channel-6994,1325708,30337700,30337712,12,2025-02-25 17:10:25.583801,2025-02-25 17:10:45.302846,19.719045
channel-6994,1325709,30337701,30337712,11,2025-02-25 17:10:26.677385,2025-02-25 17:10:45.302846,18.625461
channel-6994,1325710,30337731,30337741,10,2025-02-25 17:11:13.222856,2025-02-25 17:11:25.769108,12.546252
channel-6994,1325711,30337740,30337750,10,2025-02-25 17:11:23.473686,2025-02-25 17:11:36.591060,13.117374
channel-6994,1325712,30337771,30337780,9,2025-02-25 17:12:05.290153,2025-02-25 17:12:15.947307,10.657154
channel-6994,1325713,30337796,30337806,10,2025-02-25 17:12:36.098193,2025-02-25 17:12:49.263732,13.165539
channel-6994,1325714,30337833,30337841,8,2025-02-25 17:13:24.625593,2025-02-25 17:13:37.294601,12.669008
channel-6994,1325715,30337849,30337860,11,2025-02-25 17:13:46.945910,2025-02-25 17:13:59.663740,12.71783
channel-6994,1325716,30337855,30337869,14,2025-02-25 17:13:53.981381,2025-02-25 17:14:10.829726,16.848345
channel-6994,1325717,30337867,30337878,11,2025-02-25 17:14:07.583708,2025-02-25 17:14:23.014254,15.430546
channel-6994,1325718,30337871,30337882,11,2025-02-25 17:14:14.497876,2025-02-25 17:14:28.219025,13.721149
channel-6994,1325719,30337906,30337917,11,2025-02-25 17:14:59.417110,2025-02-25 17:15:15.819731,16.402621
channel-6994,1325720,30337907,30337917,10,2025-02-25 17:15:00.503029,2025-02-25 17:15:15.819731,15.316702
channel-6994,1325721,30337945,30337957,12,2025-02-25 17:15:52.419191,2025-02-25 17:16:06.390555,13.971364
channel-6994,1325722,30337965,30337972,7,2025-02-25 17:16:48.953369,2025-02-25 17:16:59.102962,10.149593
channel-6994,1325723,30337972,30337978,6,2025-02-25 17:16:59.102962,2025-02-25 17:17:14.952150,15.849188
channel-6994,1325724,30337972,30337978,6,2025-02-25 17:16:59.102962,2025-02-25 17:17:14.952150,15.849188
channel-6994,1325725,30337984,30337993,9,2025-02-25 17:17:22.356478,2025-02-25 17:17:39.216839,16.860361
channel-6994,1325726,30337997,30338004,7,2025-02-25 17:17:43.618640,2025-02-25 17:17:52.853749,9.235109
channel-6994,1325727,30338039,30338050,11,2025-02-25 17:18:40.262960,2025-02-25 17:18:53.544503,13.281543
channel-6994,1325728,30338050,30338058,8,2025-02-25 17:18:53.544503,2025-02-25 17:19:03.923246,10.378743
channel-6994,1325729,30338054,30338062,8,2025-02-25 17:18:59.277662,2025-02-25 17:19:10.093339,10.815677
channel-6994,1325730,30338058,30338066,8,2025-02-25 17:19:03.923246,2025-02-25 17:19:14.686057,10.762811
channel-6994,1325731,30338069,30338079,10,2025-02-25 17:19:19.350668,2025-02-25 17:19:32.636635,13.285967
channel-6994,1325732,30338079,30338088,9,2025-02-25 17:19:32.636635,2025-02-25 17:19:44.555446,11.918811
channel-6994,1325733,30338114,30338126,12,2025-02-25 17:20:16.388775,2025-02-25 17:20:35.863496,19.474721
channel-6994,1325734,30338116,30338126,10,2025-02-25 17:20:18.710330,2025-02-25 17:20:35.863496,17.153166
channel-6994,1325735,30338117,30338126,9,2025-02-25 17:20:20.943433,2025-02-25 17:20:35.863496,14.920063
channel-6994,1325736,30338118,30338126,8,2025-02-25 17:20:22.139148,2025-02-25 17:20:35.863496,13.724348
channel-6994,1325737,30338119,30338144,25,2025-02-25 17:20:23.311911,2025-02-25 17:21:00.168594,36.856683
channel-6994,1325738,30338127,30338135,8,2025-02-25 17:20:37.207969,2025-02-25 17:20:47.612695,10.404726
channel-6994,1325739,30338129,30338144,15,2025-02-25 17:20:39.556228,2025-02-25 17:21:00.168594,20.612366
channel-6994,1325740,30338133,30338148,15,2025-02-25 17:20:44.259521,2025-02-25 17:21:06.116403,21.856882
channel-6994,1325741,30338139,30338148,9,2025-02-25 17:20:52.320346,2025-02-25 17:21:06.116403,13.796057
channel-6994,1325742,30338149,30338161,12,2025-02-25 17:21:07.345593,2025-02-25 17:21:22.860159,15.514566
channel-6994,1325743,30338209,30338218,9,2025-02-25 17:22:25.083051,2025-02-25 17:22:37.997415,12.914364
channel-6994,1325744,30338212,30338224,12,2025-02-25 17:22:29.141381,2025-02-25 17:22:45.074168,15.932787
channel-6994,1325745,30338230,30338239,9,2025-02-25 17:22:52.428199,2025-02-25 17:23:06.674701,14.246502
channel-6994,1325746,30338268,30338279,11,2025-02-25 17:23:43.916897,2025-02-25 17:23:58.744611,14.827714
channel-6994,1325747,30338295,30338309,14,2025-02-25 17:24:17.331227,2025-02-25 17:24:35.892722,18.561495
channel-6994,1325748,30338310,30338322,12,2025-02-25 17:24:37.219543,2025-02-25 17:24:52.726420,15.506877
channel-6994,1325749,30338339,30338345,6,2025-02-25 17:25:17.073871,2025-02-25 17:25:25.759906,8.686035
channel-6994,1325750,30338340,30338349,9,2025-02-25 17:25:18.197208,2025-02-25 17:25:33.707903,15.510695
channel-6994,1325751,30338341,30338349,8,2025-02-25 17:25:19.542205,2025-02-25 17:25:33.707903,14.165698
channel-6994,1325752,30338351,30338362,11,2025-02-25 17:25:37.093294,2025-02-25 17:25:50.931321,13.838027
channel-6994,1325753,30338352,30338365,13,2025-02-25 17:25:38.246339,2025-02-25 17:25:57.703118,19.456779
channel-6994,1325754,30338369,30338379,10,2025-02-25 17:26:02.400984,2025-02-25 17:26:14.903824,12.50284
channel-6994,1325755,30338383,30338392,9,2025-02-25 17:26:19.759913,2025-02-25 17:26:31.263062,11.503149
channel-6994,1325756,30338398,30338409,11,2025-02-25 17:26:38.947306,2025-02-25 17:26:53.523709,14.576403
channel-6994,1325757,30338412,30338423,11,2025-02-25 17:26:58.469621,2025-02-25 17:27:12.311316,13.841695
channel-6994,1325758,30338415,30338428,13,2025-02-25 17:27:02.777231,2025-02-25 17:27:18.311084,15.533853
channel-6994,1325759,30338463,30338473,10,2025-02-25 17:28:03.482122,2025-02-25 17:28:15.053254,11.571132
channel-6994,1325760,30338467,30338476,9,2025-02-25 17:28:08.099750,2025-02-25 17:28:19.530383,11.430633
channel-6994,1325761,30338505,30338518,13,2025-02-25 17:29:01.382176,2025-02-25 17:29:22.409318,21.027142
channel-6994,1325762,30338527,30338537,10,2025-02-25 17:29:34.402052,2025-02-25 17:29:46.195841,11.793789
channel-6994,1325763,30338548,30338560,12,2025-02-25 17:30:04.040747,2025-02-25 17:30:19.308496,15.267749
channel-6994,1325764,30338555,30338565,10,2025-02-25 17:30:13.707366,2025-02-25 17:30:25.038301,11.330935
channel-6994,1325765,30338581,30338594,13,2025-02-25 17:30:49.995094,2025-02-25 17:31:05.975182,15.980088
channel-6994,1325766,30338629,30338638,9,2025-02-25 17:31:51.001545,2025-02-25 17:32:01.978096,10.976551
channel-6994,1325767,30338634,30338642,8,2025-02-25 17:31:56.831859,2025-02-25 17:32:06.881470,10.049611
channel-6994,1325768,30338658,30338668,10,2025-02-25 17:32:30.649177,2025-02-25 17:32:43.752522,13.103345
channel-6994,1325769,30338673,30338684,11,2025-02-25 17:32:50.337480,2025-02-25 17:33:08.314512,17.977032
channel-6994,1325770,30338675,30338684,9,2025-02-25 17:32:53.761117,2025-02-25 17:33:08.314512,14.553395
channel-6994,1325771,30338716,30338728,12,2025-02-25 17:33:48.694895,2025-02-25 17:34:02.844267,14.149372
channel-6994,1325772,30338754,30338766,12,2025-02-25 17:34:40.385178,2025-02-25 17:34:56.677653,16.292475
channel-6994,1325773,30338788,30338797,9,2025-02-25 17:35:23.788633,2025-02-25 17:35:36.482158,12.693525
channel-6994,1325774,30338905,30338918,13,2025-02-25 17:38:00.687570,2025-02-25 17:38:15.799580,15.11201
channel-6994,1325775,30338942,30338951,9,2025-02-25 17:38:49.969366,2025-02-25 17:39:01.423584,11.454218
channel-6994,1325776,30338954,30338967,13,2025-02-25 17:39:08.069856,2025-02-25 17:39:25.467891,17.398035
channel-6994,1325777,30338993,30339004,11,2025-02-25 17:39:59.266503,2025-02-25 17:40:13.740347,14.473844
channel-6994,1325778,30339159,30339171,12,2025-02-25 17:43:39.108440,2025-02-25 17:43:55.361317,16.252877
channel-6994,1325779,30339176,30339186,10,2025-02-25 17:44:04.948469,2025-02-25 17:44:17.823117,12.874648
channel-6994,1325780,30339180,30339189,9,2025-02-25 17:44:10.705590,2025-02-25 17:44:22.873582,12.167992
channel-6994,1325781,30339196,30339208,12,2025-02-25 17:44:30.887725,2025-02-25 17:44:45.233319,14.345594
channel-6994,1325782,30339212,30339221,9,2025-02-25 17:44:49.609643,2025-02-25 17:45:02.430462,12.820819
channel-6994,1325783,30339231,30339244,13,2025-02-25 17:45:15.162952,2025-02-25 17:45:31.635579,16.472627
channel-6994,1325784,30339246,30339272,26,2025-02-25 17:45:33.956041,2025-02-25 17:46:05.444698,31.488657
channel-6994,1325785,30339255,30339267,12,2025-02-25 17:45:44.477780,2025-02-25 17:45:59.758510,15.28073
channel-6994,1325786,30339270,30339295,25,2025-02-25 17:46:03.153466,2025-02-25 17:46:39.894679,36.741213
channel-6994,1325787,30339273,30339281,8,2025-02-25 17:46:06.629754,2025-02-25 17:46:22.333077,15.703323
channel-6994,1325788,30339279,30339289,10,2025-02-25 17:46:19.925968,2025-02-25 17:46:32.540947,12.614979
channel-6994,1325789,30339290,30339298,8,2025-02-25 17:46:33.668338,2025-02-25 17:46:44.354011,10.685673
channel-6994,1325790,30339295,30339307,12,2025-02-25 17:46:39.894679,2025-02-25 17:46:57.002491,17.107812
channel-6994,1325791,30339314,30339325,11,2025-02-25 17:47:05.152528,2025-02-25 17:47:20.005967,14.853439
channel-6994,1325792,30339321,30339330,9,2025-02-25 17:47:13.468260,2025-02-25 17:47:25.977269,12.509009
channel-6994,1325793,30339328,30339339,11,2025-02-25 17:47:23.585776,2025-02-25 17:47:38.164356,14.57858
channel-6994,1325794,30339362,30339370,8,2025-02-25 17:48:09.993113,2025-02-25 17:48:22.973038,12.979925
channel-6994,1325795,30339397,30339409,12,2025-02-25 17:48:56.571215,2025-02-25 17:49:11.991604,15.420389
channel-6994,1325796,30339438,30339449,11,2025-02-25 17:49:49.108991,2025-02-25 17:50:04.463795,15.354804
channel-6994,1325797,30339461,30339472,11,2025-02-25 17:50:22.184067,2025-02-25 17:50:36.655010,14.470943
channel-6994,1325798,30339499,30339511,12,2025-02-25 17:51:13.602137,2025-02-25 17:51:28.256363,14.654226
channel-6994,1325799,30339673,30339686,13,2025-02-25 17:54:58.440305,2025-02-25 17:55:17.790546,19.350241
channel-6994,1325800,30339708,30339721,13,2025-02-25 17:55:45.882029,2025-02-25 17:56:06.493478,20.611449
channel-6994,1325801,30339845,30339855,10,2025-02-25 17:58:50.541682,2025-02-25 17:59:02.271765,11.730083
channel-6994,1325802,30339901,30339911,10,2025-02-25 18:00:01.012817,2025-02-25 18:00:15.013537,14.00072
channel-6994,1325803,30339915,30339926,11,2025-02-25 18:00:19.524737,2025-02-25 18:00:33.243153,13.718416
channel-6994,1325804,30339915,30339926,11,2025-02-25 18:00:19.524737,2025-02-25 18:00:33.243153,13.718416
channel-6994,1325805,30339931,30339944,13,2025-02-25 18:00:41.006673,2025-02-25 18:00:55.441110,14.434437
channel-6994,1325806,30339951,30339959,8,2025-02-25 18:01:04.329984,2025-02-25 18:01:17.831976,13.501992
channel-6994,1325807,30339962,30339977,15,2025-02-25 18:01:22.236459,2025-02-25 18:01:43.239822,21.003363
channel-6994,1325808,30340112,30340122,10,2025-02-25 18:04:38.168777,2025-02-25 18:04:49.787691,11.618914
channel-6994,1325809,30340144,30340158,14,2025-02-25 18:05:18.301742,2025-02-25 18:05:37.597856,19.296114
channel-6994,1325810,30340145,30340158,13,2025-02-25 18:05:20.549157,2025-02-25 18:05:37.597856,17.048699
channel-6994,1325811,30340155,30340164,9,2025-02-25 18:05:33.367411,2025-02-25 18:05:47.824498,14.457087
channel-6994,1325812,30340222,30340235,13,2025-02-25 18:07:07.796806,2025-02-25 18:07:24.520434,16.723628
channel-6994,1325813,30340223,30340235,12,2025-02-25 18:07:09.024215,2025-02-25 18:07:24.520434,15.496219
channel-6994,1325814,30340251,30340262,11,2025-02-25 18:07:45.119465,2025-02-25 18:07:59.901840,14.782375
channel-6994,1325815,30340363,30340372,9,2025-02-25 18:10:10.017939,2025-02-25 18:10:20.641003,10.623064
channel-6994,1325816,30340378,30340402,24,2025-02-25 18:10:27.700131,2025-02-25 18:11:00.774485,33.074354
channel-6994,1325817,30340404,30340412,8,2025-02-25 18:11:04.187272,2025-02-25 18:11:16.914777,12.727505
channel-6994,1325818,30340492,30340502,10,2025-02-25 18:12:59.410329,2025-02-25 18:13:11.373838,11.963509
channel-6994,1325819,30340546,30340558,12,2025-02-25 18:14:11.596055,2025-02-25 18:14:26.320700,14.724645
channel-6994,1325820,30340571,30340596,25,2025-02-25 18:14:41.114502,2025-02-25 18:15:16.272831,35.158329
channel-6994,1325821,30340609,30340617,8,2025-02-25 18:15:32.400338,2025-02-25 18:15:41.835006,9.434668
channel-6994,1325822,30340611,30340621,10,2025-02-25 18:15:34.766523,2025-02-25 18:15:50.589755,15.823232
channel-6994,1325823,30340648,30340658,10,2025-02-25 18:16:23.425084,2025-02-25 18:16:36.320863,12.895779
channel-6994,1325824,30340697,30340711,14,2025-02-25 18:17:30.702347,2025-02-25 18:17:47.031712,16.329365
channel-6994,1325825,30340757,30340768,11,2025-02-25 18:18:46.363001,2025-02-25 18:18:59.687365,13.324364
channel-6994,1325826,30340793,30340801,8,2025-02-25 18:19:33.370523,2025-02-25 18:19:42.852694,9.482171
channel-6994,1325827,30340845,30340856,11,2025-02-25 18:20:45.352487,2025-02-25 18:20:59.936324,14.583837
channel-6994,1325828,30340877,30340887,10,2025-02-25 18:21:26.762300,2025-02-25 18:21:38.811211,12.048911
channel-6994,1325829,30340968,30340981,13,2025-02-25 18:23:25.642772,2025-02-25 18:23:41.747114,16.104342
channel-6994,1325830,30340980,30340990,10,2025-02-25 18:23:39.971583,2025-02-25 18:23:52.285416,12.313833
channel-6994,1325831,30340995,30341004,9,2025-02-25 18:23:58.087155,2025-02-25 18:24:14.388173,16.301018
channel-6994,1325832,30341006,30341017,11,2025-02-25 18:24:16.577943,2025-02-25 18:24:32.375889,15.797946
channel-6994,1325833,30341015,30341026,11,2025-02-25 18:24:28.968895,2025-02-25 18:24:42.878257,13.909362
channel-6994,1325834,30341150,30348146,6996,2025-02-25 18:27:25.045043,2025-02-25 20:59:17.797869,9112.752826
channel-6994,1325835,30341166,30341177,11,2025-02-25 18:27:49.524700,2025-02-25 18:28:02.342900,12.8182
channel-6994,1325836,30341178,30341186,8,2025-02-25 18:28:03.529483,2025-02-25 18:28:14.561875,11.032392
channel-6994,1325837,30341202,30341213,11,2025-02-25 18:28:32.787129,2025-02-25 18:28:47.440021,14.652892
channel-6994,1325838,30341218,30341230,12,2025-02-25 18:28:54.088888,2025-02-25 18:29:09.063965,14.975077
channel-6994,1325839,30341302,30341332,30,2025-02-25 18:30:43.252755,2025-02-25 18:31:20.979263,37.726508
channel-6994,1325840,30341312,30341347,35,2025-02-25 18:30:56.899162,2025-02-25 18:31:45.256749,48.357587
channel-6994,1325841,30341312,30341324,12,2025-02-25 18:30:56.899162,2025-02-25 18:31:11.636666,14.737504
channel-6994,1325842,30341467,30341477,10,2025-02-25 18:34:24.839670,2025-02-25 18:34:38.334751,13.495081
channel-6994,1325843,30341596,30341606,10,2025-02-25 18:37:10.360341,2025-02-25 18:37:24.827176,14.466835
channel-6994,1325844,30341605,30341614,9,2025-02-25 18:37:23.572033,2025-02-25 18:37:35.969702,12.397669
channel-6994,1325845,30341614,30341624,10,2025-02-25 18:37:35.969702,2025-02-25 18:37:47.471587,11.501885
channel-6994,1325846,30341624,30341633,9,2025-02-25 18:37:47.471587,2025-02-25 18:37:58.852507,11.38092
channel-6994,1325847,30341651,30341660,9,2025-02-25 18:38:23.603288,2025-02-25 18:38:34.925864,11.322576
channel-6994,1325848,30341756,30341766,10,2025-02-25 18:40:45.108262,2025-02-25 18:40:58.691378,13.583116
channel-6994,1325849,30341782,30341790,8,2025-02-25 18:41:19.484478,2025-02-25 18:41:31.417164,11.932686
channel-6994,1325850,30341796,30341823,27,2025-02-25 18:41:39.273909,2025-02-25 18:42:11.420219,32.14631
channel-6994,1325851,30341822,30341829,7,2025-02-25 18:42:10.275976,2025-02-25 18:42:21.802748,11.526772
channel-6994,1325852,30342062,30342072,10,2025-02-25 18:47:21.634921,2025-02-25 18:47:33.398888,11.763967
channel-6994,1325853,30342066,30342074,8,2025-02-25 18:47:26.147069,2025-02-25 18:47:39.088714,12.941645
channel-6994,1325854,30342084,30342095,11,2025-02-25 18:47:51.635160,2025-02-25 18:48:07.328093,15.692933
channel-6994,1325855,30342141,30342152,11,2025-02-25 18:49:05.984849,2025-02-25 18:49:19.875315,13.890466
channel-6994,1325856,30342204,30342218,14,2025-02-25 18:50:23.342878,2025-02-25 18:50:39.175851,15.832973
channel-6994,1325857,30342379,30342391,12,2025-02-25 18:54:08.160195,2025-02-25 18:54:22.032297,13.872102
channel-6994,1325858,30342414,30342424,10,2025-02-25 18:54:54.147695,2025-02-25 18:55:07.921163,13.773468
channel-6994,1325859,30342415,30342424,9,2025-02-25 18:54:56.438853,2025-02-25 18:55:07.921163,11.48231
channel-6994,1325860,30342439,30342464,25,2025-02-25 18:55:25.577416,2025-02-25 18:55:58.048168,32.470752
channel-6994,1325861,30342619,30342630,11,2025-02-25 18:59:17.400755,2025-02-25 18:59:31.128023,13.727268
channel-6994,1325862,30342662,30342674,12,2025-02-25 19:00:18.525255,2025-02-25 19:00:32.259207,13.733952
channel-6994,1325863,30342670,30342679,9,2025-02-25 19:00:27.582291,2025-02-25 19:00:38.144765,10.562474
channel-6994,1325864,30342689,30342697,8,2025-02-25 19:00:53.247835,2025-02-25 19:01:06.500004,13.252169
channel-6994,1325865,30342715,30342725,10,2025-02-25 19:01:29.914518,2025-02-25 19:01:42.366226,12.451708
channel-6994,1325866,30342722,30342733,11,2025-02-25 19:01:38.974010,2025-02-25 19:01:53.004710,14.0307
channel-6994,1325867,30342752,30342763,11,2025-02-25 19:02:15.919009,2025-02-25 19:02:30.567630,14.648621
channel-6994,1325868,30342764,30342773,9,2025-02-25 19:02:32.820745,2025-02-25 19:02:43.642615,10.82187
channel-6994,1325869,30342778,30342788,10,2025-02-25 19:02:49.210594,2025-02-25 19:03:01.436465,12.225871
channel-6994,1325870,30342810,30342821,11,2025-02-25 19:03:28.808954,2025-02-25 19:03:41.602287,12.793333
channel-6994,1325871,30342830,30342840,10,2025-02-25 19:03:56.792544,2025-02-25 19:04:10.412324,13.61978
channel-6994,1325872,30342852,30342860,8,2025-02-25 19:04:24.256914,2025-02-25 19:04:40.392204,16.13529
channel-6994,1325873,30342854,30342861,7,2025-02-25 19:04:27.973862,2025-02-25 19:04:41.568303,13.594441
channel-6994,1325874,30342858,30342869,11,2025-02-25 19:04:33.575164,2025-02-25 19:04:52.049173,18.474009
channel-6994,1325875,30342859,30342869,10,2025-02-25 19:04:39.136516,2025-02-25 19:04:52.049173,12.912657
channel-6994,1325876,30342869,30342879,10,2025-02-25 19:04:52.049173,2025-02-25 19:05:03.260948,11.211775
channel-6994,1325877,30342884,30342893,9,2025-02-25 19:05:09.303438,2025-02-25 19:05:20.258912,10.955474
channel-6994,1325878,30342888,30342898,10,2025-02-25 19:05:13.838642,2025-02-25 19:05:25.871084,12.032442
channel-6994,1325879,30342895,30342903,8,2025-02-25 19:05:22.608954,2025-02-25 19:05:35.974293,13.365339
channel-6994,1325880,30342935,30342946,11,2025-02-25 19:06:17.118051,2025-02-25 19:06:30.512918,13.394867
channel-6994,1325881,30342967,30342976,9,2025-02-25 19:06:59.645265,2025-02-25 19:07:10.960222,11.314957
channel-6994,1325882,30342991,30342998,7,2025-02-25 19:07:33.400202,2025-02-25 19:07:44.262333,10.862131
channel-6994,1325883,30343007,30343022,15,2025-02-25 19:07:54.780286,2025-02-25 19:08:13.796699,19.016413
channel-6994,1325884,30343012,30343034,22,2025-02-25 19:08:01.315914,2025-02-25 19:08:28.183101,26.867187
channel-6994,1325885,30343117,30343129,12,2025-02-25 19:10:19.158644,2025-02-25 19:10:34.392336,15.233692
channel-6994,1325886,30343120,30343129,9,2025-02-25 19:10:22.544323,2025-02-25 19:10:34.392336,11.848013
channel-6994,1325887,30343160,30343169,9,2025-02-25 19:11:14.782714,2025-02-25 19:11:27.046336,12.263622
channel-6994,1325888,30343183,30343212,29,2025-02-25 19:11:45.439252,2025-02-25 19:12:21.296689,35.857437
channel-6994,1325889,30343198,30343212,14,2025-02-25 19:12:05.202576,2025-02-25 19:12:21.296689,16.094113
channel-6994,1325890,30343240,30343262,22,2025-02-25 19:12:56.697402,2025-02-25 19:13:24.925403,28.228001
channel-6994,1325891,30343240,30343262,22,2025-02-25 19:12:56.697402,2025-02-25 19:13:24.925403,28.228001
channel-6994,1325892,30343282,30343292,10,2025-02-25 19:13:50.174443,2025-02-25 19:14:04.538501,14.364058
channel-6994,1325893,30343375,30343388,13,2025-02-25 19:15:54.107058,2025-02-25 19:16:13.091233,18.984175
channel-6994,1325894,30343381,30343402,21,2025-02-25 19:16:03.408841,2025-02-25 19:16:30.342212,26.933371
channel-6994,1325895,30343412,30343425,13,2025-02-25 19:16:42.472321,2025-02-25 19:16:58.193639,15.721318
channel-6994,1325896,30343420,30343445,25,2025-02-25 19:16:52.471856,2025-02-25 19:17:26.312930,33.841074
channel-6994,1325897,30343460,30343472,12,2025-02-25 19:17:44.373143,2025-02-25 19:17:59.130182,14.757039
channel-6994,1325898,30343481,30343493,12,2025-02-25 19:18:12.815854,2025-02-25 19:18:28.225817,15.409963
channel-6994,1325899,30343509,30343520,11,2025-02-25 19:18:47.184135,2025-02-25 19:19:02.774662,15.590527
channel-6994,1325900,30343539,30343550,11,2025-02-25 19:19:30.229520,2025-02-25 19:19:43.071415,12.841895
channel-6994,1325901,30343562,30343574,12,2025-02-25 19:19:56.831632,2025-02-25 19:20:10.588954,13.757322
channel-6994,1325902,30343569,30343578,9,2025-02-25 19:20:04.828823,2025-02-25 19:20:16.074875,11.246052
channel-6994,1325903,30343775,30343784,9,2025-02-25 19:24:37.017564,2025-02-25 19:24:49.832645,12.815081
channel-6994,1325904,30343790,30343804,14,2025-02-25 19:24:56.717894,2025-02-25 19:25:12.903043,16.185149
channel-6994,1325905,30343811,30343820,9,2025-02-25 19:25:23.074030,2025-02-25 19:25:35.545385,12.471355
channel-6994,1325906,30343890,30343901,11,2025-02-25 19:27:03.205865,2025-02-25 19:27:16.263868,13.058003
channel-6994,1325907,30343918,30343927,9,2025-02-25 19:27:39.735471,2025-02-25 19:27:49.804376,10.068905
channel-6994,1325908,30343937,30343942,5,2025-02-25 19:28:01.246834,2025-02-25 19:28:11.494535,10.247701
channel-6994,1325909,30343969,30343982,13,2025-02-25 19:28:48.949357,2025-02-25 19:29:04.357693,15.408336
channel-6994,1325910,30344096,30344104,8,2025-02-25 19:31:28.031056,2025-02-25 19:31:39.715656,11.6846
channel-6994,1325911,30344160,30344170,10,2025-02-25 19:32:56.086001,2025-02-25 19:33:07.519261,11.43326
channel-6994,1325912,30344181,30357781,13600,2025-02-25 19:33:20.774798,2025-02-26 00:26:14.534444,17573.759646
channel-6994,1325913,30344222,30344231,9,2025-02-25 19:34:11.988175,2025-02-25 19:34:22.091282,10.103107
channel-6994,1325914,30344264,30344275,11,2025-02-25 19:35:06.177521,2025-02-25 19:35:19.019844,12.842323
channel-6994,1325915,30344403,30344414,11,2025-02-25 19:38:02.692911,2025-02-25 19:38:17.337421,14.64451
channel-6994,1325916,30344446,30344461,15,2025-02-25 19:38:56.910446,2025-02-25 19:39:16.078195,19.167749
channel-6994,1325917,30344473,30344483,10,2025-02-25 19:39:35.562927,2025-02-25 19:39:47.851947,12.28902
channel-6994,1325918,30344477,30344487,10,2025-02-25 19:39:41.063403,2025-02-25 19:39:53.656082,12.592679
channel-6994,1325919,30344494,30344506,12,2025-02-25 19:40:03.044474,2025-02-25 19:40:17.917152,14.872678
channel-6994,1325920,30344589,30344599,10,2025-02-25 19:42:06.906063,2025-02-25 19:42:21.125656,14.219593
channel-6994,1325921,30344664,30344674,10,2025-02-25 19:43:42.007935,2025-02-25 19:43:53.951174,11.943239
channel-6994,1325922,30344682,30344693,11,2025-02-25 19:44:04.214410,2025-02-25 19:44:18.049532,13.835122
channel-6994,1325923,30344866,30344876,10,2025-02-25 19:48:00.940959,2025-02-25 19:48:13.594152,12.653193
channel-6994,1325924,30344885,30344898,13,2025-02-25 19:48:25.474699,2025-02-25 19:48:41.515591,16.040892
channel-6994,1325925,30344898,30344907,9,2025-02-25 19:48:41.515591,2025-02-25 19:48:55.061687,13.546096
channel-6994,1325926,30344955,30344965,10,2025-02-25 19:49:54.293232,2025-02-25 19:50:06.588987,12.295755
channel-6994,1325927,30345191,30345203,12,2025-02-25 19:55:11.102337,2025-02-25 19:55:25.019024,13.916687
channel-6994,1325928,30345232,30345244,12,2025-02-25 19:56:03.437534,2025-02-25 19:56:21.142402,17.704868
channel-6994,1325929,30345260,30345272,12,2025-02-25 19:56:41.083174,2025-02-25 19:56:55.086384,14.00321
channel-6994,1325930,30345363,30345374,11,2025-02-25 19:58:51.704233,2025-02-25 19:59:06.366693,14.66246
channel-6994,1325931,30345438,30345447,9,2025-02-25 20:00:38.219490,2025-02-25 20:00:48.657767,10.438277
channel-6994,1325932,30345466,30345479,13,2025-02-25 20:01:12.848978,2025-02-25 20:01:27.734076,14.885098
channel-6994,1325933,30345527,30345536,9,2025-02-25 20:02:31.618616,2025-02-25 20:02:42.897955,11.279339
channel-6994,1325934,30345611,30345622,11,2025-02-25 20:04:24.337836,2025-02-25 20:04:38.181183,13.843347
channel-6994,1325935,30345684,30345695,11,2025-02-25 20:05:58.617177,2025-02-25 20:06:12.701262,14.084085
channel-6994,1325936,30345745,30345759,14,2025-02-25 20:07:13.572738,2025-02-25 20:07:31.129244,17.556506
channel-6994,1325937,30345885,30345896,11,2025-02-25 20:10:16.182795,2025-02-25 20:10:29.483074,13.300279
channel-6994,1325938,30345900,30345908,8,2025-02-25 20:10:35.244856,2025-02-25 20:10:45.657669,10.412813
channel-6994,1325939,30346021,30346043,22,2025-02-25 20:13:12.779540,2025-02-25 20:13:40.766201,27.986661
channel-6994,1325940,30346094,30346101,7,2025-02-25 20:14:46.836747,2025-02-25 20:14:57.203546,10.366799
channel-6994,1325941,30346160,30346171,11,2025-02-25 20:16:10.834818,2025-02-25 20:16:24.430200,13.595382
channel-6994,1325942,30346271,30346279,8,2025-02-25 20:18:35.149926,2025-02-25 20:18:50.238238,15.088312
channel-6994,1325943,30346324,30346336,12,2025-02-25 20:19:48.272037,2025-02-25 20:20:02.124136,13.852099
channel-6994,1325944,30346393,30346401,8,2025-02-25 20:21:22.048939,2025-02-25 20:21:33.070920,11.021981
channel-6994,1325945,30346418,30346425,7,2025-02-25 20:21:55.573890,2025-02-25 20:22:07.137938,11.564048
channel-6994,1325946,30346427,30346440,13,2025-02-25 20:22:09.237797,2025-02-25 20:22:25.457773,16.219976
channel-6994,1325947,30346448,30346456,8,2025-02-25 20:22:34.817963,2025-02-25 20:22:46.796250,11.978287
channel-6994,1325948,30346466,30346475,9,2025-02-25 20:23:03.928381,2025-02-25 20:23:14.785143,10.856762
channel-6994,1325949,30346473,30346484,11,2025-02-25 20:23:12.447313,2025-02-25 20:23:26.755367,14.308054
channel-6994,1325950,30346479,30346488,9,2025-02-25 20:23:20.817186,2025-02-25 20:23:31.449042,10.631856
channel-6994,1325951,30346499,30346511,12,2025-02-25 20:23:44.844222,2025-02-25 20:24:01.410308,16.566086
channel-6994,1325952,30346503,30346514,11,2025-02-25 20:23:50.847964,2025-02-25 20:24:06.008758,15.160794
channel-6994,1325953,30346564,30346576,12,2025-02-25 20:25:17.039071,2025-02-25 20:25:31.184315,14.145244
channel-6994,1325954,30346696,30346717,21,2025-02-25 20:28:02.675664,2025-02-25 20:28:32.831676,30.156012
channel-6994,1325955,30346697,30346704,7,2025-02-25 20:28:03.811590,2025-02-25 20:28:13.529689,9.718099
channel-6994,1325956,30346703,30346712,9,2025-02-25 20:28:11.276505,2025-02-25 20:28:26.132841,14.856336
channel-6994,1325957,30346708,30346722,14,2025-02-25 20:28:20.424394,2025-02-25 20:28:39.525205,19.100811
channel-6994,1325958,30346756,30346768,12,2025-02-25 20:29:22.429542,2025-02-25 20:29:37.137218,14.707676
channel-6994,1325959,30346767,30346777,10,2025-02-25 20:29:35.925119,2025-02-25 20:29:48.630319,12.7052
channel-6994,1325960,30346923,30346934,11,2025-02-25 20:33:00.275995,2025-02-25 20:33:14.482958,14.206963
channel-6994,1325961,30346977,30346985,8,2025-02-25 20:34:12.258506,2025-02-25 20:34:22.282065,10.023559
channel-6994,1325962,30347041,30347051,10,2025-02-25 20:35:32.887048,2025-02-25 20:35:49.377140,16.490092
channel-6994,1325963,30347173,30347182,9,2025-02-25 20:38:22.834953,2025-02-25 20:38:35.230035,12.395082
channel-6994,1325964,30347202,30347215,13,2025-02-25 20:39:00.257243,2025-02-25 20:39:16.137026,15.879783
channel-6994,1325965,30347245,30347257,12,2025-02-25 20:39:59.210995,2025-02-25 20:40:14.941003,15.730008
channel-6994,1325966,30347340,30347352,12,2025-02-25 20:42:01.735575,2025-02-25 20:42:15.742916,14.007341
channel-6994,1325967,30347421,30347431,10,2025-02-25 20:43:44.356884,2025-02-25 20:43:57.631225,13.274341
channel-6994,1325968,30347428,30347441,13,2025-02-25 20:43:52.947710,2025-02-25 20:44:09.057344,16.109634
channel-6994,1325969,30347430,30347446,16,2025-02-25 20:43:56.500906,2025-02-25 20:44:14.650921,18.150015
channel-6994,1325970,30347461,30347472,11,2025-02-25 20:44:38.366858,2025-02-25 20:44:52.603633,14.236775
channel-6994,1325971,30347475,30357781,10306,2025-02-25 20:44:57.290670,2025-02-26 00:26:14.534444,13277.243774
channel-6994,1325972,30347554,30347564,10,2025-02-25 20:46:34.072644,2025-02-25 20:46:46.681361,12.608717
channel-6994,1325973,30347576,30347587,11,2025-02-25 20:47:06.869299,2025-02-25 20:47:20.452878,13.583579
channel-6994,1325974,30347617,30347627,10,2025-02-25 20:47:57.616210,2025-02-25 20:48:10.832950,13.21674
channel-6994,1325975,30347762,30347772,10,2025-02-25 20:51:02.692334,2025-02-25 20:51:15.411443,12.719109
channel-6994,1325976,30347769,30347780,11,2025-02-25 20:51:12.007370,2025-02-25 20:51:25.707933,13.700563
channel-6994,1325977,30347856,30347867,11,2025-02-25 20:53:04.032580,2025-02-25 20:53:22.663618,18.631038
channel-6994,1325978,30348043,30348054,11,2025-02-25 20:57:03.357976,2025-02-25 20:57:16.801571,13.443595
channel-6994,1325979,30348064,30348078,14,2025-02-25 20:57:30.131267,2025-02-25 20:57:46.274285,16.143018
channel-6994,1325980,30348080,30348088,8,2025-02-25 20:57:48.426908,2025-02-25 20:58:02.586400,14.159492
channel-6994,1325981,30348379,30348389,10,2025-02-25 21:04:19.857273,2025-02-25 21:04:31.311311,11.454038
channel-6994,1325982,30348472,30348484,12,2025-02-25 21:06:22.032698,2025-02-25 21:06:36.307727,14.275029
channel-6994,1325983,30348580,30348592,12,2025-02-25 21:08:39.745630,2025-02-25 21:08:57.205786,17.460156
channel-6994,1325984,30348608,30348622,14,2025-02-25 21:09:16.585543,2025-02-25 21:09:36.791102,20.205559
channel-6994,1325985,30348679,30348687,8,2025-02-25 21:10:51.458465,2025-02-25 21:11:01.875484,10.417019
channel-6994,1325986,30348685,30348696,11,2025-02-25 21:10:59.210790,2025-02-25 21:11:12.272319,13.061529
channel-6994,1325987,30348711,30348726,15,2025-02-25 21:11:35.081852,2025-02-25 21:11:53.077080,17.995228
channel-6994,1325988,30348748,30348756,8,2025-02-25 21:12:21.403980,2025-02-25 21:12:31.390604,9.986624
channel-6994,1325989,30348750,30348760,10,2025-02-25 21:12:23.538025,2025-02-25 21:12:38.030265,14.49224
channel-6994,1325990,30348758,30348769,11,2025-02-25 21:12:34.723061,2025-02-25 21:12:48.625815,13.902754
channel-6994,1325991,30348767,30348777,10,2025-02-25 21:12:46.400274,2025-02-25 21:13:00.386866,13.986592
channel-6994,1325992,30348777,30348783,6,2025-02-25 21:13:00.386866,2025-02-25 21:13:11.233365,10.846499
channel-6994,1325993,30348808,30348821,13,2025-02-25 21:13:39.944935,2025-02-25 21:13:56.227717,16.282782
channel-6994,1325994,30348893,30348904,11,2025-02-25 21:15:30.331825,2025-02-25 21:15:44.050705,13.71888
channel-6994,1325995,30348968,30348977,9,2025-02-25 21:17:06.232609,2025-02-25 21:17:18.715403,12.482794
channel-6994,1325996,30349183,30349192,9,2025-02-25 21:21:41.585127,2025-02-25 21:21:53.982626,12.397499
channel-6994,1325997,30349308,30349317,9,2025-02-25 21:24:21.589714,2025-02-25 21:24:32.579923,10.990209
channel-6994,1325998,30349902,30349912,10,2025-02-25 21:37:06.077101,2025-02-25 21:37:19.090714,13.013613
channel-6994,1325999,30349920,30349931,11,2025-02-25 21:37:27.952155,2025-02-25 21:37:41.051785,13.09963
channel-6994,1326000,30350023,30350035,12,2025-02-25 21:39:43.388890,2025-02-25 21:39:58.033854,14.644964
channel-6994,1326001,30350085,30350097,12,2025-02-25 21:41:02.438121,2025-02-25 21:41:17.178457,14.740336
channel-6994,1326002,30350168,30350182,14,2025-02-25 21:42:49.387946,2025-02-25 21:43:06.411310,17.023364
channel-6994,1326003,30350321,30350331,10,2025-02-25 21:46:03.291987,2025-02-25 21:46:17.208594,13.916607
channel-6994,1326004,30350412,30350425,13,2025-02-25 21:48:00.021393,2025-02-25 21:48:18.045997,18.024604
channel-6994,1326005,30350438,30350447,9,2025-02-25 21:48:34.422446,2025-02-25 21:48:45.626488,11.204042
channel-6994,1326006,30350597,30350609,12,2025-02-25 21:52:03.898978,2025-02-25 21:52:18.856079,14.957101
channel-6994,1326007,30350828,30350839,11,2025-02-25 21:56:56.894463,2025-02-25 21:57:11.042769,14.148306
channel-6994,1326008,30351354,30351363,9,2025-02-25 22:08:18.399807,2025-02-25 22:08:29.938760,11.538953
channel-6994,1326009,30351420,30351429,9,2025-02-25 22:09:42.883974,2025-02-25 22:09:54.525998,11.642024
channel-6994,1326010,30351481,30351490,9,2025-02-25 22:11:03.561359,2025-02-25 22:11:13.904282,10.342923
channel-6994,1326011,30351529,30351540,11,2025-02-25 22:12:02.337082,2025-02-25 22:12:15.873601,13.536519
channel-6994,1326012,30351536,30351543,7,2025-02-25 22:12:11.217620,2025-02-25 22:12:20.270665,9.053045
channel-6994,1326013,30351546,30351558,12,2025-02-25 22:12:25.204386,2025-02-25 22:12:40.393835,15.189449
channel-6994,1326014,30351549,30351572,23,2025-02-25 22:12:29.732146,2025-02-25 22:13:01.192515,31.460369
channel-6994,1326015,30351713,30351719,6,2025-02-25 22:16:00.523897,2025-02-25 22:16:12.891253,12.367356
channel-6994,1326016,30351843,30351854,11,2025-02-25 22:18:53.989064,2025-02-25 22:19:06.817537,12.828473
channel-6994,1326017,30352362,30352374,12,2025-02-25 22:29:57.737853,2025-02-25 22:30:11.486817,13.748964
channel-6994,1326018,30352380,30352388,8,2025-02-25 22:30:18.149418,2025-02-25 22:30:27.797428,9.64801
channel-6994,1326019,30352444,30352454,10,2025-02-25 22:31:45.774023,2025-02-25 22:31:59.060478,13.286455
channel-6994,1326020,30352509,30352518,9,2025-02-25 22:33:07.318487,2025-02-25 22:33:18.910971,11.592484
channel-6994,1326021,30352737,30352747,10,2025-02-25 22:37:58.688168,2025-02-25 22:38:12.283107,13.594939
channel-6994,1326022,30352986,30352996,10,2025-02-25 22:43:18.021178,2025-02-25 22:43:29.388509,11.367331
channel-6994,1326023,30353025,30353035,10,2025-02-25 22:44:06.747762,2025-02-25 22:44:19.529151,12.781389
channel-6994,1326024,30353115,30353144,29,2025-02-25 22:46:03.440831,2025-02-25 22:46:38.566894,35.126063
channel-6994,1326025,30353115,30357781,4666,2025-02-25 22:46:03.440831,2025-02-26 00:26:14.534444,6011.093613
channel-6994,1326026,30353162,30353174,12,2025-02-25 22:47:02.899038,2025-02-25 22:47:17.222191,14.323153
channel-6994,1326027,30353415,30353449,34,2025-02-25 22:52:30.039057,2025-02-25 22:53:14.163903,44.124846
channel-6994,1326028,30353499,30353508,9,2025-02-25 22:54:20.659737,2025-02-25 22:54:32.083108,11.423371
channel-6994,1326029,30353778,30353786,8,2025-02-25 23:00:15.263489,2025-02-25 23:00:29.552065,14.288576
channel-6994,1326030,30353854,30353867,13,2025-02-25 23:01:52.564868,2025-02-25 23:02:08.177959,15.613091
channel-6994,1326031,30354060,30354067,7,2025-02-25 23:06:16.998512,2025-02-25 23:06:28.080540,11.082028
channel-6994,1326032,30354137,30354148,11,2025-02-25 23:07:59.968795,2025-02-25 23:08:13.367000,13.398205
channel-6994,1326033,30354275,30354284,9,2025-02-25 23:10:54.234335,2025-02-25 23:11:09.087506,14.853171
channel-6994,1326034,30354289,30354297,8,2025-02-25 23:11:14.722312,2025-02-25 23:11:25.905832,11.18352
channel-6994,1326035,30354387,30354396,9,2025-02-25 23:13:18.641961,2025-02-25 23:13:33.154367,14.512406
channel-6994,1326036,30354469,30354480,11,2025-02-25 23:15:05.042292,2025-02-25 23:15:18.957743,13.915451
channel-6994,1326037,30354634,30354647,13,2025-02-25 23:18:35.182455,2025-02-25 23:18:51.134281,15.951826
channel-6994,1326038,30354652,30354661,9,2025-02-25 23:18:57.786113,2025-02-25 23:19:11.650462,13.864349
channel-6994,1326039,30354729,30354740,11,2025-02-25 23:20:38.054177,2025-02-25 23:20:50.684503,12.630326
channel-6994,1326040,30354817,30354826,9,2025-02-25 23:22:30.941740,2025-02-25 23:22:43.433055,12.491315
channel-6994,1326041,30355257,30355266,9,2025-02-25 23:32:01.544712,2025-02-25 23:32:12.764919,11.220207
channel-6994,1326042,30355319,30355328,9,2025-02-25 23:33:23.785803,2025-02-25 23:33:35.390128,11.604325
channel-6994,1326043,30355345,30355354,9,2025-02-25 23:33:58.755246,2025-02-25 23:34:08.850323,10.095077
channel-6994,1326044,30355502,30355512,10,2025-02-25 23:37:12.530880,2025-02-25 23:37:26.773709,14.242829
channel-6994,1326045,30355567,30355579,12,2025-02-25 23:38:39.069824,2025-02-25 23:38:55.548433,16.478609
channel-6994,1326046,30356237,30356248,11,2025-02-25 23:53:00.555062,2025-02-25 23:53:13.222045,12.666983
channel-6994,1326047,30356447,30356457,10,2025-02-25 23:57:33.552761,2025-02-25 23:57:46.942604,13.389843
channel-6994,1326048,30356620,30356631,11,2025-02-26 00:01:16.189473,2025-02-26 00:01:30.708676,14.519203
channel-6994,1326049,30356638,30356657,19,2025-02-26 00:01:41.889181,2025-02-26 00:02:05.256314,23.367133
channel-6994,1326050,30356644,30356670,26,2025-02-26 00:01:49.830691,2025-02-26 00:02:20.296553,30.465862
channel-6994,1326051,30356687,30356699,12,2025-02-26 00:02:42.145300,2025-02-26 00:02:57.690551,15.545251
channel-6994,1326052,30357095,30357103,8,2025-02-26 00:11:28.412706,2025-02-26 00:11:38.021859,9.609153
channel-6994,1326053,30357550,30357562,12,2025-02-26 00:21:15.593940,2025-02-26 00:21:29.276387,13.682447
channel-6994,1326054,30357603,30357612,9,2025-02-26 00:22:29.051957,2025-02-26 00:22:40.372015,11.320058
channel-6994,1326055,30358046,30358059,13,2025-02-26 00:31:56.636319,2025-02-26 00:32:12.120670,15.484351
channel-6994,1326056,30358079,30358087,8,2025-02-26 00:32:38.949788,2025-02-26 00:32:49.029243,10.079455
channel-6994,1326057,30358205,30358214,9,2025-02-26 00:35:19.326898,2025-02-26 00:35:33.837246,14.510348
channel-6994,1326058,30358328,30358337,9,2025-02-26 00:37:57.660975,2025-02-26 00:38:09.092423,11.431448
channel-6994,1326059,30358528,30358539,11,2025-02-26 00:42:14.921466,2025-02-26 00:42:29.289054,14.367588
channel-6994,1326060,30358569,30358579,10,2025-02-26 00:43:06.783777,2025-02-26 00:43:18.443512,11.659735
channel-6994,1326061,30358583,30358593,10,2025-02-26 00:43:23.040703,2025-02-26 00:43:36.794200,13.753497
channel-6994,1326062,30358591,30358603,12,2025-02-26 00:43:32.646002,2025-02-26 00:43:48.181897,15.535895
channel-6994,1326063,30358853,30358863,10,2025-02-26 00:49:13.815224,2025-02-26 00:49:25.970122,12.154898
channel-6994,1326064,30359099,30359108,9,2025-02-26 00:54:32.821950,2025-02-26 00:54:43.252211,10.430261
channel-6994,1326065,30359117,30359159,42,2025-02-26 00:54:54.509920,2025-02-26 00:55:50.375167,55.865247
channel-6994,1326066,30359233,30359246,13,2025-02-26 00:57:28.227764,2025-02-26 00:57:43.111929,14.884165
channel-6994,1326067,30359276,30359289,13,2025-02-26 00:58:24.943647,2025-02-26 00:58:41.421490,16.477843
channel-6994,1326068,30359512,30359521,9,2025-02-26 01:03:27.565136,2025-02-26 01:03:41.507314,13.942178
channel-6994,1326069,30359602,30359613,11,2025-02-26 01:05:23.630877,2025-02-26 01:05:36.627786,12.996909
channel-6994,1326070,30359686,30359693,7,2025-02-26 01:07:12.947889,2025-02-26 01:07:23.071021,10.123132
channel-6994,1326071,30359828,30359841,13,2025-02-26 01:10:18.284335,2025-02-26 01:10:38.845413,20.561078
channel-6994,1326072,30359869,30359877,8,2025-02-26 01:11:14.872581,2025-02-26 01:11:28.951590,14.079009
channel-6994,1326073,30359888,30359896,8,2025-02-26 01:11:41.589798,2025-02-26 01:11:51.487470,9.897672
channel-6994,1326074,30359922,30359934,12,2025-02-26 01:12:28.366177,2025-02-26 01:12:41.815591,13.449414
channel-6994,1326075,30360121,30360133,12,2025-02-26 01:16:41.994078,2025-02-26 01:16:56.953426,14.959348
channel-6994,1326076,30360243,30360280,37,2025-02-26 01:19:22.355819,2025-02-26 01:20:08.856596,46.500777
channel-6994,1326077,30360305,30360342,37,2025-02-26 01:20:42.584744,2025-02-26 01:21:29.348129,46.763385
channel-6994,1326078,30360367,30360414,47,2025-02-26 01:22:01.526225,2025-02-26 01:23:00.456731,58.930506
channel-6994,1326079,30360547,30360559,12,2025-02-26 01:25:56.261094,2025-02-26 01:26:09.747990,13.486896
channel-6994,1326080,30360566,30360577,11,2025-02-26 01:26:19.755009,2025-02-26 01:26:32.181835,12.426826
channel-6994,1326081,30360591,30360602,11,2025-02-26 01:26:51.731161,2025-02-26 01:27:05.387267,13.656106
channel-6994,1326082,30360637,30360646,9,2025-02-26 01:27:50.360987,2025-02-26 01:28:01.374051,11.013064
channel-6994,1326083,30360663,30360673,10,2025-02-26 01:28:22.221489,2025-02-26 01:28:35.798673,13.577184
channel-6994,1326084,30360674,30360687,13,2025-02-26 01:28:37.050854,2025-02-26 01:28:52.641642,15.590788
channel-6994,1326085,30360686,30360719,33,2025-02-26 01:28:50.531097,2025-02-26 01:29:37.468754,46.937657
channel-6994,1326086,30360848,30360856,8,2025-02-26 01:32:23.780066,2025-02-26 01:32:33.221158,9.441092
channel-6994,1326087,30361038,30361052,14,2025-02-26 01:36:31.981306,2025-02-26 01:36:49.039349,17.058043
channel-6994,1326088,30361084,30361121,37,2025-02-26 01:37:29.030437,2025-02-26 01:38:18.671362,49.640925
channel-6994,1326089,30361099,30361107,8,2025-02-26 01:37:47.949744,2025-02-26 01:38:02.146107,14.196363
channel-6994,1326090,30361148,30361184,36,2025-02-26 01:38:53.098966,2025-02-26 01:39:42.129585,49.030619
channel-6994,1326091,30361315,30361334,19,2025-02-26 01:42:28.700951,2025-02-26 01:42:54.772970,26.072019
channel-6994,1326092,30361355,30361365,10,2025-02-26 01:43:21.616362,2025-02-26 01:43:33.420135,11.803773
channel-6994,1326096,30361864,30361881,17,2025-02-26 01:54:11.158545,2025-02-26 01:54:33.678988,22.520443
channel-6994,1326097,30362061,30362088,27,2025-02-26 01:58:23.737810,2025-02-26 01:58:57.745422,34.007612
channel-6994,1326098,30362105,30362115,10,2025-02-26 01:59:18.436095,2025-02-26 01:59:31.108221,12.672126
channel-6994,1326099,30362190,30362201,11,2025-02-26 02:01:09.134830,2025-02-26 02:01:21.413478,12.278648
channel-6994,1326100,30362232,30362242,10,2025-02-26 02:02:00.632719,2025-02-26 02:02:12.540174,11.907455
channel-6994,1326101,30362294,30362303,9,2025-02-26 02:03:21.776792,2025-02-26 02:03:31.678154,9.901362
channel-6994,1326102,30362308,30362315,7,2025-02-26 02:03:37.465498,2025-02-26 02:03:48.683804,11.218306
channel-6994,1326103,30362340,30362352,12,2025-02-26 02:04:23.679214,2025-02-26 02:04:37.401279,13.722065
channel-6994,1326104,30362552,30362566,14,2025-02-26 02:08:48.532913,2025-02-26 02:09:06.750115,18.217202
channel-6994,1326105,30362601,30362609,8,2025-02-26 02:09:52.200615,2025-02-26 02:10:02.373562,10.172947
channel-6994,1326106,30362624,30362632,8,2025-02-26 02:10:20.572812,2025-02-26 02:10:31.755109,11.182297
channel-6994,1326107,30362657,30362670,13,2025-02-26 02:11:01.648740,2025-02-26 02:11:16.682014,15.033274
channel-6994,1326108,30362700,30362712,12,2025-02-26 02:11:56.790768,2025-02-26 02:12:13.754824,16.964056
channel-6994,1326109,30362872,30362883,11,2025-02-26 02:15:36.641811,2025-02-26 02:15:50.336654,13.694843
channel-6994,1326110,30362892,30362901,9,2025-02-26 02:16:01.552754,2025-02-26 02:16:13.036476,11.483722
channel-6994,1326111,30362931,30362940,9,2025-02-26 02:16:49.200584,2025-02-26 02:17:03.965583,14.764999
channel-6994,1326112,30362955,30362968,13,2025-02-26 02:17:23.325307,2025-02-26 02:17:38.470322,15.145015
channel-6994,1326113,30363087,30363096,9,2025-02-26 02:20:11.689766,2025-02-26 02:20:22.401261,10.711495
channel-6994,1326114,30363307,30363317,10,2025-02-26 02:24:54.397328,2025-02-26 02:25:06.682672,12.285344
channel-6994,1326115,30363484,30363493,9,2025-02-26 02:28:40.230758,2025-02-26 02:28:51.616631,11.385873
channel-6994,1326116,30364117,30364130,13,2025-02-26 02:42:10.184910,2025-02-26 02:42:26.095725,15.910815
channel-6994,1326117,30364231,30364242,11,2025-02-26 02:44:35.904844,2025-02-26 02:44:50.740901,14.836057
channel-6994,1326118,30364240,30364250,10,2025-02-26 02:44:47.344812,2025-02-26 02:45:00.925929,13.581117
channel-6994,1326119,30364403,30364412,9,2025-02-26 02:48:12.723863,2025-02-26 02:48:24.726945,12.003082
channel-6994,1326120,30364462,30364475,13,2025-02-26 02:49:28.576879,2025-02-26 02:49:44.520467,15.943588
channel-6994,1326121,30364497,30364505,8,2025-02-26 02:50:16.541168,2025-02-26 02:50:27.621046,11.079878
channel-6994,1326122,30364875,30364894,19,2025-02-26 02:58:29.043162,2025-02-26 02:58:51.633009,22.589847
channel-6994,1326123,30364900,30364912,12,2025-02-26 02:58:58.753879,2025-02-26 02:59:13.338371,14.584492
channel-6994,1326124,30365012,30365023,11,2025-02-26 03:01:24.847372,2025-02-26 03:01:37.326813,12.479441
channel-6994,1326125,30365222,30365232,10,2025-02-26 03:05:55.938874,2025-02-26 03:06:07.473505,11.534631
channel-6994,1326126,30365238,30365249,11,2025-02-26 03:06:14.532697,2025-02-26 03:06:29.216497,14.6838
channel-6994,1326127,30365407,30365418,11,2025-02-26 03:09:49.040279,2025-02-26 03:10:02.435624,13.395345
channel-6994,1326128,30365482,30365494,12,2025-02-26 03:11:27.557040,2025-02-26 03:11:43.400052,15.843012
channel-6994,1326129,30365517,30365526,9,2025-02-26 03:12:09.732050,2025-02-26 03:12:20.352103,10.620053
channel-6994,1326130,30365582,30365592,10,2025-02-26 03:13:31.458598,2025-02-26 03:13:44.295128,12.83653
channel-6994,1326131,30365622,30365634,12,2025-02-26 03:14:21.840984,2025-02-26 03:14:36.667146,14.826162
channel-6994,1326132,30365670,30365681,11,2025-02-26 03:15:25.749180,2025-02-26 03:15:40.255831,14.506651
channel-6994,1326133,30365673,30365695,22,2025-02-26 03:15:29.072214,2025-02-26 03:15:57.894695,28.822481
channel-6994,1326134,30365840,30365849,9,2025-02-26 03:19:01.870112,2025-02-26 03:19:12.164429,10.294317
channel-6994,1326135,30365840,30365849,9,2025-02-26 03:19:01.870112,2025-02-26 03:19:12.164429,10.294317
channel-6994,1326136,30366074,30366084,10,2025-02-26 03:24:01.848618,2025-02-26 03:24:16.273132,14.424514
channel-6994,1326137,30366263,30366282,19,2025-02-26 03:28:01.569096,2025-02-26 03:28:23.637361,22.068265
channel-6994,1326138,30366276,30366285,9,2025-02-26 03:28:16.699647,2025-02-26 03:28:30.208541,13.508894
channel-6994,1326139,30366309,30366317,8,2025-02-26 03:29:04.070305,2025-02-26 03:29:14.457252,10.386947
channel-6994,1326140,30366310,30366321,11,2025-02-26 03:29:05.163760,2025-02-26 03:29:19.350212,14.186452
channel-6994,1326141,30366331,30366339,8,2025-02-26 03:29:31.967055,2025-02-26 03:29:42.442524,10.475469
channel-6994,1326142,30366357,30366367,10,2025-02-26 03:30:04.451928,2025-02-26 03:30:17.095074,12.643146
channel-6994,1326143,30366395,30366425,30,2025-02-26 03:30:52.763251,2025-02-26 03:31:29.193011,36.42976
channel-6994,1326144,30366402,30366417,15,2025-02-26 03:31:00.852775,2025-02-26 03:31:19.042549,18.189774
channel-6994,1326145,30366594,30366606,12,2025-02-26 03:35:06.164267,2025-02-26 03:35:21.370242,15.205975
channel-6994,1326146,30366827,30366835,8,2025-02-26 03:40:06.829882,2025-02-26 03:40:17.043285,10.213403
channel-6994,1326147,30366901,30366908,7,2025-02-26 03:41:38.024429,2025-02-26 03:41:50.358003,12.333574
channel-6994,1326148,30366912,30366922,10,2025-02-26 03:41:57.940662,2025-02-26 03:42:10.042173,12.101511
channel-6994,1326149,30366927,30366938,11,2025-02-26 03:42:16.232918,2025-02-26 03:42:31.356821,15.123903
channel-6994,1326150,30366929,30366951,22,2025-02-26 03:42:18.578089,2025-02-26 03:42:47.855975,29.277886
channel-6994,1326151,30367143,30367172,29,2025-02-26 03:46:58.228582,2025-02-26 03:47:35.440075,37.211493
channel-6994,1326152,30367184,30367212,28,2025-02-26 03:47:52.655502,2025-02-26 03:48:25.959278,33.303776
channel-6994,1326153,30367503,30367514,11,2025-02-26 03:54:38.670691,2025-02-26 03:54:51.185515,12.514824
channel-6994,1326154,30367509,30367529,20,2025-02-26 03:54:45.533432,2025-02-26 03:55:14.351904,28.818472
channel-6994,1326155,30367526,30367535,9,2025-02-26 03:55:10.624311,2025-02-26 03:55:22.430946,11.806635
channel-6994,1326156,30367550,30367571,21,2025-02-26 03:55:42.907525,2025-02-26 03:56:09.337396,26.429871
channel-6994,1326157,30367848,30367856,8,2025-02-26 04:02:02.458500,2025-02-26 04:02:12.959174,10.500674
channel-6994,1326158,30367873,30367881,8,2025-02-26 04:02:34.757060,2025-02-26 04:02:45.070232,10.313172
channel-6994,1326159,30367989,30367999,10,2025-02-26 04:05:08.684478,2025-02-26 04:05:21.423270,12.738792
channel-6994,1326160,30368076,30368088,12,2025-02-26 04:07:00.971220,2025-02-26 04:07:14.657336,13.686116
channel-6994,1326161,30368206,30368220,14,2025-02-26 04:09:47.903081,2025-02-26 04:10:04.272974,16.369893
channel-6994,1326162,30368332,30368343,11,2025-02-26 04:12:25.533177,2025-02-26 04:12:42.494476,16.961299
channel-6994,1326163,30368506,30368516,10,2025-02-26 04:16:08.324418,2025-02-26 04:16:21.323805,12.999387
channel-6994,1326164,30368604,30368613,9,2025-02-26 04:18:12.636530,2025-02-26 04:18:24.777948,12.141418
channel-6994,1326165,30368615,30368640,25,2025-02-26 04:18:27.262610,2025-02-26 04:18:59.559257,32.296647
channel-6994,1326166,30368616,30368644,28,2025-02-26 04:18:28.501327,2025-02-26 04:19:04.522007,36.02068
channel-6994,1326167,30368642,30368653,11,2025-02-26 04:19:01.976241,2025-02-26 04:19:14.944852,12.968611
channel-6994,1326168,30368826,30368838,12,2025-02-26 04:22:59.331609,2025-02-26 04:23:13.553907,14.222298
channel-6994,1326169,30368891,30368903,12,2025-02-26 04:24:21.173669,2025-02-26 04:24:34.942926,13.769257
channel-6994,1326170,30369201,30369213,12,2025-02-26 04:30:53.968365,2025-02-26 04:31:09.466665,15.4983
channel-6994,1326171,30369861,30369869,8,2025-02-26 04:44:55.747562,2025-02-26 04:45:05.794526,10.046964
channel-6994,1326172,30370344,30370355,11,2025-02-26 04:55:11.789209,2025-02-26 04:55:25.390391,13.601182
channel-6994,1326173,30370385,30370396,11,2025-02-26 04:56:05.979361,2025-02-26 04:56:20.508383,14.529022
channel-6994,1326174,30370392,30370400,8,2025-02-26 04:56:15.044845,2025-02-26 04:56:25.454689,10.409844
channel-6994,1326175,30370422,30370432,10,2025-02-26 04:56:51.624903,2025-02-26 04:57:07.143504,15.518601
channel-6994,1326176,30370466,30370478,12,2025-02-26 04:57:48.780751,2025-02-26 04:58:02.754818,13.974067
channel-6994,1326177,30370518,30370528,10,2025-02-26 04:58:55.668183,2025-02-26 04:59:07.537811,11.869628
channel-6994,1326178,30370533,30370542,9,2025-02-26 04:59:13.078763,2025-02-26 04:59:24.820491,11.741728
channel-6994,1326179,30370593,30370604,11,2025-02-26 05:00:28.241831,2025-02-26 05:00:43.883990,15.642159
channel-6994,1326180,30370662,30370698,36,2025-02-26 05:02:00.398495,2025-02-26 05:02:45.533346,45.134851
channel-6994,1326181,30370725,30370765,40,2025-02-26 05:03:19.447728,2025-02-26 05:04:08.165990,48.718262
channel-6994,1326182,30370736,30370745,9,2025-02-26 05:03:32.988451,2025-02-26 05:03:45.252269,12.263818
channel-6994,1326183,30370753,30370765,12,2025-02-26 05:03:54.757427,2025-02-26 05:04:08.165990,13.408563
channel-6994,1326184,30370795,30370844,49,2025-02-26 05:04:45.501976,2025-02-26 05:05:52.266425,66.764449
channel-6994,1326185,30370861,30370897,36,2025-02-26 05:06:14.827082,2025-02-26 05:07:00.219129,45.392047
channel-6994,1326186,30370897,30370911,14,2025-02-26 05:07:00.219129,2025-02-26 05:07:16.506934,16.287805
channel-6994,1326187,30370925,30370964,39,2025-02-26 05:07:33.483506,2025-02-26 05:08:21.469926,47.98642
channel-6994,1326188,30370984,30370992,8,2025-02-26 05:08:49.604880,2025-02-26 05:09:00.844650,11.23977
channel-6994,1326189,30370986,30371029,43,2025-02-26 05:08:52.945532,2025-02-26 05:09:45.201074,52.255542
channel-6994,1326190,30371077,30371089,12,2025-02-26 05:10:50.059130,2025-02-26 05:11:05.292739,15.233609
channel-6994,1326191,30371157,30371167,10,2025-02-26 05:12:36.661370,2025-02-26 05:12:47.956236,11.294866
channel-6994,1326192,30371346,30371385,39,2025-02-26 05:16:37.092430,2025-02-26 05:17:26.062445,48.970015
channel-6994,1326193,30371416,30371452,36,2025-02-26 05:18:04.985622,2025-02-26 05:18:50.168127,45.182505
channel-6994,1326194,30371439,30371447,8,2025-02-26 05:18:34.220627,2025-02-26 05:18:44.512257,10.29163
channel-6994,1326195,30371476,30371513,37,2025-02-26 05:19:23.577264,2025-02-26 05:20:10.195287,46.618023
channel-6994,1326196,30371538,30371570,32,2025-02-26 05:20:41.125329,2025-02-26 05:21:27.261390,46.136061
channel-6994,1326197,30371560,30371568,8,2025-02-26 05:21:08.287606,2025-02-26 05:21:20.527775,12.240169
channel-6994,1326198,30371568,30371584,16,2025-02-26 05:21:20.527775,2025-02-26 05:21:44.542231,24.014456
channel-6994,1326199,30371583,30371593,10,2025-02-26 05:21:43.400187,2025-02-26 05:21:55.934477,12.53429
channel-6994,1326200,30371601,30371638,37,2025-02-26 05:22:05.268078,2025-02-26 05:22:51.039068,45.77099
channel-6994,1326201,30371601,30371612,11,2025-02-26 05:22:05.268078,2025-02-26 05:22:20.209249,14.941171
channel-6994,1326202,30371666,30371701,35,2025-02-26 05:23:28.861465,2025-02-26 05:24:15.484768,46.623303
channel-6994,1326203,30371683,30371693,10,2025-02-26 05:23:51.460159,2025-02-26 05:24:06.019021,14.558862
channel-6994,1326204,30371690,30371701,11,2025-02-26 05:24:02.591484,2025-02-26 05:24:15.484768,12.893284
channel-6994,1326205,30371727,30371775,48,2025-02-26 05:24:48.019817,2025-02-26 05:25:50.979205,62.959388
channel-6994,1326206,30371777,30371789,12,2025-02-26 05:25:54.340491,2025-02-26 05:26:09.211132,14.870641
channel-6994,1326208,30372049,30372081,32,2025-02-26 05:31:39.453987,2025-02-26 05:32:19.541729,40.087742
channel-6994,1326209,30372106,30372144,38,2025-02-26 05:32:56.903171,2025-02-26 05:33:43.133151,46.22998
channel-6994,1326210,30372171,30372204,33,2025-02-26 05:34:15.451228,2025-02-26 05:35:00.659236,45.208008
channel-6994,1326211,30372229,30372266,37,2025-02-26 05:35:31.023314,2025-02-26 05:36:18.123345,47.100031
channel-6994,1326212,30372347,30372353,6,2025-02-26 05:37:59.156075,2025-02-26 05:38:09.418941,10.262866
channel-6994,1326213,30372476,30372485,9,2025-02-26 05:40:41.980778,2025-02-26 05:40:54.291814,12.311036
channel-6994,1326214,30372607,30372619,12,2025-02-26 05:43:30.655881,2025-02-26 05:43:48.457921,17.80204
channel-6994,1326215,30372735,30372746,11,2025-02-26 05:46:18.729532,2025-02-26 05:46:33.405838,14.676306
channel-6994,1326216,30372957,30372964,7,2025-02-26 05:51:01.733151,2025-02-26 05:51:12.832200,11.099049
channel-6994,1326217,30372981,30372992,11,2025-02-26 05:51:34.598059,2025-02-26 05:51:48.237560,13.639501
channel-6994,1326218,30373020,30373058,38,2025-02-26 05:52:22.181060,2025-02-26 05:53:09.909531,47.728471
channel-6994,1326219,30373084,30373114,30,2025-02-26 05:53:42.903674,2025-02-26 05:54:21.415066,38.511392
channel-6994,1326220,30373139,30373182,43,2025-02-26 05:54:56.352105,2025-02-26 05:55:50.499421,54.147316
channel-6994,1326221,30373210,30373245,35,2025-02-26 05:56:25.412188,2025-02-26 05:57:08.227806,42.815618
channel-6994,1326222,30373314,30373323,9,2025-02-26 05:58:37.295471,2025-02-26 05:58:47.639259,10.343788
channel-6994,1326223,30373380,30373416,36,2025-02-26 05:59:59.982753,2025-02-26 06:00:48.802713,48.81996
channel-6994,1326224,30373435,30373470,35,2025-02-26 06:01:11.924075,2025-02-26 06:01:55.690068,43.765993
channel-6994,1326225,30373494,30373525,31,2025-02-26 06:02:30.896196,2025-02-26 06:03:13.740303,42.844107
channel-6994,1326226,30373549,30373582,33,2025-02-26 06:03:45.282018,2025-02-26 06:04:29.717265,44.435247
channel-6994,1326227,30373604,30373648,44,2025-02-26 06:04:58.443884,2025-02-26 06:05:55.658690,57.214806
channel-6994,1326228,30373625,30373634,9,2025-02-26 06:05:26.516863,2025-02-26 06:05:36.797559,10.280696
channel-6994,1326229,30373949,30373956,7,2025-02-26 06:12:21.367586,2025-02-26 06:12:32.680226,11.31264
channel-6994,1326230,30373971,30373980,9,2025-02-26 06:12:50.028852,2025-02-26 06:13:01.808158,11.779306
channel-6994,1326231,30373978,30373987,9,2025-02-26 06:12:59.290822,2025-02-26 06:13:11.708406,12.417584
channel-6994,1326232,30374017,30374027,10,2025-02-26 06:13:47.464519,2025-02-26 06:14:02.636039,15.17152
channel-6994,1326233,30374205,30374214,9,2025-02-26 06:17:47.930486,2025-02-26 06:17:57.807570,9.877084
channel-6994,1326234,30374404,30374414,10,2025-02-26 06:22:02.703420,2025-02-26 06:22:15.290519,12.587099
channel-6994,1326235,30374503,30374513,10,2025-02-26 06:24:08.540193,2025-02-26 06:24:21.001103,12.46091
channel-6994,1326236,30374616,30374627,11,2025-02-26 06:26:34.212112,2025-02-26 06:26:47.039832,12.82772
channel-6994,1326237,30374672,30374683,11,2025-02-26 06:27:45.039281,2025-02-26 06:28:00.730628,15.691347
channel-6994,1326238,30374734,30374743,9,2025-02-26 06:29:05.063331,2025-02-26 06:29:15.251924,10.188593
channel-6994,1326239,30374884,30374908,24,2025-02-26 06:32:15.249926,2025-02-26 06:32:45.538913,30.288987
channel-6994,1326240,30374925,30374936,11,2025-02-26 06:33:06.967071,2025-02-26 06:33:19.412753,12.445682
channel-6994,1326241,30374925,30374936,11,2025-02-26 06:33:06.967071,2025-02-26 06:33:19.412753,12.445682
channel-6994,1326242,30374929,30374949,20,2025-02-26 06:33:11.485969,2025-02-26 06:33:39.603649,28.11768
channel-6994,1326243,30374969,30374979,10,2025-02-26 06:34:03.512694,2025-02-26 06:34:14.762326,11.249632
channel-6994,1326244,30374989,30375002,13,2025-02-26 06:34:31.846175,2025-02-26 06:34:48.886514,17.040339
channel-6994,1326245,30375059,30375070,11,2025-02-26 06:36:00.737739,2025-02-26 06:36:13.796956,13.059217
channel-6994,1326246,30375089,30375104,15,2025-02-26 06:36:36.771362,2025-02-26 06:36:57.836019,21.064657
channel-6994,1326247,30375124,30375133,9,2025-02-26 06:37:23.468294,2025-02-26 06:37:35.043814,11.57552
channel-6994,1326248,30375217,30375227,10,2025-02-26 06:39:19.765298,2025-02-26 06:39:33.323725,13.558427
channel-6994,1326249,30375240,30375250,10,2025-02-26 06:39:48.916228,2025-02-26 06:40:00.758691,11.842463
channel-6994,1326250,30375249,30375260,11,2025-02-26 06:39:59.543394,2025-02-26 06:40:11.894113,12.350719
channel-6994,1326251,30375308,30375317,9,2025-02-26 06:41:14.307020,2025-02-26 06:41:24.755436,10.448416
channel-6994,1326252,30375340,30375365,25,2025-02-26 06:41:55.338270,2025-02-26 06:42:26.196270,30.858
channel-6994,1326253,30375505,30375515,10,2025-02-26 06:45:30.013350,2025-02-26 06:45:42.284855,12.271505
channel-6994,1326254,30375557,30375566,9,2025-02-26 06:46:37.602452,2025-02-26 06:46:50.676685,13.074233
channel-6994,1326255,30375585,30375594,9,2025-02-26 06:47:13.073735,2025-02-26 06:47:23.435420,10.361685
channel-6994,1326256,30375625,30375635,10,2025-02-26 06:48:06.282316,2025-02-26 06:48:18.914401,12.632085
channel-6994,1326257,30375774,30375782,8,2025-02-26 06:51:12.163279,2025-02-26 06:51:21.463476,9.300197
channel-6994,1326258,30375775,30375787,12,2025-02-26 06:51:13.334814,2025-02-26 06:51:28.300140,14.965326
channel-6994,1326259,30375784,30375796,12,2025-02-26 06:51:24.894833,2025-02-26 06:51:39.726587,14.831754
channel-6994,1326260,30375882,30375895,13,2025-02-26 06:53:31.570571,2025-02-26 06:53:48.210362,16.639791
channel-6994,1326261,30375961,30375973,12,2025-02-26 06:55:10.794614,2025-02-26 06:55:25.275982,14.481368
channel-6994,1326262,30376036,30376046,10,2025-02-26 06:56:47.679621,2025-02-26 06:57:01.248645,13.569024
channel-6994,1326263,30376109,30376120,11,2025-02-26 06:58:24.812180,2025-02-26 06:58:37.792758,12.980578
channel-6994,1326264,30376282,30376292,10,2025-02-26 07:02:02.468069,2025-02-26 07:02:16.807781,14.339712
channel-6994,1326265,30376326,30376335,9,2025-02-26 07:03:01.340537,2025-02-26 07:03:13.031773,11.691236
channel-6994,1326266,30376373,30376384,11,2025-02-26 07:04:00.906113,2025-02-26 07:04:14.619024,13.712911
channel-6994,1326267,30376511,30376523,12,2025-02-26 07:07:00.381770,2025-02-26 07:07:14.012297,13.630527
channel-6994,1326268,30376518,30376527,9,2025-02-26 07:07:08.410758,2025-02-26 07:07:19.629450,11.218692
channel-6994,1326269,30376540,30376553,13,2025-02-26 07:07:37.380622,2025-02-26 07:07:53.533090,16.152468
channel-6994,1326270,30376646,30376661,15,2025-02-26 07:09:50.454645,2025-02-26 07:10:08.028825,17.57418
channel-6994,1326271,30376722,30376731,9,2025-02-26 07:11:29.839713,2025-02-26 07:11:41.985030,12.145317
channel-6994,1326272,30376765,30376776,11,2025-02-26 07:12:25.736118,2025-02-26 07:12:39.477362,13.741244
channel-6994,1326273,30376789,30376798,9,2025-02-26 07:12:54.556171,2025-02-26 07:13:06.200870,11.644699
channel-6994,1326274,30376795,30376808,13,2025-02-26 07:13:01.746344,2025-02-26 07:13:17.636588,15.890244
channel-6994,1326275,30376801,30376813,12,2025-02-26 07:13:09.690113,2025-02-26 07:13:23.008879,13.318766
channel-6994,1326276,30376878,30376888,10,2025-02-26 07:14:50.946619,2025-02-26 07:15:02.500093,11.553474
channel-6994,1326277,30377037,30377046,9,2025-02-26 07:18:10.213752,2025-02-26 07:18:22.542695,12.328943
channel-6994,1326278,30377106,30377116,10,2025-02-26 07:19:39.221961,2025-02-26 07:19:52.675790,13.453829
channel-6994,1326279,30377137,30377149,12,2025-02-26 07:20:17.559668,2025-02-26 07:20:32.397215,14.837547
channel-6994,1326280,30377149,30377170,21,2025-02-26 07:20:32.397215,2025-02-26 07:20:59.783032,27.385817
channel-6994,1326281,30377247,30377259,12,2025-02-26 07:22:33.514797,2025-02-26 07:22:49.903394,16.388597
channel-6994,1326282,30377293,30377319,26,2025-02-26 07:23:36.056278,2025-02-26 07:24:08.198967,32.142689
channel-6994,1326283,30377359,30377369,10,2025-02-26 07:24:58.079027,2025-02-26 07:25:14.857504,16.778477
channel-6994,1326284,30377385,30377397,12,2025-02-26 07:25:34.103521,2025-02-26 07:25:48.341390,14.237869
channel-6994,1326285,30377388,30377415,27,2025-02-26 07:25:37.634416,2025-02-26 07:26:10.985423,33.351007
channel-6994,1326286,30377415,30377425,10,2025-02-26 07:26:10.985423,2025-02-26 07:26:23.639058,12.653635
channel-6994,1326287,30377586,30377595,9,2025-02-26 07:29:49.836732,2025-02-26 07:30:02.332512,12.49578
channel-6994,1326288,30377642,30377664,22,2025-02-26 07:31:00.967125,2025-02-26 07:31:27.313806,26.346681
channel-6994,1326289,30377692,30377701,9,2025-02-26 07:32:05.423211,2025-02-26 07:32:16.941694,11.518483
channel-6994,1326290,30377711,30377724,13,2025-02-26 07:32:30.239418,2025-02-26 07:32:45.721652,15.482234
channel-6994,1326291,30377733,30377746,13,2025-02-26 07:32:58.017205,2025-02-26 07:33:13.007879,14.990674
channel-6994,1326292,30377754,30377782,28,2025-02-26 07:33:22.167210,2025-02-26 07:33:58.782371,36.615161
channel-6994,1326293,30377778,30377792,14,2025-02-26 07:33:51.742261,2025-02-26 07:34:12.722021,20.97976
channel-6994,1326294,30378236,30378249,13,2025-02-26 07:43:46.210416,2025-02-26 07:44:00.890314,14.679898
channel-6994,1326295,30378250,30378259,9,2025-02-26 07:44:02.090658,2025-02-26 07:44:12.658745,10.568087
channel-6994,1326296,30378288,30378298,10,2025-02-26 07:44:49.288805,2025-02-26 07:45:01.477641,12.188836
channel-6994,1326297,30378431,30378445,14,2025-02-26 07:47:51.236508,2025-02-26 07:48:08.139698,16.90319
channel-6994,1326298,30378572,30378585,13,2025-02-26 07:50:58.525249,2025-02-26 07:51:13.369184,14.843935
channel-6994,1326299,30378577,30378591,14,2025-02-26 07:51:04.226475,2025-02-26 07:51:20.253185,16.02671
channel-6994,1326300,30378610,30378621,11,2025-02-26 07:51:45.440596,2025-02-26 07:51:58.059840,12.619244
channel-6994,1326301,30378672,30378682,10,2025-02-26 07:53:02.634691,2025-02-26 07:53:14.322767,11.688076
channel-6994,1326302,30378741,30378753,12,2025-02-26 07:54:31.241838,2025-02-26 07:54:46.824269,15.582431
channel-6994,1326303,30378742,30378753,11,2025-02-26 07:54:32.329390,2025-02-26 07:54:46.824269,14.494879
channel-6994,1326304,30378782,30378794,12,2025-02-26 07:55:21.942112,2025-02-26 07:55:37.713583,15.771471
channel-6994,1326305,30378904,30378910,6,2025-02-26 07:57:56.057318,2025-02-26 07:58:07.096075,11.038757
channel-6994,1326306,30378919,30378930,11,2025-02-26 07:58:19.143542,2025-02-26 07:58:34.846042,15.7025
channel-6994,1326307,30379071,30379082,11,2025-02-26 08:01:32.054226,2025-02-26 08:01:45.208512,13.154286
channel-6994,1326308,30379077,30379086,9,2025-02-26 08:01:39.199995,2025-02-26 08:01:52.392614,13.192619
channel-6994,1326309,30379272,30379285,13,2025-02-26 08:05:50.450630,2025-02-26 08:06:07.653316,17.202686
channel-6994,1326310,30379302,30379314,12,2025-02-26 08:06:28.283396,2025-02-26 08:06:42.138976,13.85558
channel-6994,1326311,30379322,30379335,13,2025-02-26 08:06:53.108328,2025-02-26 08:07:09.612374,16.504046
channel-6994,1326312,30379352,30379364,12,2025-02-26 08:07:35.357332,2025-02-26 08:07:49.017248,13.659916
channel-6994,1326313,30379419,30379430,11,2025-02-26 08:08:56.712021,2025-02-26 08:09:12.594998,15.882977
channel-6994,1326314,30379509,30379516,7,2025-02-26 08:10:55.180706,2025-02-26 08:11:04.202925,9.022219
channel-6994,1326315,30379512,30379521,9,2025-02-26 08:10:58.614592,2025-02-26 08:11:11.595079,12.980487
channel-6994,1326316,30379569,30379579,10,2025-02-26 08:12:14.746718,2025-02-26 08:12:26.178901,11.432183
channel-6994,1326317,30379599,30379615,16,2025-02-26 08:12:52.114095,2025-02-26 08:13:13.966278,21.852183
channel-6994,1326318,30379618,30379627,9,2025-02-26 08:13:17.555657,2025-02-26 08:13:29.079193,11.523536
channel-6994,1326319,30379647,30379657,10,2025-02-26 08:13:53.585341,2025-02-26 08:14:04.943118,11.357777
channel-6994,1326320,30379973,30379984,11,2025-02-26 08:20:49.850706,2025-02-26 08:21:03.413819,13.563113
