channel_id,sequence,send_height,ack_height,block_delay,send_time,ack_time,time_delay_sec
channel-750,679808,30159513,30159523,10,2025-02-22 23:43:11.843115,2025-02-22 23:43:23.101422,11.258307
channel-750,679809,30159568,30159572,4,2025-02-22 23:44:25.277579,2025-02-22 23:44:29.785298,4.507719
channel-750,679810,30159612,30159626,14,2025-02-22 23:45:20.579041,2025-02-22 23:45:38.641019,18.061978
channel-750,679811,30159857,30159873,16,2025-02-22 23:50:34.622110,2025-02-22 23:50:54.273007,19.650897
channel-750,679812,30159857,30159873,16,2025-02-22 23:50:34.622110,2025-02-22 23:50:54.273007,19.650897
channel-750,679813,30159860,30159873,13,2025-02-22 23:50:39.329578,2025-02-22 23:50:54.273007,14.943429
channel-750,679814,30159860,30159864,4,2025-02-22 23:50:39.329578,2025-02-22 23:50:44.250152,4.920574
channel-750,679815,30159867,30159881,14,2025-02-22 23:50:47.519720,2025-02-22 23:51:06.255219,18.735499
channel-750,679816,30159879,30159893,14,2025-02-22 23:51:03.275090,2025-02-22 23:51:22.761176,19.486086
channel-750,679817,30159903,30159916,13,2025-02-22 23:51:35.257199,2025-02-22 23:51:50.348498,15.091299
channel-750,679818,30159904,30159909,5,2025-02-22 23:51:36.380975,2025-02-22 23:51:41.885057,5.504082
channel-750,679819,30159943,30159949,6,2025-02-22 23:52:23.432287,2025-02-22 23:52:30.818367,7.38608
channel-750,679820,30160109,30160115,6,2025-02-22 23:55:59.810102,2025-02-22 23:56:07.097832,7.28773
channel-750,679821,30160152,30160158,6,2025-02-22 23:56:54.357930,2025-02-22 23:57:01.534283,7.176353
channel-750,679822,30160168,30160175,7,2025-02-22 23:57:17.632602,2025-02-22 23:57:27.201969,9.569367
channel-750,679823,30160195,30160200,5,2025-02-22 23:57:52.896654,2025-02-22 23:57:58.466875,5.570221
channel-750,679824,30160227,30160232,5,2025-02-22 23:58:35.658687,2025-02-22 23:58:42.831750,7.173063
channel-750,679825,30160268,30160278,10,2025-02-22 23:59:31.029510,2025-02-22 23:59:42.532817,11.503307
channel-750,679826,30160302,30160305,3,2025-02-23 00:00:13.097218,2025-02-23 00:00:16.377247,3.280029
channel-750,679827,30160308,30160313,5,2025-02-23 00:00:21.492847,2025-02-23 00:00:28.228992,6.736145
channel-750,679828,30160315,30160320,5,2025-02-23 00:00:30.526609,2025-02-23 00:00:37.752207,7.225598
channel-750,679829,30160324,30160329,5,2025-02-23 00:00:43.265202,2025-02-23 00:00:49.143195,5.877993
channel-750,679830,30160330,30160334,4,2025-02-23 00:00:51.771226,2025-02-23 00:00:56.518455,4.747229
channel-750,679831,30160381,30160387,6,2025-02-23 00:01:59.346487,2025-02-23 00:02:06.688050,7.341563
channel-750,679832,30160394,30160411,17,2025-02-23 00:02:16.001515,2025-02-23 00:02:36.235369,20.233854
channel-750,679833,30160411,30160416,5,2025-02-23 00:02:36.235369,2025-02-23 00:02:41.862393,5.627024
channel-750,679834,30160418,30160423,5,2025-02-23 00:02:44.667366,2025-02-23 00:02:51.431456,6.76409
channel-750,679835,30160434,30160440,6,2025-02-23 00:03:05.316171,2025-02-23 00:03:12.178251,6.86208
channel-750,679836,30160436,30160441,5,2025-02-23 00:03:07.562934,2025-02-23 00:03:13.308846,5.745912
channel-750,679837,30160442,30160451,9,2025-02-23 00:03:14.388815,2025-02-23 00:03:26.224967,11.836152
channel-750,679838,30160447,30160451,4,2025-02-23 00:03:21.112096,2025-02-23 00:03:26.224967,5.112871
channel-750,679839,30160449,30160454,5,2025-02-23 00:03:23.345938,2025-02-23 00:03:30.384704,7.038766
channel-750,679840,30160464,30160470,6,2025-02-23 00:03:41.922871,2025-02-23 00:03:49.909758,7.986887
channel-750,679841,30160477,30160483,6,2025-02-23 00:03:59.309797,2025-02-23 00:04:08.266950,8.957153
channel-750,679842,30160519,30160533,14,2025-02-23 00:04:54.567389,2025-02-23 00:05:13.545887,18.978498
channel-750,679843,30160602,30160607,5,2025-02-23 00:06:42.334087,2025-02-23 00:06:47.879941,5.545854
channel-750,679844,30160762,30160766,4,2025-02-23 00:10:07.328211,2025-02-23 00:10:14.368920,7.040709
channel-750,679845,30160899,30160904,5,2025-02-23 00:13:01.922418,2025-02-23 00:13:07.575848,5.65343
channel-750,679846,30160945,30160949,4,2025-02-23 00:14:01.638758,2025-02-23 00:14:06.366834,4.728076
channel-750,679847,30160959,30160965,6,2025-02-23 00:14:21.604251,2025-02-23 00:14:28.310007,6.705756
channel-750,679848,30161104,30161117,13,2025-02-23 00:17:28.707135,2025-02-23 00:17:43.678479,14.971344
channel-750,679849,30161201,30161204,3,2025-02-23 00:19:33.358720,2025-02-23 00:19:36.606298,3.247578
channel-750,679850,30161214,30161228,14,2025-02-23 00:19:51.883366,2025-02-23 00:20:08.466273,16.582907
channel-750,679851,30161216,30161221,5,2025-02-23 00:19:54.178268,2025-02-23 00:19:59.790011,5.611743
channel-750,679852,30161221,30161234,13,2025-02-23 00:19:59.790011,2025-02-23 00:20:15.158633,15.368622
channel-750,679853,30161225,30161241,16,2025-02-23 00:20:04.562640,2025-02-23 00:20:23.232359,18.669719
channel-750,679854,30161226,30161231,5,2025-02-23 00:20:06.248585,2025-02-23 00:20:11.825637,5.577052
channel-750,679855,30161228,30161244,16,2025-02-23 00:20:08.466273,2025-02-23 00:20:26.560904,18.094631
channel-750,679856,30161257,30161269,12,2025-02-23 00:20:45.477068,2025-02-23 00:21:02.595909,17.118841
channel-750,679857,30161258,30161262,4,2025-02-23 00:20:46.761175,2025-02-23 00:20:53.511443,6.750268
channel-750,679858,30161259,30161263,4,2025-02-23 00:20:48.394920,2025-02-23 00:20:55.661730,7.26681
channel-750,679859,30161262,30161277,15,2025-02-23 00:20:53.511443,2025-02-23 00:21:13.940931,20.429488
channel-750,679860,30161272,30161279,7,2025-02-23 00:21:07.309236,2025-02-23 00:21:17.280603,9.971367
channel-750,679861,30161272,30161286,14,2025-02-23 00:21:07.309236,2025-02-23 00:21:26.448037,19.138801
channel-750,679862,30161275,30161289,14,2025-02-23 00:21:11.697335,2025-02-23 00:21:30.221180,18.523845
channel-750,679863,30161282,30161293,11,2025-02-23 00:21:20.820551,2025-02-23 00:21:36.653791,15.83324
channel-750,679864,30161282,30161287,5,2025-02-23 00:21:20.820551,2025-02-23 00:21:27.718467,6.897916
channel-750,679865,30161287,30161300,13,2025-02-23 00:21:27.718467,2025-02-23 00:21:44.932178,17.213711
channel-750,679866,30161288,30161292,4,2025-02-23 00:21:29.011414,2025-02-23 00:21:34.175254,5.16384
channel-750,679867,30161293,30161300,7,2025-02-23 00:21:36.653791,2025-02-23 00:21:44.932178,8.278387
channel-750,679868,30161295,30161309,14,2025-02-23 00:21:38.981512,2025-02-23 00:21:56.161477,17.179965
channel-750,679869,30161299,30161311,12,2025-02-23 00:21:43.536071,2025-02-23 00:21:58.500543,14.964472
channel-750,679870,30161307,30161322,15,2025-02-23 00:21:53.917761,2025-02-23 00:22:11.799270,17.881509
channel-750,679871,30161309,30161323,14,2025-02-23 00:21:56.161477,2025-02-23 00:22:13.206008,17.044531
channel-750,679872,30161310,30161323,13,2025-02-23 00:21:57.281699,2025-02-23 00:22:13.206008,15.924309
channel-750,679873,30161311,30161315,4,2025-02-23 00:21:58.500543,2025-02-23 00:22:04.039709,5.539166
channel-750,679874,30161315,30161331,16,2025-02-23 00:22:04.039709,2025-02-23 00:22:23.327025,19.287316
channel-750,679875,30161325,30161329,4,2025-02-23 00:22:15.930651,2025-02-23 00:22:20.981416,5.050765
channel-750,679876,30161329,30161343,14,2025-02-23 00:22:20.981416,2025-02-23 00:22:38.515822,17.534406
channel-750,679877,30161329,30161334,5,2025-02-23 00:22:20.981416,2025-02-23 00:22:26.871233,5.889817
channel-750,679878,30161330,30161343,13,2025-02-23 00:22:22.112137,2025-02-23 00:22:38.515822,16.403685
channel-750,679879,30161339,30161352,13,2025-02-23 00:22:32.894665,2025-02-23 00:22:50.109108,17.214443
channel-750,679880,30161347,30161352,5,2025-02-23 00:22:44.566027,2025-02-23 00:22:50.109108,5.543081
channel-750,679881,30161348,30161361,13,2025-02-23 00:22:45.728482,2025-02-23 00:23:01.209404,15.480922
channel-750,679882,30161348,30161353,5,2025-02-23 00:22:45.728482,2025-02-23 00:22:51.405299,5.676817
channel-750,679883,30161352,30161366,14,2025-02-23 00:22:50.109108,2025-02-23 00:23:08.840626,18.731518
channel-750,679884,30161356,30161361,5,2025-02-23 00:22:54.904555,2025-02-23 00:23:01.209404,6.304849
channel-750,679885,30161359,30161370,11,2025-02-23 00:22:58.337972,2025-02-23 00:23:13.959843,15.621871
channel-750,679886,30161360,30161376,16,2025-02-23 00:23:00.115546,2025-02-23 00:23:21.831343,21.715797
channel-750,679887,30161364,30161376,12,2025-02-23 00:23:06.327105,2025-02-23 00:23:21.831343,15.504238
channel-750,679888,30161366,30161378,12,2025-02-23 00:23:08.840626,2025-02-23 00:23:24.147056,15.30643
channel-750,679889,30161389,30161398,9,2025-02-23 00:23:39.957072,2025-02-23 00:23:53.039065,13.081993
channel-750,679890,30161394,30161399,5,2025-02-23 00:23:46.222486,2025-02-23 00:23:54.205965,7.983479
channel-750,679891,30161416,30161421,5,2025-02-23 00:24:16.751849,2025-02-23 00:24:22.467458,5.715609
channel-750,679892,30161418,30161424,6,2025-02-23 00:24:19.049255,2025-02-23 00:24:25.905907,6.856652
channel-750,679893,30161528,30161538,10,2025-02-23 00:26:37.529103,2025-02-23 00:26:50.551390,13.022287
channel-750,679894,30161581,30161589,8,2025-02-23 00:27:45.342484,2025-02-23 00:27:55.865554,10.52307
channel-750,679895,30161585,30161601,16,2025-02-23 00:27:51.208598,2025-02-23 00:28:11.232224,20.023626
channel-750,679896,30161613,30161618,5,2025-02-23 00:28:26.454269,2025-02-23 00:28:32.330843,5.876574
channel-750,679897,30161722,30161726,4,2025-02-23 00:30:49.040414,2025-02-23 00:30:53.469694,4.42928
channel-750,679898,30161724,30161736,12,2025-02-23 00:30:51.262152,2025-02-23 00:31:06.880374,15.618222
channel-750,679899,30161729,30161733,4,2025-02-23 00:30:58.322582,2025-02-23 00:31:03.731334,5.408752
channel-750,679900,30161736,30161748,12,2025-02-23 00:31:06.880374,2025-02-23 00:31:20.905454,14.02508
channel-750,679901,30161740,30161745,5,2025-02-23 00:31:11.356008,2025-02-23 00:31:17.414756,6.058748
channel-750,679902,30161741,30161753,12,2025-02-23 00:31:12.515081,2025-02-23 00:31:27.872625,15.357544
channel-750,679903,30161747,30161766,19,2025-02-23 00:31:19.679999,2025-02-23 00:31:44.145218,24.465219
channel-750,679904,30161752,30161764,12,2025-02-23 00:31:26.675949,2025-02-23 00:31:41.766030,15.090081
channel-750,679905,30161754,30161766,12,2025-02-23 00:31:29.009058,2025-02-23 00:31:44.145218,15.13616
channel-750,679906,30161759,30161763,4,2025-02-23 00:31:34.611242,2025-02-23 00:31:40.687146,6.075904
channel-750,679907,30161764,30161775,11,2025-02-23 00:31:41.766030,2025-02-23 00:31:57.898408,16.132378
channel-750,679908,30161799,30161809,10,2025-02-23 00:32:27.628945,2025-02-23 00:32:40.822609,13.193664
channel-750,679909,30161845,30161850,5,2025-02-23 00:33:28.000744,2025-02-23 00:33:34.604432,6.603688
channel-750,679910,30161847,30161852,5,2025-02-23 00:33:30.230278,2025-02-23 00:33:37.219342,6.989064
channel-750,679911,30161848,30161861,13,2025-02-23 00:33:32.379204,2025-02-23 00:33:49.781424,17.40222
channel-750,679912,30161853,30161864,11,2025-02-23 00:33:38.334172,2025-02-23 00:33:53.814581,15.480409
channel-750,679913,30161854,30161864,10,2025-02-23 00:33:39.393932,2025-02-23 00:33:53.814581,14.420649
channel-750,679914,30161857,30161870,13,2025-02-23 00:33:42.796414,2025-02-23 00:34:01.962917,19.166503
channel-750,679915,30161858,30161870,12,2025-02-23 00:33:45.072764,2025-02-23 00:34:01.962917,16.890153
channel-750,679916,30161859,30161864,5,2025-02-23 00:33:47.336581,2025-02-23 00:33:53.814581,6.478
channel-750,679917,30161872,30161886,14,2025-02-23 00:34:05.447747,2025-02-23 00:34:22.541077,17.09333
channel-750,679918,30161880,30161894,14,2025-02-23 00:34:15.535266,2025-02-23 00:34:31.947949,16.412683
channel-750,679919,30161885,30161897,12,2025-02-23 00:34:21.376659,2025-02-23 00:34:35.849545,14.472886
channel-750,679920,30161911,30161915,4,2025-02-23 00:34:53.518464,2025-02-23 00:34:57.977662,4.459198
channel-750,679921,30161914,30161919,5,2025-02-23 00:34:56.832992,2025-02-23 00:35:03.945098,7.112106
channel-750,679922,30161915,30161928,13,2025-02-23 00:34:57.977662,2025-02-23 00:35:15.883396,17.905734
channel-750,679923,30161918,30161932,14,2025-02-23 00:35:02.841911,2025-02-23 00:35:21.302528,18.460617
channel-750,679924,30161920,30161936,16,2025-02-23 00:35:06.325461,2025-02-23 00:35:25.714821,19.38936
channel-750,679925,30161921,30161936,15,2025-02-23 00:35:07.550522,2025-02-23 00:35:25.714821,18.164299
channel-750,679926,30161940,30161946,6,2025-02-23 00:35:31.562345,2025-02-23 00:35:38.735986,7.173641
channel-750,679927,30161945,30161949,4,2025-02-23 00:35:37.734027,2025-02-23 00:35:42.028133,4.294106
channel-750,679928,30161967,30161972,5,2025-02-23 00:36:05.131954,2025-02-23 00:36:12.023224,6.89127
channel-750,679929,30161967,30161972,5,2025-02-23 00:36:05.131954,2025-02-23 00:36:12.023224,6.89127
channel-750,679930,30161970,30161983,13,2025-02-23 00:36:09.636154,2025-02-23 00:36:25.862198,16.226044
channel-750,679931,30161971,30161983,12,2025-02-23 00:36:10.792727,2025-02-23 00:36:25.862198,15.069471
channel-750,679932,30161973,30161978,5,2025-02-23 00:36:13.171992,2025-02-23 00:36:18.556626,5.384634
channel-750,679933,30161975,30161986,11,2025-02-23 00:36:15.317844,2025-02-23 00:36:29.418025,14.100181
channel-750,679934,30161993,30162006,13,2025-02-23 00:36:37.433297,2025-02-23 00:36:54.677823,17.244526
channel-750,679935,30161995,30161999,4,2025-02-23 00:36:39.702023,2025-02-23 00:36:45.439104,5.737081
channel-750,679936,30162037,30162045,8,2025-02-23 00:37:34.916080,2025-02-23 00:37:50.214856,15.298776
channel-750,679937,30162041,30162053,12,2025-02-23 00:37:44.292879,2025-02-23 00:38:03.196160,18.903281
channel-750,679938,30162047,30162053,6,2025-02-23 00:37:56.082886,2025-02-23 00:38:03.196160,7.113274
channel-750,679939,30162048,30162062,14,2025-02-23 00:37:57.279487,2025-02-23 00:38:15.197523,17.918036
channel-750,679940,30162050,30162064,14,2025-02-23 00:37:59.887574,2025-02-23 00:38:18.451241,18.563667
channel-750,679941,30162050,30162064,14,2025-02-23 00:37:59.887574,2025-02-23 00:38:18.451241,18.563667
channel-750,679942,30162096,30162109,13,2025-02-23 00:38:57.836541,2025-02-23 00:39:14.291729,16.455188
channel-750,679943,30162098,30162102,4,2025-02-23 00:38:59.995183,2025-02-23 00:39:05.027391,5.032208
channel-750,679944,30162098,30162112,14,2025-02-23 00:38:59.995183,2025-02-23 00:39:18.774621,18.779438
channel-750,679945,30162111,30162114,3,2025-02-23 00:39:17.703248,2025-02-23 00:39:21.034996,3.331748
channel-750,679946,30162114,30162125,11,2025-02-23 00:39:21.034996,2025-02-23 00:39:39.078822,18.043826
channel-750,679947,30162130,30162145,15,2025-02-23 00:39:44.913632,2025-02-23 00:40:03.794636,18.881004
channel-750,679948,30162146,30162161,15,2025-02-23 00:40:05.748883,2025-02-23 00:40:24.034067,18.285184
channel-750,679949,30162151,30162164,13,2025-02-23 00:40:11.567456,2025-02-23 00:40:27.322081,15.754625
channel-750,679950,30162165,30162170,5,2025-02-23 00:40:28.524432,2025-02-23 00:40:34.947616,6.423184
channel-750,679951,30162168,30162185,17,2025-02-23 00:40:32.593097,2025-02-23 00:40:53.168131,20.575034
channel-750,679952,30162171,30162185,14,2025-02-23 00:40:37.216424,2025-02-23 00:40:53.168131,15.951707
channel-750,679953,30162172,30162186,14,2025-02-23 00:40:38.235257,2025-02-23 00:40:55.256665,17.021408
channel-750,679954,30162173,30162186,13,2025-02-23 00:40:39.270789,2025-02-23 00:40:55.256665,15.985876
channel-750,679955,30162181,30162185,4,2025-02-23 00:40:48.746830,2025-02-23 00:40:53.168131,4.421301
channel-750,679956,30162193,30162204,11,2025-02-23 00:41:03.608752,2025-02-23 00:41:16.609726,13.000974
channel-750,679957,30162196,30162209,13,2025-02-23 00:41:06.893866,2025-02-23 00:41:28.057046,21.16318
channel-750,679958,30162199,30162209,10,2025-02-23 00:41:10.930718,2025-02-23 00:41:28.057046,17.126328
channel-750,679959,30162202,30162212,10,2025-02-23 00:41:14.258236,2025-02-23 00:41:31.242982,16.984746
channel-750,679960,30162210,30162224,14,2025-02-23 00:41:29.151939,2025-02-23 00:41:45.451048,16.299109
channel-750,679961,30162224,30162234,10,2025-02-23 00:41:45.451048,2025-02-23 00:42:02.888911,17.437863
channel-750,679962,30162239,30162248,9,2025-02-23 00:42:08.463206,2025-02-23 00:42:19.852545,11.389339
channel-750,679963,30162256,30162261,5,2025-02-23 00:42:29.840266,2025-02-23 00:42:35.700575,5.860309
channel-750,679964,30162261,30162274,13,2025-02-23 00:42:35.700575,2025-02-23 00:42:51.133410,15.432835
channel-750,679965,30162286,30162295,9,2025-02-23 00:43:04.940057,2025-02-23 00:43:19.270805,14.330748
channel-750,679966,30162305,30162317,12,2025-02-23 00:43:31.391669,2025-02-23 00:43:48.203122,16.811453
channel-750,679967,30162329,30162341,12,2025-02-23 00:44:02.895896,2025-02-23 00:44:19.123684,16.227788
channel-750,679968,30162337,30162341,4,2025-02-23 00:44:13.128767,2025-02-23 00:44:19.123684,5.994917
channel-750,679969,30162413,30162427,14,2025-02-23 00:45:50.271930,2025-02-23 00:46:06.255753,15.983823
channel-750,679970,30162440,30162454,14,2025-02-23 00:46:22.897181,2025-02-23 00:46:41.696609,18.799428
channel-750,679971,30162441,30162447,6,2025-02-23 00:46:24.038751,2025-02-23 00:46:30.882743,6.843992
channel-750,679972,30162464,30162468,4,2025-02-23 00:46:57.421836,2025-02-23 00:47:02.862629,5.440793
channel-750,679973,30162575,30162590,15,2025-02-23 00:49:22.654944,2025-02-23 00:49:39.924436,17.269492
channel-750,679974,30162578,30162591,13,2025-02-23 00:49:26.139012,2025-02-23 00:49:41.016995,14.877983
channel-750,679975,30162580,30162593,13,2025-02-23 00:49:28.518967,2025-02-23 00:49:43.288256,14.769289
channel-750,679976,30162582,30162596,14,2025-02-23 00:49:30.831083,2025-02-23 00:49:47.845371,17.014288
channel-750,679977,30162584,30162590,6,2025-02-23 00:49:33.179633,2025-02-23 00:49:39.924436,6.744803
channel-750,679978,30162645,30162658,13,2025-02-23 00:50:48.578580,2025-02-23 00:51:05.297956,16.719376
channel-750,679979,30162658,30162662,4,2025-02-23 00:51:05.297956,2025-02-23 00:51:12.009414,6.711458
channel-750,679980,30162707,30162712,5,2025-02-23 00:52:11.988879,2025-02-23 00:52:17.815667,5.826788
channel-750,679981,30162806,30162814,8,2025-02-23 00:54:19.712050,2025-02-23 00:54:32.239131,12.527081
channel-750,679982,30162838,30162852,14,2025-02-23 00:55:01.004182,2025-02-23 00:55:17.883298,16.879116
channel-750,679983,30162839,30162860,21,2025-02-23 00:55:02.176824,2025-02-23 00:55:30.451322,28.274498
channel-750,679984,30162954,30162967,13,2025-02-23 00:57:32.679755,2025-02-23 00:57:47.529949,14.850194
channel-750,679985,30162964,30162978,14,2025-02-23 00:57:44.267777,2025-02-23 00:58:01.493446,17.225669
channel-750,679986,30162964,30162978,14,2025-02-23 00:57:44.267777,2025-02-23 00:58:01.493446,17.225669
channel-750,679987,30162986,30162999,13,2025-02-23 00:58:11.814521,2025-02-23 00:58:31.436379,19.621858
channel-750,679988,30162986,30162999,13,2025-02-23 00:58:11.814521,2025-02-23 00:58:31.436379,19.621858
channel-750,679989,30162987,30162999,12,2025-02-23 00:58:14.628492,2025-02-23 00:58:31.436379,16.807887
channel-750,679990,30162991,30163006,15,2025-02-23 00:58:20.135492,2025-02-23 00:58:39.542856,19.407364
channel-750,679991,30163113,30163118,5,2025-02-23 01:01:00.780199,2025-02-23 01:01:06.743664,5.963465
channel-750,679992,30163143,30163154,11,2025-02-23 01:01:38.058590,2025-02-23 01:01:52.814868,14.756278
channel-750,679993,30163198,30163207,9,2025-02-23 01:02:47.254750,2025-02-23 01:03:01.114915,13.860165
channel-750,679994,30163208,30163221,13,2025-02-23 01:03:02.231457,2025-02-23 01:03:18.060090,15.828633
channel-750,679995,30163213,30163225,12,2025-02-23 01:03:08.676888,2025-02-23 01:03:25.245663,16.568775
channel-750,679996,30163231,30163242,11,2025-02-23 01:03:32.216656,2025-02-23 01:03:44.787778,12.571122
channel-750,679997,30163231,30163243,12,2025-02-23 01:03:32.216656,2025-02-23 01:03:45.944766,13.72811
channel-750,679998,30163248,30163261,13,2025-02-23 01:03:53.815465,2025-02-23 01:04:10.677750,16.862285
channel-750,679999,30163252,30163257,5,2025-02-23 01:03:59.375552,2025-02-23 01:04:06.008494,6.632942
channel-750,680000,30163274,30163284,10,2025-02-23 01:04:26.795937,2025-02-23 01:04:41.800528,15.004591
channel-750,680001,30163328,30163342,14,2025-02-23 01:05:37.500660,2025-02-23 01:05:55.839318,18.338658
channel-750,680002,30163334,30163339,5,2025-02-23 01:05:44.920633,2025-02-23 01:05:52.442622,7.521989
channel-750,680003,30163373,30163378,5,2025-02-23 01:06:35.554613,2025-02-23 01:06:42.183825,6.629212
channel-750,680004,30163410,30163422,12,2025-02-23 01:07:21.049751,2025-02-23 01:07:38.493334,17.443583
channel-750,680005,30163582,30163595,13,2025-02-23 01:11:09.832951,2025-02-23 01:11:26.177179,16.344228
channel-750,680006,30163664,30163668,4,2025-02-23 01:12:52.374531,2025-02-23 01:12:56.905113,4.530582
channel-750,680007,30163701,30163715,14,2025-02-23 01:13:43.374914,2025-02-23 01:14:00.754468,17.379554
channel-750,680008,30163706,30163719,13,2025-02-23 01:13:50.255317,2025-02-23 01:14:05.728653,15.473336
channel-750,680009,30163741,30163746,5,2025-02-23 01:14:34.502928,2025-02-23 01:14:41.088715,6.585787
channel-750,680010,30163856,30163860,4,2025-02-23 01:16:57.905269,2025-02-23 01:17:05.180577,7.275308
channel-750,680011,30163890,30163894,4,2025-02-23 01:17:42.845515,2025-02-23 01:17:47.543956,4.698441
channel-750,680012,30163910,30163915,5,2025-02-23 01:18:11.217508,2025-02-23 01:18:17.012617,5.795109
channel-750,680013,30164084,30164096,12,2025-02-23 01:21:50.948180,2025-02-23 01:22:06.395183,15.447003
channel-750,680014,30164247,30164252,5,2025-02-23 01:25:22.463164,2025-02-23 01:25:28.194987,5.731823
channel-750,680015,30164679,30164688,9,2025-02-23 01:34:38.121746,2025-02-23 01:34:49.910785,11.789039
channel-750,680016,30164940,30164944,4,2025-02-23 01:40:17.519835,2025-02-23 01:40:22.127756,4.607921
channel-750,680017,30164999,30165008,9,2025-02-23 01:41:34.165581,2025-02-23 01:41:46.191250,12.025669
channel-750,680018,30165140,30165153,13,2025-02-23 01:44:32.616116,2025-02-23 01:44:49.466310,16.850194
channel-750,680019,30165162,30165176,14,2025-02-23 01:45:04.737792,2025-02-23 01:45:22.040494,17.302702
channel-750,680020,30165198,30165213,15,2025-02-23 01:45:48.392612,2025-02-23 01:46:07.136416,18.743804
channel-750,680021,30165228,30165240,12,2025-02-23 01:46:25.853718,2025-02-23 01:46:43.414591,17.560873
channel-750,680022,30165262,30165275,13,2025-02-23 01:47:10.806885,2025-02-23 01:47:27.771732,16.964847
channel-750,680023,30165326,30165341,15,2025-02-23 01:48:33.111390,2025-02-23 01:48:50.996487,17.885097
channel-750,680024,30165333,30165345,12,2025-02-23 01:48:41.406137,2025-02-23 01:48:57.907946,16.501809
channel-750,680025,30165346,30165360,14,2025-02-23 01:49:00.098029,2025-02-23 01:49:19.428193,19.330164
channel-750,680026,30165403,30165407,4,2025-02-23 01:50:12.334394,2025-02-23 01:50:18.695471,6.361077
channel-750,680027,30165408,30165413,5,2025-02-23 01:50:20.916685,2025-02-23 01:50:26.861180,5.944495
channel-750,680028,30165494,30165510,16,2025-02-23 01:52:11.349391,2025-02-23 01:52:32.878608,21.529217
channel-750,680029,30165650,30165666,16,2025-02-23 01:55:31.320499,2025-02-23 01:55:50.672760,19.352261
channel-750,680030,30165787,30165802,15,2025-02-23 01:58:31.517781,2025-02-23 01:58:49.644026,18.126245
channel-750,680031,30165873,30165877,4,2025-02-23 02:00:17.889419,2025-02-23 02:00:22.788198,4.898779
channel-750,680032,30165907,30165927,20,2025-02-23 02:01:01.656449,2025-02-23 02:01:27.237629,25.58118
channel-750,680033,30165929,30165931,2,2025-02-23 02:01:29.749980,2025-02-23 02:01:32.025712,2.275732
channel-750,680034,30165933,30165940,7,2025-02-23 02:01:38.389327,2025-02-23 02:01:47.694959,9.305632
channel-750,680035,30165961,30165966,5,2025-02-23 02:02:13.444480,2025-02-23 02:02:19.137779,5.693299
channel-750,680036,30165986,30165992,6,2025-02-23 02:02:44.320448,2025-02-23 02:02:54.582999,10.262551
channel-750,680037,30166058,30166069,11,2025-02-23 02:04:21.146502,2025-02-23 02:04:35.365499,14.218997
channel-750,680038,30166083,30166088,5,2025-02-23 02:04:51.689278,2025-02-23 02:04:57.742831,6.053553
channel-750,680039,30166340,30166351,11,2025-02-23 02:10:22.703276,2025-02-23 02:10:36.867912,14.164636
channel-750,680040,30166364,30166379,15,2025-02-23 02:10:54.167509,2025-02-23 02:11:12.853301,18.685792
channel-750,680041,30166480,30166491,11,2025-02-23 02:13:23.730964,2025-02-23 02:13:39.476395,15.745431
channel-750,680042,30166481,30166492,11,2025-02-23 02:13:24.883408,2025-02-23 02:13:40.711405,15.827997
channel-750,680043,30166488,30166501,13,2025-02-23 02:13:35.072667,2025-02-23 02:13:53.304879,18.232212
channel-750,680044,30166497,30166508,11,2025-02-23 02:13:47.218925,2025-02-23 02:14:01.203114,13.984189
channel-750,680045,30166553,30166561,8,2025-02-23 02:15:01.105196,2025-02-23 02:15:11.504269,10.399073
channel-750,680046,30166614,30166619,5,2025-02-23 02:16:17.538348,2025-02-23 02:16:23.306517,5.768169
channel-750,680047,30166630,30166643,13,2025-02-23 02:16:38.547901,2025-02-23 02:16:55.998217,17.450316
channel-750,680048,30166753,30166760,7,2025-02-23 02:19:15.319648,2025-02-23 02:19:24.169720,8.850072
channel-750,680049,30166822,30166828,6,2025-02-23 02:20:44.572551,2025-02-23 02:20:51.722613,7.150062
channel-750,680050,30166870,30166874,4,2025-02-23 02:21:44.343227,2025-02-23 02:21:49.763590,5.420363
channel-750,680051,30167151,30167156,5,2025-02-23 02:27:49.923240,2025-02-23 02:27:55.894440,5.9712
channel-750,680052,30167255,30167265,10,2025-02-23 02:30:05.179756,2025-02-23 02:30:17.786721,12.606965
channel-750,680053,30167314,30167322,8,2025-02-23 02:31:20.169537,2025-02-23 02:31:32.343349,12.173812
channel-750,680054,30167416,30167421,5,2025-02-23 02:33:31.225699,2025-02-23 02:33:37.373304,6.147605
channel-750,680055,30167485,30167490,5,2025-02-23 02:35:02.938515,2025-02-23 02:35:08.789576,5.851061
channel-750,680056,30167710,30167722,12,2025-02-23 02:39:57.498164,2025-02-23 02:40:11.802341,14.304177
channel-750,680057,30167802,30167812,10,2025-02-23 02:41:52.641389,2025-02-23 02:42:07.174813,14.533424
channel-750,680058,30167971,30167985,14,2025-02-23 02:45:32.425359,2025-02-23 02:45:49.972791,17.547432
channel-750,680059,30167974,30167989,15,2025-02-23 02:45:35.831528,2025-02-23 02:45:55.062286,19.230758
channel-750,680060,30168048,30168057,9,2025-02-23 02:47:11.454424,2025-02-23 02:47:25.309902,13.855478
channel-750,680061,30168240,30168256,16,2025-02-23 02:51:18.403594,2025-02-23 02:51:38.303091,19.899497
channel-750,680062,30168467,30168483,16,2025-02-23 02:56:16.987494,2025-02-23 02:56:37.683274,20.69578
channel-750,680063,30168493,30168497,4,2025-02-23 02:56:49.640288,2025-02-23 02:56:55.406294,5.766006
channel-750,680064,30168527,30168539,12,2025-02-23 02:57:33.721888,2025-02-23 02:57:48.228567,14.506679
channel-750,680065,30168529,30168540,11,2025-02-23 02:57:36.766970,2025-02-23 02:57:49.427560,12.66059
channel-750,680066,30168533,30168537,4,2025-02-23 02:57:41.246180,2025-02-23 02:57:46.037618,4.791438
channel-750,680067,30168550,30168561,11,2025-02-23 02:58:01.381615,2025-02-23 02:58:16.369097,14.987482
channel-750,680068,30168713,30168720,7,2025-02-23 03:01:38.243148,2025-02-23 03:01:46.251946,8.008798
channel-750,680069,30168887,30168901,14,2025-02-23 03:05:21.374840,2025-02-23 03:05:38.289309,16.914469
channel-750,680070,30168926,30168936,10,2025-02-23 03:06:10.600297,2025-02-23 03:06:23.510437,12.91014
channel-750,680071,30168984,30168989,5,2025-02-23 03:07:25.895986,2025-02-23 03:07:31.768730,5.872744
channel-750,680072,30169092,30169102,10,2025-02-23 03:09:46.395517,2025-02-23 03:09:59.332075,12.936558
channel-750,680073,30169160,30169164,4,2025-02-23 03:11:17.202070,2025-02-23 03:11:22.870846,5.668776
channel-750,680074,30169364,30169369,5,2025-02-23 03:15:39.519551,2025-02-23 03:15:46.161407,6.641856
channel-750,680075,30169647,30169660,13,2025-02-23 03:21:47.953849,2025-02-23 03:22:09.698089,21.74424
channel-750,680076,30169677,30169681,4,2025-02-23 03:22:29.941800,2025-02-23 03:22:35.724240,5.78244
channel-750,680077,30169863,30169869,6,2025-02-23 03:26:30.286248,2025-02-23 03:26:38.313613,8.027365
channel-750,680078,30169895,30169911,16,2025-02-23 03:27:11.514578,2025-02-23 03:27:31.271640,19.757062
channel-750,680079,30169942,30169947,5,2025-02-23 03:28:15.357823,2025-02-23 03:28:21.565462,6.207639
channel-750,680080,30169976,30169981,5,2025-02-23 03:28:58.896459,2025-02-23 03:29:04.609244,5.712785
channel-750,680081,30170041,30170046,5,2025-02-23 03:30:24.752686,2025-02-23 03:30:30.958267,6.205581
channel-750,680082,30170065,30170077,12,2025-02-23 03:30:55.652760,2025-02-23 03:31:11.461580,15.80882
channel-750,680083,30170090,30170103,13,2025-02-23 03:31:28.689200,2025-02-23 03:31:43.511989,14.822789
channel-750,680084,30170189,30170198,9,2025-02-23 03:33:36.103263,2025-02-23 03:33:47.977072,11.873809
channel-750,680085,30170231,30170236,5,2025-02-23 03:34:28.975704,2025-02-23 03:34:34.389664,5.41396
channel-750,680086,30170306,30170320,14,2025-02-23 03:36:07.683815,2025-02-23 03:36:25.228359,17.544544
channel-750,680087,30170351,30170356,5,2025-02-23 03:37:06.616561,2025-02-23 03:37:12.389620,5.773059
channel-750,680088,30170381,30170390,9,2025-02-23 03:37:45.394991,2025-02-23 03:37:56.441464,11.046473
channel-750,680089,30170455,30170468,13,2025-02-23 03:39:20.111201,2025-02-23 03:39:35.224932,15.113731
channel-750,680090,30170486,30170494,8,2025-02-23 03:39:57.744522,2025-02-23 03:40:09.119546,11.375024
channel-750,680091,30170512,30170521,9,2025-02-23 03:40:30.778024,2025-02-23 03:40:46.332532,15.554508
channel-750,680092,30170547,30170557,10,2025-02-23 03:41:20.063748,2025-02-23 03:41:34.464492,14.400744
channel-750,680093,30170698,30170712,14,2025-02-23 03:44:34.446271,2025-02-23 03:44:51.349431,16.90316
channel-750,680094,30170707,30170718,11,2025-02-23 03:44:45.673678,2025-02-23 03:44:59.916338,14.24266
channel-750,680095,30170789,30170801,12,2025-02-23 03:46:30.970301,2025-02-23 03:46:47.092588,16.122287
channel-750,680096,30171483,30171489,6,2025-02-23 04:01:25.213391,2025-02-23 04:01:33.183075,7.969684
channel-750,680097,30171534,30171539,5,2025-02-23 04:02:28.411975,2025-02-23 04:02:34.164708,5.752733
channel-750,680098,30171855,30171864,9,2025-02-23 04:09:20.591481,2025-02-23 04:09:33.376364,12.784883
channel-750,680099,30171917,30171921,4,2025-02-23 04:10:44.064962,2025-02-23 04:10:49.849337,5.784375
channel-750,680100,30171918,30171928,10,2025-02-23 04:10:45.129449,2025-02-23 04:10:58.775281,13.645832
channel-750,680101,30171923,30171927,4,2025-02-23 04:10:52.187736,2025-02-23 04:10:56.579803,4.392067
channel-750,680102,30172306,30172320,14,2025-02-23 04:19:10.872558,2025-02-23 04:19:27.899615,17.027057
channel-750,680103,30172318,30172338,20,2025-02-23 04:19:25.634359,2025-02-23 04:19:54.571242,28.936883
channel-750,680104,30172354,30172369,15,2025-02-23 04:20:14.114409,2025-02-23 04:20:33.348014,19.233605
channel-750,680105,30172524,30172529,5,2025-02-23 04:23:51.101723,2025-02-23 04:23:58.200407,7.098684
channel-750,680106,30172581,30172599,18,2025-02-23 04:25:04.675002,2025-02-23 04:25:30.523175,25.848173
channel-750,680107,30172639,30172644,5,2025-02-23 04:26:24.361910,2025-02-23 04:26:29.848586,5.486676
channel-750,680108,30172755,30172762,7,2025-02-23 04:28:49.655182,2025-02-23 04:28:59.510034,9.854852
channel-750,680109,30172763,30172772,9,2025-02-23 04:29:02.176539,2025-02-23 04:29:13.779915,11.603376
channel-750,680110,30172816,30172829,13,2025-02-23 04:30:08.622625,2025-02-23 04:30:27.924564,19.301939
channel-750,680111,30172823,30172828,5,2025-02-23 04:30:17.564707,2025-02-23 04:30:26.824239,9.259532
channel-750,680112,30172824,30172838,14,2025-02-23 04:30:18.767623,2025-02-23 04:30:39.214214,20.446591
channel-750,680113,30172841,30172850,9,2025-02-23 04:30:43.147412,2025-02-23 04:30:53.486538,10.339126
channel-750,680114,30172914,30172926,12,2025-02-23 04:32:20.922837,2025-02-23 04:32:35.549638,14.626801
channel-750,680115,30172996,30173011,15,2025-02-23 04:34:06.618786,2025-02-23 04:34:24.303248,17.684462
channel-750,680116,30173010,30173026,16,2025-02-23 04:34:23.112462,2025-02-23 04:34:44.116095,21.003633
channel-750,680117,30173071,30173092,21,2025-02-23 04:35:45.035943,2025-02-23 04:36:10.051711,25.015768
channel-750,680118,30173072,30173092,20,2025-02-23 04:35:46.105467,2025-02-23 04:36:10.051711,23.946244
channel-750,680119,30173220,30173225,5,2025-02-23 04:38:53.467611,2025-02-23 04:39:00.225384,6.757773
channel-750,680120,30173270,30173292,22,2025-02-23 04:39:58.279944,2025-02-23 04:40:27.218841,28.938897
channel-750,680121,30173593,30173603,10,2025-02-23 04:46:54.087235,2025-02-23 04:47:08.040361,13.953126
channel-750,680122,30173605,30173616,11,2025-02-23 04:47:10.303779,2025-02-23 04:47:24.212899,13.90912
channel-750,680123,30173843,30173851,8,2025-02-23 04:52:14.876571,2025-02-23 04:52:24.760174,9.883603
channel-750,680124,30173888,30173892,4,2025-02-23 04:53:15.694998,2025-02-23 04:53:21.784546,6.089548
channel-750,680125,30173957,30173962,5,2025-02-23 04:54:44.177533,2025-02-23 04:54:49.840422,5.662889
channel-750,680126,30173973,30173980,7,2025-02-23 04:55:02.377055,2025-02-23 04:55:13.089971,10.712916
channel-750,680127,30174140,30174161,21,2025-02-23 04:58:39.687285,2025-02-23 04:59:06.311495,26.62421
channel-750,680128,30174216,30174221,5,2025-02-23 05:00:14.638804,2025-02-23 05:00:20.770598,6.131794
channel-750,680129,30174220,30174225,5,2025-02-23 05:00:19.550346,2025-02-23 05:00:25.460689,5.910343
channel-750,680130,30174263,30174273,10,2025-02-23 05:01:13.803365,2025-02-23 05:01:26.388917,12.585552
channel-750,680131,30174422,30174427,5,2025-02-23 05:04:45.158128,2025-02-23 05:04:51.948301,6.790173
channel-750,680132,30174507,30174512,5,2025-02-23 05:06:36.164629,2025-02-23 05:06:43.163297,6.998668
channel-750,680133,30174625,30174631,6,2025-02-23 05:09:06.722832,2025-02-23 05:09:13.474096,6.751264
channel-750,680134,30174708,30174720,12,2025-02-23 05:10:55.133404,2025-02-23 05:11:09.590364,14.45696
channel-750,680135,30174729,30174744,15,2025-02-23 05:11:20.547905,2025-02-23 05:11:38.915662,18.367757
channel-750,680136,30174738,30174748,10,2025-02-23 05:11:31.094881,2025-02-23 05:11:43.636928,12.542047
channel-750,680137,30174758,30174771,13,2025-02-23 05:11:57.061806,2025-02-23 05:12:13.489099,16.427293
channel-750,680138,30174837,30174854,17,2025-02-23 05:13:38.238317,2025-02-23 05:14:01.918665,23.680348
channel-750,680139,30174850,30174872,22,2025-02-23 05:13:56.125689,2025-02-23 05:14:24.221489,28.0958
channel-750,680140,30174887,30174921,34,2025-02-23 05:14:43.824251,2025-02-23 05:15:27.315409,43.491158
channel-750,680141,30174904,30174918,14,2025-02-23 05:15:05.015609,2025-02-23 05:15:23.704433,18.688824
channel-750,680142,30175194,30175199,5,2025-02-23 05:21:21.038253,2025-02-23 05:21:27.366161,6.327908
channel-750,680143,30175209,30175229,20,2025-02-23 05:21:39.937751,2025-02-23 05:22:06.114409,26.176658
channel-750,680144,30175325,30175339,14,2025-02-23 05:24:10.507916,2025-02-23 05:24:28.342527,17.834611
channel-750,680145,30175331,30175337,6,2025-02-23 05:24:19.036822,2025-02-23 05:24:25.777362,6.74054
channel-750,680146,30175347,30175353,6,2025-02-23 05:24:37.449598,2025-02-23 05:24:44.257329,6.807731
channel-750,680147,30175348,30175363,15,2025-02-23 05:24:38.674279,2025-02-23 05:24:58.534527,19.860248
channel-750,680148,30175362,30175377,15,2025-02-23 05:24:55.746698,2025-02-23 05:25:17.896417,22.149719
channel-750,680149,30175368,30175382,14,2025-02-23 05:25:05.857982,2025-02-23 05:25:23.920391,18.062409
channel-750,680150,30175416,30175429,13,2025-02-23 05:26:06.426993,2025-02-23 05:26:25.970909,19.543916
channel-750,680151,30175470,30175475,5,2025-02-23 05:27:18.040081,2025-02-23 05:27:25.111189,7.071108
channel-750,680152,30175665,30175679,14,2025-02-23 05:31:31.643084,2025-02-23 05:31:49.118130,17.475046
channel-750,680153,30175726,30175738,12,2025-02-23 05:32:54.280744,2025-02-23 05:33:09.594992,15.314248
channel-750,680154,30175738,30175743,5,2025-02-23 05:33:09.594992,2025-02-23 05:33:16.057717,6.462725
channel-750,680155,30175761,30175773,12,2025-02-23 05:33:38.566744,2025-02-23 05:33:54.622686,16.055942
channel-750,680156,30175853,30175870,17,2025-02-23 05:35:35.398514,2025-02-23 05:35:57.424270,22.025756
channel-750,680157,30175955,30175960,5,2025-02-23 05:37:47.706155,2025-02-23 05:37:54.697148,6.990993
channel-750,680158,30176003,30176017,14,2025-02-23 05:38:52.634000,2025-02-23 05:39:10.690900,18.0569
channel-750,680159,30176009,30176019,10,2025-02-23 05:39:00.205488,2025-02-23 05:39:12.861660,12.656172
channel-750,680160,30176106,30176118,12,2025-02-23 05:41:00.619098,2025-02-23 05:41:17.399908,16.78081
channel-750,680161,30176111,30176125,14,2025-02-23 05:41:07.219291,2025-02-23 05:41:25.205908,17.986617
channel-750,680162,30176128,30176140,12,2025-02-23 05:41:28.565959,2025-02-23 05:41:46.406242,17.840283
channel-750,680163,30176144,30176149,5,2025-02-23 05:41:52.563135,2025-02-23 05:41:59.584272,7.021137
channel-750,680164,30176155,30176160,5,2025-02-23 05:42:06.385920,2025-02-23 05:42:12.160874,5.774954
channel-750,680165,30176238,30176248,10,2025-02-23 05:43:53.262325,2025-02-23 05:44:06.501733,13.239408
channel-750,680166,30176335,30176339,4,2025-02-23 05:45:54.358612,2025-02-23 05:46:00.500792,6.14218
channel-750,680167,30176439,30176456,17,2025-02-23 05:48:12.302252,2025-02-23 05:48:32.759497,20.457245
channel-750,680168,30176444,30176459,15,2025-02-23 05:48:18.065742,2025-02-23 05:48:36.303705,18.237963
channel-750,680169,30176451,30176463,12,2025-02-23 05:48:27.084063,2025-02-23 05:48:42.094377,15.010314
channel-750,680170,30176478,30176489,11,2025-02-23 05:48:59.475504,2025-02-23 05:49:15.375079,15.899575
channel-750,680171,30176489,30176494,5,2025-02-23 05:49:15.375079,2025-02-23 05:49:25.352729,9.97765
channel-750,680172,30176504,30176520,16,2025-02-23 05:49:37.887077,2025-02-23 05:49:56.918456,19.031379
channel-750,680173,30176504,30176520,16,2025-02-23 05:49:37.887077,2025-02-23 05:49:56.918456,19.031379
channel-750,680174,30176688,30176701,13,2025-02-23 05:53:34.239968,2025-02-23 05:53:52.418339,18.178371
channel-750,680175,30176691,30176700,9,2025-02-23 05:53:38.749099,2025-02-23 05:53:51.248788,12.499689
channel-750,680176,30176703,30176708,5,2025-02-23 05:53:54.825379,2025-02-23 05:54:02.156426,7.331047
channel-750,680177,30176714,30176727,13,2025-02-23 05:54:09.396698,2025-02-23 05:54:25.363139,15.966441
channel-750,680178,30176730,30176747,17,2025-02-23 05:54:28.911713,2025-02-23 05:54:49.761769,20.850056
channel-750,680179,30176732,30176743,11,2025-02-23 05:54:31.126801,2025-02-23 05:54:45.106426,13.979625
channel-750,680180,30176732,30176736,4,2025-02-23 05:54:31.126801,2025-02-23 05:54:36.545701,5.4189
channel-750,680181,30176739,30176751,12,2025-02-23 05:54:40.124009,2025-02-23 05:54:56.011950,15.887941
channel-750,680182,30176752,30176756,4,2025-02-23 05:54:57.112875,2025-02-23 05:55:02.992775,5.8799
channel-750,680183,30176765,30176776,11,2025-02-23 05:55:14.488435,2025-02-23 05:55:33.266407,18.777972
channel-750,680184,30176773,30176790,17,2025-02-23 05:55:27.815177,2025-02-23 05:55:49.724466,21.909289
channel-750,680185,30176792,30176807,15,2025-02-23 05:55:51.948676,2025-02-23 05:56:10.137531,18.188855
channel-750,680186,30176799,30176804,5,2025-02-23 05:56:01.114974,2025-02-23 05:56:06.862168,5.747194
channel-750,680187,30176831,30176843,12,2025-02-23 05:56:42.019995,2025-02-23 05:57:00.754650,18.734655
channel-750,680188,30176875,30176889,14,2025-02-23 05:57:40.424190,2025-02-23 05:57:58.925412,18.501222
channel-750,680189,30176887,30176893,6,2025-02-23 05:57:56.472471,2025-02-23 05:58:03.609896,7.137425
channel-750,680190,30176910,30176929,19,2025-02-23 05:58:23.142070,2025-02-23 05:58:50.568283,27.426213
channel-750,680191,30176945,30176955,10,2025-02-23 05:59:10.261323,2025-02-23 05:59:22.733813,12.47249
channel-750,680192,30177115,30177119,4,2025-02-23 06:02:51.616067,2025-02-23 06:02:56.612647,4.99658
channel-750,680193,30177123,30177128,5,2025-02-23 06:03:01.204755,2025-02-23 06:03:07.166977,5.962222
channel-750,680194,30177288,30177300,12,2025-02-23 06:06:36.661283,2025-02-23 06:06:53.117503,16.45622
channel-750,680195,30177294,30177298,4,2025-02-23 06:06:43.395862,2025-02-23 06:06:49.873517,6.477655
channel-750,680196,30177380,30177386,6,2025-02-23 06:08:34.500236,2025-02-23 06:08:45.600952,11.100716
channel-750,680197,30177640,30177646,6,2025-02-23 06:14:12.864059,2025-02-23 06:14:20.999201,8.135142
channel-750,680198,30177936,30177946,10,2025-02-23 06:20:34.482867,2025-02-23 06:20:47.063152,12.580285
channel-750,680199,30178013,30178025,12,2025-02-23 06:22:11.935613,2025-02-23 06:22:30.572734,18.637121
channel-750,680200,30178049,30178061,12,2025-02-23 06:23:02.614580,2025-02-23 06:23:17.817960,15.20338
channel-750,680201,30178088,30178099,11,2025-02-23 06:23:51.253335,2025-02-23 06:24:06.558736,15.305401
channel-750,680202,30178094,30178105,11,2025-02-23 06:23:58.703594,2025-02-23 06:24:13.390059,14.686465
channel-750,680203,30178100,30178113,13,2025-02-23 06:24:07.695979,2025-02-23 06:24:23.246714,15.550735
channel-750,680204,30178194,30178205,11,2025-02-23 06:26:07.078667,2025-02-23 06:26:21.450020,14.371353
channel-750,680205,30178201,30178210,9,2025-02-23 06:26:15.855319,2025-02-23 06:26:31.458969,15.60365
channel-750,680206,30178290,30178294,4,2025-02-23 06:28:12.522555,2025-02-23 06:28:17.742827,5.220272
channel-750,680207,30178469,30178481,12,2025-02-23 06:32:02.858384,2025-02-23 06:32:18.589796,15.731412
channel-750,680208,30178489,30178494,5,2025-02-23 06:32:30.132547,2025-02-23 06:32:36.285185,6.152638
channel-750,680209,30178586,30178600,14,2025-02-23 06:34:32.251985,2025-02-23 06:34:50.231953,17.979968
channel-750,680210,30178603,30178612,9,2025-02-23 06:34:53.769932,2025-02-23 06:35:06.209398,12.439466
channel-750,680211,30178696,30178700,4,2025-02-23 06:36:55.664918,2025-02-23 06:37:01.182860,5.517942
channel-750,680212,30178700,30178716,16,2025-02-23 06:37:01.182860,2025-02-23 06:37:20.690247,19.507387
channel-750,680213,30178725,30178738,13,2025-02-23 06:37:30.877906,2025-02-23 06:37:46.923637,16.045731
channel-750,680214,30178796,30178803,7,2025-02-23 06:39:00.003998,2025-02-23 06:39:09.279212,9.275214
channel-750,680215,30178886,30178891,5,2025-02-23 06:40:58.783698,2025-02-23 06:41:04.794938,6.01124
channel-750,680216,30178910,30178922,12,2025-02-23 06:41:33.127255,2025-02-23 06:41:48.827945,15.70069
channel-750,680217,30178922,30178934,12,2025-02-23 06:41:48.827945,2025-02-23 06:42:02.943409,14.115464
channel-750,680218,30178951,30178973,22,2025-02-23 06:42:23.665049,2025-02-23 06:42:50.602529,26.93748
channel-750,680219,30178992,30179011,19,2025-02-23 06:43:14.152548,2025-02-23 06:43:39.036078,24.88353
channel-750,680220,30179037,30179040,3,2025-02-23 06:44:11.320312,2025-02-23 06:44:16.299645,4.979333
channel-750,680221,30179164,30179179,15,2025-02-23 06:46:57.528196,2025-02-23 06:47:22.715545,25.187349
channel-750,680222,30179200,30179214,14,2025-02-23 06:47:48.538819,2025-02-23 06:48:05.119862,16.581043
channel-750,680223,30179214,30179230,16,2025-02-23 06:48:05.119862,2025-02-23 06:48:23.114860,17.994998
channel-750,680224,30179223,30179228,5,2025-02-23 06:48:15.334653,2025-02-23 06:48:20.817883,5.48323
channel-750,680225,30179236,30179254,18,2025-02-23 06:48:32.655010,2025-02-23 06:48:57.865909,25.210899
channel-750,680226,30179258,30179272,14,2025-02-23 06:49:02.603248,2025-02-23 06:49:21.103306,18.500058
channel-750,680227,30179373,30179391,18,2025-02-23 06:51:34.829876,2025-02-23 06:51:57.694826,22.86495
channel-750,680228,30179394,30179399,5,2025-02-23 06:52:01.084593,2025-02-23 06:52:07.252199,6.167606
channel-750,680229,30179413,30179426,13,2025-02-23 06:52:24.117013,2025-02-23 06:52:43.925383,19.80837
channel-750,680230,30179424,30179435,11,2025-02-23 06:52:40.582640,2025-02-23 06:52:56.869697,16.287057
channel-750,680231,30179424,30179435,11,2025-02-23 06:52:40.582640,2025-02-23 06:52:56.869697,16.287057
channel-750,680232,30179430,30179444,14,2025-02-23 06:52:50.299339,2025-02-23 06:53:07.488497,17.189158
channel-750,680233,30179452,30179465,13,2025-02-23 06:53:18.550242,2025-02-23 06:53:37.633755,19.083513
channel-750,680234,30179456,30179461,5,2025-02-23 06:53:26.996499,2025-02-23 06:53:32.694073,5.697574
channel-750,680235,30179493,30179506,13,2025-02-23 06:54:14.688896,2025-02-23 06:54:30.308406,15.61951
channel-750,680236,30179536,30179548,12,2025-02-23 06:55:11.012958,2025-02-23 06:55:26.555660,15.542702
channel-750,680237,30179571,30179585,14,2025-02-23 06:55:55.687483,2025-02-23 06:56:13.198093,17.51061
channel-750,680238,30179593,30179604,11,2025-02-23 06:56:22.403033,2025-02-23 06:56:35.888355,13.485322
channel-750,680239,30179635,30179643,8,2025-02-23 06:57:16.406762,2025-02-23 06:57:27.331274,10.924512
channel-750,680240,30179636,30179643,7,2025-02-23 06:57:17.550171,2025-02-23 06:57:27.331274,9.781103
channel-750,680241,30179647,30179657,10,2025-02-23 06:57:32.063214,2025-02-23 06:57:43.800144,11.73693
channel-750,680242,30179647,30179657,10,2025-02-23 06:57:32.063214,2025-02-23 06:57:43.800144,11.73693
channel-750,680243,30179652,30179660,8,2025-02-23 06:57:38.178078,2025-02-23 06:57:51.923292,13.745214
channel-750,680244,30179653,30179657,4,2025-02-23 06:57:39.179656,2025-02-23 06:57:43.800144,4.620488
channel-750,680245,30179672,30179676,4,2025-02-23 06:58:10.838622,2025-02-23 06:58:15.972883,5.134261
channel-750,680246,30179694,30179706,12,2025-02-23 06:58:39.058463,2025-02-23 06:58:54.262598,15.204135
channel-750,680247,30179694,30179706,12,2025-02-23 06:58:39.058463,2025-02-23 06:58:54.262598,15.204135
channel-750,680248,30179715,30179721,6,2025-02-23 06:59:05.878835,2025-02-23 06:59:13.259791,7.380956
channel-750,680249,30179738,30179750,12,2025-02-23 06:59:35.214547,2025-02-23 06:59:49.593286,14.378739
channel-750,680250,30179739,30179755,16,2025-02-23 06:59:36.343453,2025-02-23 06:59:55.385672,19.042219
channel-750,680251,30179753,30179767,14,2025-02-23 06:59:53.109704,2025-02-23 07:00:10.853363,17.743659
channel-750,680252,30179770,30179775,5,2025-02-23 07:00:14.451876,2025-02-23 07:00:22.505758,8.053882
channel-750,680253,30179773,30179778,5,2025-02-23 07:00:18.706777,2025-02-23 07:00:26.934430,8.227653
channel-750,680254,30179773,30179778,5,2025-02-23 07:00:18.706777,2025-02-23 07:00:26.934430,8.227653
channel-750,680255,30179779,30179793,14,2025-02-23 07:00:31.678307,2025-02-23 07:00:49.389907,17.7116
channel-750,680256,30179780,30179793,13,2025-02-23 07:00:33.030749,2025-02-23 07:00:49.389907,16.359158
channel-750,680257,30179791,30179805,14,2025-02-23 07:00:47.108752,2025-02-23 07:01:05.165355,18.056603
channel-750,680258,30179819,30179824,5,2025-02-23 07:01:25.811476,2025-02-23 07:01:32.812723,7.001247
channel-750,680259,30179823,30179837,14,2025-02-23 07:01:30.257938,2025-02-23 07:01:47.755515,17.497577
channel-750,680260,30179856,30179869,13,2025-02-23 07:02:10.200734,2025-02-23 07:02:29.045740,18.845006
channel-750,680261,30179873,30179887,14,2025-02-23 07:02:37.365811,2025-02-23 07:02:54.668145,17.302334
channel-750,680262,30179893,30179904,11,2025-02-23 07:03:01.508324,2025-02-23 07:03:17.164133,15.655809
channel-750,680263,30179899,30179914,15,2025-02-23 07:03:08.441872,2025-02-23 07:03:30.272836,21.830964
channel-750,680264,30179916,30179928,12,2025-02-23 07:03:32.465183,2025-02-23 07:03:48.190263,15.72508
channel-750,680265,30179922,30179943,21,2025-02-23 07:03:40.202942,2025-02-23 07:04:06.736563,26.533621
channel-750,680266,30179945,30179950,5,2025-02-23 07:04:10.620800,2025-02-23 07:04:16.463713,5.842913
channel-750,680267,30179946,30179960,14,2025-02-23 07:04:11.817105,2025-02-23 07:04:28.740164,16.923059
channel-750,680268,30179976,30179990,14,2025-02-23 07:04:48.642218,2025-02-23 07:05:05.450754,16.808536
channel-750,680269,30180007,30180012,5,2025-02-23 07:05:28.449602,2025-02-23 07:05:34.578030,6.128428
channel-750,680270,30180032,30180044,12,2025-02-23 07:06:03.269043,2025-02-23 07:06:20.647305,17.378262
channel-750,680271,30180041,30180052,11,2025-02-23 07:06:15.275655,2025-02-23 07:06:31.373260,16.097605
channel-750,680272,30180084,30180097,13,2025-02-23 07:07:11.754374,2025-02-23 07:07:27.538020,15.783646
channel-750,680273,30180102,30180119,17,2025-02-23 07:07:34.917148,2025-02-23 07:07:56.734110,21.816962
channel-750,680274,30180121,30180125,4,2025-02-23 07:07:59.208735,2025-02-23 07:08:05.224117,6.015382
channel-750,680275,30180125,30180139,14,2025-02-23 07:08:05.224117,2025-02-23 07:08:22.131171,16.907054
channel-750,680276,30180131,30180142,11,2025-02-23 07:08:11.926248,2025-02-23 07:08:25.673170,13.746922
channel-750,680277,30180169,30180184,15,2025-02-23 07:09:04.063951,2025-02-23 07:09:21.855501,17.79155
channel-750,680278,30180247,30180261,14,,2025-02-23 07:10:59.186006,
channel-750,680279,30180253,30180260,7,,2025-02-23 07:10:57.925194,
channel-750,680280,30180256,30180267,11,,2025-02-23 07:11:06.929763,
channel-750,680281,30180274,30180286,12,,2025-02-23 07:11:35.135360,
channel-750,680282,30180292,30180302,10,,2025-02-23 07:12:03.229486,
channel-750,680283,30180336,30180347,11,,2025-02-23 07:12:59.941270,
channel-750,680284,30180371,30180377,6,,2025-02-23 07:13:37.114105,
channel-750,680285,30180381,30180391,10,,2025-02-23 07:14:00.937332,
channel-750,680286,30180400,30180405,5,,2025-02-23 07:14:21.343720,
channel-750,680287,30180425,30180444,19,,2025-02-23 07:15:10.307207,
channel-750,680288,30180433,30180444,11,,2025-02-23 07:15:10.307207,
channel-750,680289,30180463,30180484,21,2025-02-23 07:15:33.899061,2025-02-23 07:16:01.881923,27.982862
channel-750,680290,30180471,30180476,5,2025-02-23 07:15:44.441725,2025-02-23 07:15:51.167348,6.725623
channel-750,680291,30180475,30180487,12,2025-02-23 07:15:49.956588,2025-02-23 07:16:06.720671,16.764083
channel-750,680292,30180476,30180480,4,2025-02-23 07:15:51.167348,2025-02-23 07:15:55.718255,4.550907
channel-750,680293,30180528,30180542,14,2025-02-23 07:17:01.447916,2025-02-23 07:17:20.472603,19.024687
channel-750,680294,30180529,30180542,13,2025-02-23 07:17:02.565167,2025-02-23 07:17:20.472603,17.907436
channel-750,680295,30180555,30180567,12,2025-02-23 07:17:37.028944,2025-02-23 07:17:53.534658,16.505714
channel-750,680296,30180574,30180591,17,2025-02-23 07:18:02.650855,2025-02-23 07:18:23.678808,21.027953
channel-750,680297,30180590,30180604,14,2025-02-23 07:18:22.529416,2025-02-23 07:18:38.784220,16.254804
channel-750,680298,30180640,30180655,15,2025-02-23 07:19:29.233052,2025-02-23 07:19:50.628420,21.395368
channel-750,680299,30180643,30180653,10,2025-02-23 07:19:35.821778,2025-02-23 07:19:48.270742,12.448964
channel-750,680300,30180645,30180649,4,2025-02-23 07:19:38.147069,2025-02-23 07:19:43.195408,5.048339
channel-750,680301,30180649,30180654,5,2025-02-23 07:19:43.195408,2025-02-23 07:19:49.529678,6.33427
channel-750,680302,30180672,30180689,17,2025-02-23 07:20:12.207764,2025-02-23 07:20:34.814042,22.606278
channel-750,680303,30180699,30180711,12,2025-02-23 07:20:46.222224,2025-02-23 07:21:03.164655,16.942431
channel-750,680304,30180759,30180774,15,2025-02-23 07:22:06.211973,2025-02-23 07:22:26.836805,20.624832
channel-750,680305,30180778,30180792,14,2025-02-23 07:22:33.372192,2025-02-23 07:22:50.180750,16.808558
channel-750,680306,30180829,30180834,5,2025-02-23 07:23:42.672919,2025-02-23 07:23:48.886899,6.21398
channel-750,680307,30180865,30180880,15,2025-02-23 07:24:28.591121,2025-02-23 07:24:51.014239,22.423118
channel-750,680308,30180897,30180908,11,2025-02-23 07:25:12.154414,2025-02-23 07:25:26.449225,14.294811
channel-750,680309,30180908,30180913,5,2025-02-23 07:25:26.449225,2025-02-23 07:25:35.622567,9.173342
channel-750,680310,30180911,30180926,15,2025-02-23 07:25:33.234859,2025-02-23 07:25:53.105529,19.87067
channel-750,680311,30180912,30180926,14,2025-02-23 07:25:34.361697,2025-02-23 07:25:53.105529,18.743832
channel-750,680312,30180932,30180939,7,2025-02-23 07:25:59.803137,2025-02-23 07:26:07.777778,7.974641
channel-750,680313,30180956,30180969,13,2025-02-23 07:26:29.098755,2025-02-23 07:26:45.259424,16.160669
channel-750,680314,30180973,30180987,14,2025-02-23 07:26:50.908642,2025-02-23 07:27:08.613622,17.70498
channel-750,680315,30180977,30180981,4,2025-02-23 07:26:55.570963,2025-02-23 07:27:00.105090,4.534127
channel-750,680316,30181040,30181053,13,2025-02-23 07:28:19.606930,2025-02-23 07:28:36.257975,16.651045
channel-750,680317,30181085,30181091,6,2025-02-23 07:29:19.490436,2025-02-23 07:29:27.210760,7.720324
channel-750,680318,30181123,30181138,15,2025-02-23 07:30:15.362674,2025-02-23 07:30:33.028227,17.665553
channel-750,680319,30181176,30181192,16,2025-02-23 07:31:25.519901,2025-02-23 07:31:45.058882,19.538981
channel-750,680320,30181341,30181352,11,2025-02-23 07:34:59.522968,2025-02-23 07:35:11.898707,12.375739
channel-750,680321,30181376,30181388,12,2025-02-23 07:35:49.957538,2025-02-23 07:36:05.011446,15.053908
channel-750,680322,30181393,30181399,6,2025-02-23 07:36:11.219955,2025-02-23 07:36:18.863161,7.643206
channel-750,680323,30181406,30181419,13,2025-02-23 07:36:28.075601,2025-02-23 07:36:43.408607,15.333006
channel-750,680324,30181569,30181580,11,2025-02-23 07:40:06.767040,2025-02-23 07:40:19.105672,12.338632
channel-750,680325,30181599,30181613,14,2025-02-23 07:40:44.033047,2025-02-23 07:41:03.050018,19.016971
channel-750,680326,30181606,30181619,13,2025-02-23 07:40:52.140487,2025-02-23 07:41:10.094840,17.954353
channel-750,680327,30181679,30181683,4,2025-02-23 07:42:30.360844,2025-02-23 07:42:36.249082,5.888238
channel-750,680328,30181729,30181752,23,2025-02-23 07:43:35.054129,2025-02-23 07:44:07.227777,32.173648
channel-750,680329,30181742,30181758,16,2025-02-23 07:43:51.256550,2025-02-23 07:44:14.572235,23.315685
channel-750,680330,30181749,30181764,15,2025-02-23 07:44:03.689219,2025-02-23 07:44:22.172935,18.483716
channel-750,680331,30181751,30181764,13,2025-02-23 07:44:06.089288,2025-02-23 07:44:22.172935,16.083647
channel-750,680332,30181773,30181788,15,2025-02-23 07:44:35.303018,2025-02-23 07:44:53.031492,17.728474
channel-750,680333,30181795,30181808,13,2025-02-23 07:45:03.815614,2025-02-23 07:45:20.012656,16.197042
channel-750,680334,30181917,30181931,14,2025-02-23 07:47:37.143215,2025-02-23 07:47:54.777624,17.634409
channel-750,680335,30181919,30181934,15,2025-02-23 07:47:40.587959,2025-02-23 07:48:00.421126,19.833167
channel-750,680336,30181920,30181925,5,2025-02-23 07:47:41.696567,2025-02-23 07:47:47.302942,5.606375
channel-750,680337,30181978,30181993,15,2025-02-23 07:48:59.780718,2025-02-23 07:49:18.619957,18.839239
channel-750,680338,30181989,30181994,5,2025-02-23 07:49:14.057558,2025-02-23 07:49:19.719956,5.662398
channel-750,680339,30182056,30182069,13,2025-02-23 07:50:39.960891,2025-02-23 07:50:58.101499,18.140608
channel-750,680340,30182184,30182199,15,2025-02-23 07:53:29.837715,2025-02-23 07:53:47.530185,17.69247
channel-750,680341,30182221,30182238,17,2025-02-23 07:54:14.879786,2025-02-23 07:54:37.146416,22.26663
channel-750,680342,30182224,30182228,4,2025-02-23 07:54:18.252666,2025-02-23 07:54:24.377330,6.124664
channel-750,680343,30182344,30182354,10,2025-02-23 07:56:55.131135,2025-02-23 07:57:07.792161,12.661026
channel-750,680344,30182362,30182372,10,2025-02-23 07:57:21.101008,2025-02-23 07:57:35.804159,14.703151
channel-750,680345,30182389,30182412,23,2025-02-23 07:57:56.444373,2025-02-23 07:58:26.270994,29.826621
channel-750,680346,30182437,30182445,8,2025-02-23 07:59:00.823828,2025-02-23 07:59:10.035852,9.212024
channel-750,680347,30182468,30182472,4,2025-02-23 07:59:41.106337,2025-02-23 07:59:46.922832,5.816495
channel-750,680348,30182500,30182505,5,2025-02-23 08:00:20.795887,2025-02-23 08:00:26.989666,6.193779
channel-750,680349,30182505,30182509,4,2025-02-23 08:00:26.989666,2025-02-23 08:00:31.627633,4.637967
channel-750,680350,30182530,30182540,10,2025-02-23 08:00:58.033612,2025-02-23 08:01:10.732620,12.699008
channel-750,680351,30182625,30182635,10,2025-02-23 08:03:03.062664,2025-02-23 08:03:16.524920,13.462256
channel-750,680352,30182744,30182750,6,2025-02-23 08:05:35.233647,2025-02-23 08:05:41.986319,6.752672
channel-750,680353,30182824,30182840,16,2025-02-23 08:07:23.400640,2025-02-23 08:07:43.285538,19.884898
channel-750,680354,30182921,30182935,14,2025-02-23 08:09:26.542400,2025-02-23 08:09:43.990978,17.448578
channel-750,680355,30182951,30182956,5,2025-02-23 08:10:04.973714,2025-02-23 08:10:10.755551,5.781837
channel-750,680356,30183037,30183050,13,2025-02-23 08:11:57.447769,2025-02-23 08:12:15.151788,17.704019
channel-750,680357,30183043,30183048,5,2025-02-23 08:12:05.839552,2025-02-23 08:12:12.939337,7.099785
channel-750,680358,30183098,30183102,4,2025-02-23 08:13:14.808603,2025-02-23 08:13:20.291349,5.482746
channel-750,680359,30183122,30183133,11,2025-02-23 08:13:45.447102,2025-02-23 08:13:59.086109,13.639007
channel-750,680360,30183370,30183375,5,2025-02-23 08:19:12.502652,2025-02-23 08:19:18.280895,5.778243
channel-750,680361,30183378,30183398,20,2025-02-23 08:19:22.209046,2025-02-23 08:19:51.311602,29.102556
channel-750,680362,30183395,30183408,13,2025-02-23 08:19:44.702445,2025-02-23 08:20:03.007473,18.305028
channel-750,680363,30183417,30183423,6,2025-02-23 08:20:16.795890,2025-02-23 08:20:24.090877,7.294987
channel-750,680364,30183420,30183425,5,2025-02-23 08:20:20.529035,2025-02-23 08:20:26.720834,6.191799
channel-750,680365,30183421,30183445,24,2025-02-23 08:20:21.658248,2025-02-23 08:20:53.063437,31.405189
channel-750,680366,30183479,30183492,13,2025-02-23 08:21:37.144931,2025-02-23 08:21:51.857071,14.71214
channel-750,680367,30183479,30183492,13,2025-02-23 08:21:37.144931,2025-02-23 08:21:51.857071,14.71214
channel-750,680368,30183480,30183494,14,2025-02-23 08:21:38.404802,2025-02-23 08:21:55.210572,16.80577
channel-750,680369,30183500,30183512,12,2025-02-23 08:22:03.602766,2025-02-23 08:22:18.344935,14.742169
channel-750,680370,30183518,30183522,4,2025-02-23 08:22:26.271123,2025-02-23 08:22:31.149961,4.878838
channel-750,680371,30183521,30183534,13,2025-02-23 08:22:29.992677,2025-02-23 08:22:46.563013,16.570336
channel-750,680372,30183605,30183610,5,2025-02-23 08:24:15.870906,2025-02-23 08:24:24.715251,8.844345
channel-750,680373,30183606,30183620,14,2025-02-23 08:24:20.221354,2025-02-23 08:24:37.463234,17.24188
channel-750,680374,30183619,30183629,10,2025-02-23 08:24:36.351762,2025-02-23 08:24:48.688613,12.336851
channel-750,680375,30183641,30183652,11,2025-02-23 08:25:02.611248,2025-02-23 08:25:17.099467,14.488219
channel-750,680376,30183648,30183661,13,2025-02-23 08:25:12.517874,2025-02-23 08:25:29.668888,17.151014
channel-750,680377,30183717,30183730,13,2025-02-23 08:26:43.630461,2025-02-23 08:26:59.368486,15.738025
channel-750,680378,30183813,30183825,12,2025-02-23 08:28:46.306331,2025-02-23 08:29:04.962585,18.656254
channel-750,680379,30183837,30183852,15,2025-02-23 08:29:21.336598,2025-02-23 08:29:41.197449,19.860851
channel-750,680380,30183862,30183867,5,2025-02-23 08:29:53.406733,2025-02-23 08:30:00.176378,6.769645
channel-750,680381,30183917,30183926,9,2025-02-23 08:31:02.165495,2025-02-23 08:31:13.555859,11.390364
channel-750,680382,30183950,30183963,13,2025-02-23 08:31:44.587967,2025-02-23 08:32:02.229966,17.641999
channel-750,680383,30183955,30183968,13,2025-02-23 08:31:52.025809,2025-02-23 08:32:07.807885,15.782076
channel-750,680384,30183959,30183973,14,2025-02-23 08:31:57.664757,2025-02-23 08:32:14.622512,16.957755
channel-750,680385,30183960,30183974,14,2025-02-23 08:31:58.738477,2025-02-23 08:32:15.884129,17.145652
channel-750,680386,30184064,30184082,18,2025-02-23 08:34:14.650858,2025-02-23 08:34:36.950659,22.299801
channel-750,680387,30184078,30184082,4,2025-02-23 08:34:31.782406,2025-02-23 08:34:36.950659,5.168253
channel-750,680388,30184091,30184107,16,2025-02-23 08:34:48.185189,2025-02-23 08:35:10.004864,21.819675
channel-750,680389,30184144,30184158,14,2025-02-23 08:35:56.982645,2025-02-23 08:36:14.741595,17.75895
channel-750,680390,30184207,30184220,13,2025-02-23 08:37:17.773693,2025-02-23 08:37:34.936983,17.16329
channel-750,680391,30184215,30184231,16,2025-02-23 08:37:28.471261,2025-02-23 08:37:48.723787,20.252526
channel-750,680392,30184295,30184306,11,2025-02-23 08:39:13.305065,2025-02-23 08:39:28.784030,15.478965
channel-750,680393,30184311,30184320,9,2025-02-23 08:39:35.363107,2025-02-23 08:39:46.354620,10.991513
channel-750,680394,30184347,30184357,10,2025-02-23 08:40:21.527864,2025-02-23 08:40:34.525700,12.997836
channel-750,680395,30184348,30184356,8,2025-02-23 08:40:22.640173,2025-02-23 08:40:33.396724,10.756551
channel-750,680396,30184354,30184360,6,2025-02-23 08:40:31.098619,2025-02-23 08:40:38.052597,6.953978
channel-750,680397,30184387,30184396,9,2025-02-23 08:41:11.028272,2025-02-23 08:41:22.686062,11.65779
channel-750,680398,30184415,30184424,9,2025-02-23 08:41:47.854569,2025-02-23 08:41:59.835369,11.9808
channel-750,680399,30184464,30184475,11,2025-02-23 08:42:56.236683,2025-02-23 08:43:08.787179,12.550496
channel-750,680400,30184466,30184478,12,2025-02-23 08:42:58.389967,2025-02-23 08:43:12.250322,13.860355
channel-750,680401,30184514,30184522,8,2025-02-23 08:43:57.870991,2025-02-23 08:44:08.525123,10.654132
channel-750,680402,30184616,30184621,5,2025-02-23 08:46:07.688198,2025-02-23 08:46:16.510183,8.821985
channel-750,680403,30184653,30184663,10,2025-02-23 08:46:58.963914,2025-02-23 08:47:10.982202,12.018288
channel-750,680404,30184698,30184707,9,2025-02-23 08:47:54.205461,2025-02-23 08:48:06.315245,12.109784
channel-750,680405,30184740,30184755,15,2025-02-23 08:48:51.022225,2025-02-23 08:49:09.419423,18.397198
channel-750,680406,30184750,30184755,5,2025-02-23 08:49:03.679070,2025-02-23 08:49:09.419423,5.740353
channel-750,680407,30184761,30184771,10,2025-02-23 08:49:16.768756,2025-02-23 08:49:28.054977,11.286221
channel-750,680408,30184780,30184794,14,2025-02-23 08:49:39.561382,2025-02-23 08:49:58.866311,19.304929
channel-750,680409,30184796,30184811,15,2025-02-23 08:50:02.750999,2025-02-23 08:50:21.378809,18.62781
channel-750,680410,30184812,30184821,9,2025-02-23 08:50:22.504675,2025-02-23 08:50:33.534306,11.029631
channel-750,680411,30184815,30184828,13,2025-02-23 08:50:26.465522,2025-02-23 08:50:43.246452,16.78093
channel-750,680412,30184838,30184846,8,2025-02-23 08:50:54.871839,2025-02-23 08:51:05.816781,10.944942
channel-750,680413,30184854,30184864,10,2025-02-23 08:51:19.988761,2025-02-23 08:51:32.009187,12.020426
channel-750,680414,30184858,30184871,13,2025-02-23 08:51:25.271602,2025-02-23 08:51:41.122318,15.850716
channel-750,680415,30184870,30184888,18,2025-02-23 08:51:39.952829,2025-02-23 08:52:08.450789,28.49796
channel-750,680416,30184892,30184902,10,2025-02-23 08:52:13.560845,2025-02-23 08:52:25.815793,12.254948
channel-750,680417,30184989,30185001,12,2025-02-23 08:54:16.050535,2025-02-23 08:54:30.397509,14.346974
channel-750,680418,30185058,30185068,10,2025-02-23 08:55:46.497590,2025-02-23 08:55:58.357989,11.860399
channel-750,680419,30185108,30185123,15,2025-02-23 08:56:48.259112,2025-02-23 08:57:07.334708,19.075596
channel-750,680420,30185238,30185243,5,2025-02-23 08:59:33.313909,2025-02-23 08:59:38.912196,5.598287
channel-750,680421,30185266,30185270,4,2025-02-23 09:00:12.964427,2025-02-23 09:00:18.748575,5.784148
channel-750,680422,30185269,30185274,5,2025-02-23 09:00:16.620936,2025-02-23 09:00:23.440948,6.820012
channel-750,680423,30185290,30185311,21,2025-02-23 09:00:44.502904,2025-02-23 09:01:11.307037,26.804133
channel-750,680424,30185348,30185352,4,2025-02-23 09:02:00.717614,2025-02-23 09:02:06.200603,5.482989
channel-750,680425,30185374,30185398,24,2025-02-23 09:02:32.551534,2025-02-23 09:03:04.956805,32.405271
channel-750,680426,30185427,30185437,10,2025-02-23 09:03:41.244518,2025-02-23 09:03:53.361059,12.116541
channel-750,680427,30185451,30185465,14,2025-02-23 09:04:10.109433,2025-02-23 09:04:27.831393,17.72196
channel-750,680428,30185496,30185508,12,2025-02-23 09:05:12.297003,2025-02-23 09:05:29.427195,17.130192
channel-750,680429,30185504,30185525,21,2025-02-23 09:05:24.857342,2025-02-23 09:05:49.223266,24.365924
channel-750,680430,30185831,30185851,20,2025-02-23 09:12:26.153951,2025-02-23 09:12:52.515163,26.361212
channel-750,680431,30185860,30185870,10,2025-02-23 09:13:05.082205,2025-02-23 09:13:16.884595,11.80239
channel-750,680432,30185871,30185890,19,2025-02-23 09:13:18.073796,2025-02-23 09:13:44.989517,26.915721
channel-750,680433,30186085,30186099,14,2025-02-23 09:17:51.690403,2025-02-23 09:18:13.020955,21.330552
channel-750,680434,30186087,30186099,12,2025-02-23 09:17:54.201260,2025-02-23 09:18:13.020955,18.819695
channel-750,680435,30186161,30186166,5,2025-02-23 09:19:31.176173,2025-02-23 09:19:37.951334,6.775161
channel-750,680436,30186222,30186226,4,2025-02-23 09:20:46.662958,2025-02-23 09:20:51.397630,4.734672
channel-750,680437,30186323,30186337,14,2025-02-23 09:23:02.270802,2025-02-23 09:23:18.874876,16.604074
channel-750,680438,30186345,30186356,11,2025-02-23 09:23:29.630283,2025-02-23 09:23:46.126517,16.496234
channel-750,680439,30186464,30186477,13,2025-02-23 09:26:01.995258,2025-02-23 09:26:19.840525,17.845267
channel-750,680440,30186476,30186490,14,2025-02-23 09:26:18.681415,2025-02-23 09:26:34.468183,15.786768
channel-750,680441,30186546,30186559,13,2025-02-23 09:27:50.556761,2025-02-23 09:28:05.043224,14.486463
channel-750,680442,30186690,30186702,12,2025-02-23 09:30:54.402792,2025-02-23 09:31:10.001673,15.598881
channel-750,680443,30186731,30186743,12,2025-02-23 09:31:50.681340,2025-02-23 09:32:06.245159,15.563819
channel-750,680444,30187119,30187125,6,2025-02-23 09:40:19.751615,2025-02-23 09:40:27.173569,7.421954
channel-750,680445,30187246,30187260,14,2025-02-23 09:43:08.395458,2025-02-23 09:43:24.735090,16.339632
channel-750,680446,30187297,30187306,9,2025-02-23 09:44:11.582323,2025-02-23 09:44:23.569211,11.986888
channel-750,680447,30187381,30187385,4,2025-02-23 09:46:02.463899,2025-02-23 09:46:07.734664,5.270765
channel-750,680448,30187507,30187523,16,2025-02-23 09:48:44.423211,2025-02-23 09:49:04.381613,19.958402
channel-750,680449,30187596,30187603,7,2025-02-23 09:50:40.575209,2025-02-23 09:50:49.461892,8.886683
channel-750,680450,30187632,30187639,7,2025-02-23 09:51:25.906107,2025-02-23 09:51:34.809454,8.903347
channel-750,680451,30187702,30187707,5,2025-02-23 09:52:55.161638,2025-02-23 09:53:00.657959,5.496321
channel-750,680452,30187778,30187792,14,2025-02-23 09:54:33.908474,2025-02-23 09:54:53.057224,19.14875
channel-750,680453,30187779,30187792,13,2025-02-23 09:54:35.080996,2025-02-23 09:54:53.057224,17.976228
channel-750,680454,30187870,30187885,15,2025-02-23 09:56:33.422047,2025-02-23 09:56:50.617140,17.195093
channel-750,680455,30187877,30187882,5,2025-02-23 09:56:41.643502,2025-02-23 09:56:47.296205,5.652703
channel-750,680456,30187905,30187916,11,2025-02-23 09:57:14.402328,2025-02-23 09:57:30.505653,16.103325
channel-750,680457,30187909,30187918,9,2025-02-23 09:57:20.384671,2025-02-23 09:57:32.955827,12.571156
channel-750,680458,30187945,30187957,12,2025-02-23 09:58:04.555801,2025-02-23 09:58:24.336099,19.780298
channel-750,680459,30188043,30188049,6,2025-02-23 10:00:13.902807,2025-02-23 10:00:20.710086,6.807279
channel-750,680460,30188046,30188052,6,2025-02-23 10:00:17.355462,2025-02-23 10:00:24.275939,6.920477
channel-750,680461,30188136,30188154,18,2025-02-23 10:02:15.408982,2025-02-23 10:02:37.469262,22.06028
channel-750,680462,30188588,30188593,5,2025-02-23 10:11:57.587914,2025-02-23 10:12:04.124788,6.536874
channel-750,680463,30188589,30188600,11,2025-02-23 10:11:58.865435,2025-02-23 10:12:13.191611,14.326176
channel-750,680464,30188602,30188613,11,2025-02-23 10:12:16.996124,2025-02-23 10:12:31.794979,14.798855
channel-750,680465,30188610,30188625,15,2025-02-23 10:12:28.444535,2025-02-23 10:12:45.539844,17.095309
channel-750,680466,30188655,30188668,13,2025-02-23 10:13:23.193499,2025-02-23 10:13:40.818199,17.6247
channel-750,680467,30188655,30188660,5,2025-02-23 10:13:23.193499,2025-02-23 10:13:30.413885,7.220386
channel-750,680468,30188658,30188671,13,2025-02-23 10:13:27.672279,2025-02-23 10:13:44.082924,16.410645
channel-750,680469,30188663,30188668,5,2025-02-23 10:13:34.084760,2025-02-23 10:13:40.818199,6.733439
channel-750,680470,30188675,30188687,12,2025-02-23 10:13:48.740795,2025-02-23 10:14:05.342014,16.601219
channel-750,680471,30188675,30188679,4,2025-02-23 10:13:48.740795,2025-02-23 10:13:54.591663,5.850868
channel-750,680472,30188681,30188692,11,2025-02-23 10:13:56.935217,2025-02-23 10:14:12.801107,15.86589
channel-750,680473,30188691,30188704,13,2025-02-23 10:14:11.507917,2025-02-23 10:14:27.080756,15.572839
channel-750,680474,30188693,30188698,5,2025-02-23 10:14:13.937044,2025-02-23 10:14:20.243379,6.306335
channel-750,680475,30188706,30188717,11,2025-02-23 10:14:29.519850,2025-02-23 10:14:44.952260,15.43241
channel-750,680476,30188708,30188712,4,2025-02-23 10:14:31.753914,2025-02-23 10:14:37.184594,5.43068
channel-750,680477,30188717,30188730,13,2025-02-23 10:14:44.952260,2025-02-23 10:15:01.284777,16.332517
channel-750,680478,30188746,30188751,5,2025-02-23 10:15:22.331158,2025-02-23 10:15:27.985921,5.654763
channel-750,680479,30188752,30188768,16,2025-02-23 10:15:29.135442,2025-02-23 10:15:48.191541,19.056099
channel-750,680480,30188772,30188782,10,2025-02-23 10:15:52.948276,2025-02-23 10:16:07.286698,14.338422
channel-750,680481,30188775,30188780,5,2025-02-23 10:15:57.870244,2025-02-23 10:16:03.653613,5.783369
channel-750,680482,30188784,30188797,13,2025-02-23 10:16:10.816548,2025-02-23 10:16:29.408197,18.591649
channel-750,680483,30188784,30188797,13,2025-02-23 10:16:10.816548,2025-02-23 10:16:29.408197,18.591649
channel-750,680484,30188786,30188800,14,2025-02-23 10:16:16.391524,2025-02-23 10:16:32.845635,16.454111
channel-750,680485,30188791,30188803,12,2025-02-23 10:16:21.910098,2025-02-23 10:16:36.400346,14.490248
channel-750,680486,30188803,30188815,12,2025-02-23 10:16:36.400346,2025-02-23 10:16:50.982501,14.582155
channel-750,680487,30188805,30188833,28,2025-02-23 10:16:38.603777,2025-02-23 10:17:14.248243,35.644466
channel-750,680488,30188829,30188837,8,2025-02-23 10:17:08.553151,2025-02-23 10:17:18.766011,10.21286
channel-750,680489,30188833,30188846,13,2025-02-23 10:17:14.248243,2025-02-23 10:17:29.200604,14.952361
channel-750,680490,30188841,30188851,10,2025-02-23 10:17:23.471507,2025-02-23 10:17:36.107913,12.636406
channel-750,680491,30188853,30188857,4,2025-02-23 10:17:38.380020,2025-02-23 10:17:44.393682,6.013662
channel-750,680492,30188962,30188966,4,2025-02-23 10:19:57.821809,2025-02-23 10:20:02.883349,5.06154
channel-750,680494,30189211,30189215,4,2025-02-23 10:25:21.877958,2025-02-23 10:25:27.071861,5.193903
channel-750,680495,30189215,30189233,18,2025-02-23 10:25:27.071861,2025-02-23 10:25:51.927094,24.855233
channel-750,680496,30189526,30189544,18,2025-02-23 10:32:09.423173,2025-02-23 10:32:32.527851,23.104678
channel-750,680497,30189557,30189573,16,2025-02-23 10:32:51.107889,2025-02-23 10:33:12.391103,21.283214
channel-750,680498,30189648,30189662,14,2025-02-23 10:34:49.571095,2025-02-23 10:35:11.153709,21.582614
channel-750,680499,30189679,30189691,12,2025-02-23 10:35:32.358615,2025-02-23 10:35:48.108353,15.749738
channel-750,680500,30189725,30189730,5,2025-02-23 10:36:31.433500,2025-02-23 10:36:38.774407,7.340907
channel-750,680501,30189740,30189761,21,2025-02-23 10:36:51.369280,2025-02-23 10:37:16.502670,25.13339
channel-750,680502,30189838,30189853,15,2025-02-23 10:39:00.177704,2025-02-23 10:39:20.522493,20.344789
channel-750,680503,30189849,30189859,10,2025-02-23 10:39:15.608893,2025-02-23 10:39:27.437010,11.828117
channel-750,680504,30189886,30189901,15,2025-02-23 10:39:58.906719,2025-02-23 10:40:20.273574,21.366855
channel-750,680505,30190016,30190030,14,2025-02-23 10:42:47.865340,2025-02-23 10:43:09.570570,21.70523
channel-750,680506,30190040,30190057,17,2025-02-23 10:43:22.983930,2025-02-23 10:43:43.352953,20.369023
channel-750,680507,30190146,30190161,15,2025-02-23 10:45:39.540542,2025-02-23 10:45:59.484848,19.944306
channel-750,680508,30190150,30190153,3,2025-02-23 10:45:43.986106,2025-02-23 10:45:47.601963,3.615857
channel-750,680509,30190152,30190168,16,2025-02-23 10:45:46.317986,2025-02-23 10:46:07.467667,21.149681
channel-750,680510,30190185,30190195,10,2025-02-23 10:46:30.387303,2025-02-23 10:46:41.881025,11.493722
channel-750,680511,30190244,30190249,5,2025-02-23 10:47:47.705243,2025-02-23 10:47:56.506663,8.80142
channel-750,680512,30190254,30190259,5,2025-02-23 10:48:02.267269,2025-02-23 10:48:07.974532,5.707263
channel-750,680513,30190266,30190280,14,2025-02-23 10:48:16.332012,2025-02-23 10:48:34.193259,17.861247
channel-750,680514,30190339,30190344,5,2025-02-23 10:49:51.450107,2025-02-23 10:49:57.380770,5.930663
channel-750,680515,30190398,30190402,4,2025-02-23 10:51:03.130626,2025-02-23 10:51:07.736702,4.606076
