channel_id,sequence,send_height,ack_height,block_delay,send_time,ack_time,time_delay_sec
channel-85077,59888,30280054,30280062,8,2025-02-24 20:02:06.558575,2025-02-24 20:02:21.281227,14.722652
channel-85077,59889,30280060,30280084,24,2025-02-24 20:02:18.833671,2025-02-24 20:02:48.759447,29.925776
channel-85077,59890,30280079,30280089,10,2025-02-24 20:02:42.576099,2025-02-24 20:02:55.649426,13.073327
channel-85077,59891,30280153,30280164,11,2025-02-24 20:04:18.455890,2025-02-24 20:04:31.635465,13.179575
channel-85077,59892,30280349,30280358,9,2025-02-24 20:08:43.967361,2025-02-24 20:08:54.365570,10.398209
channel-85077,59893,30280374,30280383,9,2025-02-24 20:09:14.430721,2025-02-24 20:09:26.123334,11.692613
channel-85077,59894,30280410,30280427,17,2025-02-24 20:10:00.120342,2025-02-24 20:10:24.185937,24.065595
channel-85077,59895,30280510,30280520,10,2025-02-24 20:12:10.117845,2025-02-24 20:12:24.821871,14.704026
channel-85077,59896,30280512,30280521,9,2025-02-24 20:12:14.084537,2025-02-24 20:12:26.399676,12.315139
channel-85077,59897,30280593,30280600,7,2025-02-24 20:14:01.487799,2025-02-24 20:14:09.312801,7.825002
channel-85077,59898,30280825,30280835,10,2025-02-24 20:19:05.723455,2025-02-24 20:19:17.800009,12.076554
channel-85077,59899,30280873,30280900,27,2025-02-24 20:20:10.116695,2025-02-24 20:20:43.002321,32.885626
channel-85077,59900,30280938,30280944,6,2025-02-24 20:21:30.004189,2025-02-24 20:21:40.040425,10.036236
channel-85077,59901,30280965,30280974,9,2025-02-24 20:22:10.227170,2025-02-24 20:22:21.439632,11.212462
channel-85077,59902,30280968,30280978,10,2025-02-24 20:22:14.716492,2025-02-24 20:22:25.983496,11.267004
channel-85077,59903,30281087,30281096,9,2025-02-24 20:24:45.043945,2025-02-24 20:24:55.446044,10.402099
channel-85077,59904,30281225,30281234,9,2025-02-24 20:27:45.805981,2025-02-24 20:27:57.502582,11.696601
channel-85077,59905,30281333,30281345,12,2025-02-24 20:30:09.117786,2025-02-24 20:30:23.321126,14.20334
channel-85077,59906,30281351,30281361,10,2025-02-24 20:30:35.025270,2025-02-24 20:30:47.454685,12.429415
channel-85077,59907,30281394,30281401,7,2025-02-24 20:31:28.168530,2025-02-24 20:31:40.189377,12.020847
channel-85077,59908,30281638,30281647,9,2025-02-24 20:36:47.999289,2025-02-24 20:37:01.316881,13.317592
channel-85077,59909,30281654,30281661,7,2025-02-24 20:37:09.969509,2025-02-24 20:37:18.062378,8.092869
channel-85077,59910,30281696,30281704,8,2025-02-24 20:38:02.116379,2025-02-24 20:38:12.442584,10.326205
channel-85077,59911,30281717,30281725,8,2025-02-24 20:38:28.381479,2025-02-24 20:38:38.607178,10.225699
channel-85077,59912,30281721,30281731,10,2025-02-24 20:38:34.096691,2025-02-24 20:38:49.716222,15.619531
channel-85077,59913,30281780,30281789,9,2025-02-24 20:39:55.193111,2025-02-24 20:40:08.051715,12.858604
channel-85077,59914,30281889,30281899,10,2025-02-24 20:42:18.368299,2025-02-24 20:42:31.252423,12.884124
channel-85077,59915,30281923,30281932,9,2025-02-24 20:43:04.412862,2025-02-24 20:43:17.419168,13.006306
channel-85077,59916,30281925,30281938,13,2025-02-24 20:43:06.669295,2025-02-24 20:43:26.915865,20.24657
channel-85077,59917,30281928,30281938,10,2025-02-24 20:43:11.498364,2025-02-24 20:43:26.915865,15.417501
channel-85077,59918,30281945,30281953,8,2025-02-24 20:43:35.679177,2025-02-24 20:43:44.946677,9.2675
channel-85077,59919,30281950,30281959,9,2025-02-24 20:43:41.305563,2025-02-24 20:43:52.859321,11.553758
channel-85077,59920,30281953,30281963,10,2025-02-24 20:43:44.946677,2025-02-24 20:43:57.608121,12.661444
channel-85077,59921,30281954,30281971,17,2025-02-24 20:43:46.069857,2025-02-24 20:44:07.441775,21.371918
channel-85077,59922,30281969,30281975,6,2025-02-24 20:44:05.055728,2025-02-24 20:44:12.458595,7.402867
channel-85077,59923,30281975,30281985,10,2025-02-24 20:44:12.458595,2025-02-24 20:44:29.057764,16.599169
channel-85077,59924,30281977,30281987,10,2025-02-24 20:44:19.397301,2025-02-24 20:44:32.350979,12.953678
channel-85077,59925,30282014,30282024,10,2025-02-24 20:45:06.634152,2025-02-24 20:45:18.171252,11.5371
channel-85077,59926,30282022,30282035,13,2025-02-24 20:45:15.918441,2025-02-24 20:45:33.048226,17.129785
channel-85077,59927,30282033,30282043,10,2025-02-24 20:45:30.762820,2025-02-24 20:45:45.702984,14.940164
channel-85077,59928,30282040,30282060,20,2025-02-24 20:45:39.341942,2025-02-24 20:46:07.895685,28.553743
channel-85077,59929,30282044,30282055,11,2025-02-24 20:45:46.816980,2025-02-24 20:46:02.123950,15.30697
channel-85077,59930,30282058,30282064,6,2025-02-24 20:46:05.648876,2025-02-24 20:46:12.765831,7.116955
channel-85077,59931,30282073,30282085,12,2025-02-24 20:46:27.177095,2025-02-24 20:46:40.868186,13.691091
channel-85077,59932,30282076,30282099,23,2025-02-24 20:46:30.694541,2025-02-24 20:46:57.305441,26.6109
channel-85077,59933,30282086,30282096,10,2025-02-24 20:46:41.971404,2025-02-24 20:46:53.917449,11.946045
channel-85077,59934,30282100,30282107,7,2025-02-24 20:46:58.445224,2025-02-24 20:47:07.513335,9.068111
channel-85077,59935,30282126,30282140,14,2025-02-24 20:47:31.723009,2025-02-24 20:47:49.547171,17.824162
channel-85077,59936,30282140,30282151,11,2025-02-24 20:47:49.547171,2025-02-24 20:48:02.548129,13.000958
channel-85077,59937,30282155,30282162,7,2025-02-24 20:48:09.369688,2025-02-24 20:48:22.919558,13.54987
channel-85077,59938,30282160,30282171,11,2025-02-24 20:48:15.899926,2025-02-24 20:48:35.049176,19.14925
channel-85077,59939,30282178,30282188,10,2025-02-24 20:48:43.871535,2025-02-24 20:48:59.139636,15.268101
channel-85077,59940,30282229,30282238,9,2025-02-24 20:49:50.834872,2025-02-24 20:50:02.727063,11.892191
channel-85077,59941,30282231,30282244,13,2025-02-24 20:49:53.174596,2025-02-24 20:50:11.721068,18.546472
channel-85077,59942,30282236,30282248,12,2025-02-24 20:49:58.901004,2025-02-24 20:50:16.292732,17.391728
channel-85077,59943,30282244,30282251,7,2025-02-24 20:50:11.721068,2025-02-24 20:50:24.141251,12.420183
channel-85077,59944,30282251,30282262,11,2025-02-24 20:50:24.141251,2025-02-24 20:50:38.467449,14.326198
channel-85077,59945,30282280,30282290,10,2025-02-24 20:51:01.688426,2025-02-24 20:51:13.014410,11.325984
channel-85077,59946,30282348,30282359,11,2025-02-24 20:52:27.733651,2025-02-24 20:52:40.787724,13.054073
channel-85077,59947,30282349,30282359,10,2025-02-24 20:52:28.942062,2025-02-24 20:52:40.787724,11.845662
channel-85077,59948,30282362,30282370,8,2025-02-24 20:52:44.296982,2025-02-24 20:52:57.601481,13.304499
channel-85077,59949,30282376,30282388,12,2025-02-24 20:53:05.649507,2025-02-24 20:53:19.923272,14.273765
channel-85077,59950,30282380,30282389,9,2025-02-24 20:53:10.195342,2025-02-24 20:53:20.939883,10.744541
channel-85077,59951,30282415,30282423,8,2025-02-24 20:53:56.962295,2025-02-24 20:54:11.248723,14.286428
channel-85077,59952,30282416,30282423,7,2025-02-24 20:53:58.260710,2025-02-24 20:54:11.248723,12.988013
channel-85077,59953,30282417,30282430,13,2025-02-24 20:54:04.021927,2025-02-24 20:54:20.693766,16.671839
channel-85077,59954,30282422,30282458,36,2025-02-24 20:54:09.989985,2025-02-24 20:54:57.895268,47.905283
channel-85077,59955,30282423,30282433,10,2025-02-24 20:54:11.248723,2025-02-24 20:54:25.196908,13.948185
channel-85077,59956,30282432,30282442,10,2025-02-24 20:54:23.551475,2025-02-24 20:54:35.947737,12.396262
channel-85077,59957,30282438,30282458,20,2025-02-24 20:54:31.242536,2025-02-24 20:54:57.895268,26.652732
channel-85077,59958,30282454,30282468,14,2025-02-24 20:54:52.379831,2025-02-24 20:55:11.416408,19.036577
channel-85077,59959,30282454,30282468,14,2025-02-24 20:54:52.379831,2025-02-24 20:55:11.416408,19.036577
channel-85077,59960,30282470,30282488,18,2025-02-24 20:55:13.780106,2025-02-24 20:55:37.628663,23.848557
channel-85077,59961,30282472,30282481,9,2025-02-24 20:55:15.985936,2025-02-24 20:55:27.467549,11.481613
channel-85077,59962,30282473,30282485,12,2025-02-24 20:55:18.184219,2025-02-24 20:55:33.083203,14.898984
channel-85077,59963,30282480,30282488,8,2025-02-24 20:55:26.322681,2025-02-24 20:55:37.628663,11.305982
channel-85077,59964,30282486,30282495,9,2025-02-24 20:55:34.307400,2025-02-24 20:55:46.003765,11.696365
channel-85077,59965,30282504,30282514,10,2025-02-24 20:55:58.745073,2025-02-24 20:56:12.380632,13.635559
channel-85077,59966,30282506,30282516,10,2025-02-24 20:56:00.984345,2025-02-24 20:56:15.137222,14.152877
channel-85077,59967,30282544,30282551,7,2025-02-24 20:56:49.538051,2025-02-24 20:56:58.993628,9.455577
channel-85077,59968,30282625,30282650,25,2025-02-24 20:58:38.977095,2025-02-24 20:59:08.207536,29.230441
channel-85077,59969,30282638,30282650,12,2025-02-24 20:58:54.487403,2025-02-24 20:59:08.207536,13.720133
channel-85077,59970,30282642,30282673,31,2025-02-24 20:58:59.026620,2025-02-24 20:59:37.618033,38.591413
channel-85077,59971,30282704,30282776,72,2025-02-24 21:00:21.295310,2025-02-24 21:01:57.229577,95.934267
channel-85077,59972,30282895,30282904,9,2025-02-24 21:04:34.512577,2025-02-24 21:04:46.870295,12.357718
channel-85077,59973,30282911,30282924,13,2025-02-24 21:04:56.343787,2025-02-24 21:05:13.122079,16.778292
channel-85077,59974,30282966,30282983,17,2025-02-24 21:06:09.590653,2025-02-24 21:06:31.214241,21.623588
channel-85077,59975,30283045,30283059,14,2025-02-24 21:07:57.661832,2025-02-24 21:08:15.823428,18.161596
channel-85077,59976,30283424,30283435,11,2025-02-24 21:16:13.292943,2025-02-24 21:16:28.071273,14.77833
channel-85077,59977,30283476,30283490,14,2025-02-24 21:17:23.485823,2025-02-24 21:17:42.208661,18.722838
channel-85077,59978,30283518,30283544,26,2025-02-24 21:18:14.470113,2025-02-24 21:18:49.375716,34.905603
channel-85077,59979,30283522,30283538,16,2025-02-24 21:18:19.943488,2025-02-24 21:18:42.615652,22.672164
channel-85077,59980,30283882,30283891,9,2025-02-24 21:26:12.871117,2025-02-24 21:26:23.837600,10.966483
channel-85077,59981,30284021,30284029,8,2025-02-24 21:29:15.558353,2025-02-24 21:29:24.906775,9.348422
channel-85077,59982,30284037,30284051,14,2025-02-24 21:29:34.127800,2025-02-24 21:29:53.075239,18.947439
channel-85077,59983,30284527,30284537,10,2025-02-24 21:40:28.787702,2025-02-24 21:40:41.416634,12.628932
channel-85077,59984,30284643,30284652,9,2025-02-24 21:42:55.867631,2025-02-24 21:43:08.095421,12.22779
channel-85077,59985,30284652,30284661,9,2025-02-24 21:43:08.095421,2025-02-24 21:43:18.782834,10.687413
channel-85077,59986,30284692,30284710,18,2025-02-24 21:44:06.666798,2025-02-24 21:44:28.432011,21.765213
channel-85077,59987,30284751,30284760,9,2025-02-24 21:45:21.946460,2025-02-24 21:45:34.012106,12.065646
channel-85077,59988,30284767,30284776,9,2025-02-24 21:45:42.353401,2025-02-24 21:45:54.029742,11.676341
channel-85077,59989,30284808,30284818,10,2025-02-24 21:46:33.960908,2025-02-24 21:46:45.686699,11.725791
channel-85077,59990,30284938,30284947,9,2025-02-24 21:49:27.546994,2025-02-24 21:49:38.522921,10.975927
channel-85077,59991,30284981,30284990,9,2025-02-24 21:50:22.950141,2025-02-24 21:50:33.995762,11.045621
channel-85077,59992,30285102,30285108,6,2025-02-24 21:52:58.231950,2025-02-24 21:53:10.012857,11.780907
channel-85077,59993,30285104,30285120,16,2025-02-24 21:53:01.102319,2025-02-24 21:53:28.288388,27.186069
channel-85077,59994,30285127,30285138,11,2025-02-24 21:53:37.670058,2025-02-24 21:53:50.578433,12.908375
channel-85077,59995,30285133,30285141,8,2025-02-24 21:53:44.704327,2025-02-24 21:53:55.086589,10.382262
channel-85077,59996,30285133,30285141,8,2025-02-24 21:53:44.704327,2025-02-24 21:53:55.086589,10.382262
channel-85077,59997,30285173,30285182,9,2025-02-24 21:54:36.578395,2025-02-24 21:54:48.656226,12.077831
channel-85077,59998,30285264,30285274,10,2025-02-24 21:56:32.135938,2025-02-24 21:56:44.245687,12.109749
channel-85077,59999,30285283,30285294,11,2025-02-24 21:57:00.156420,2025-02-24 21:57:13.385477,13.229057
channel-85077,60000,30285293,30285302,9,2025-02-24 21:57:12.233728,2025-02-24 21:57:22.481967,10.248239
channel-85077,60001,30285332,30285343,11,2025-02-24 21:58:06.591437,2025-02-24 21:58:19.746027,13.15459
channel-85077,60002,30285359,30285365,6,2025-02-24 21:58:39.456809,2025-02-24 21:58:50.573755,11.116946
channel-85077,60003,30285410,30285449,39,2025-02-24 21:59:46.166949,2025-02-24 22:00:35.723634,49.556685
channel-85077,60004,30285410,30285449,39,2025-02-24 21:59:46.166949,2025-02-24 22:00:35.723634,49.556685
channel-85077,60005,30285468,30285479,11,2025-02-24 22:01:07.424323,2025-02-24 22:01:20.164365,12.740042
channel-85077,60006,30285510,30285519,9,2025-02-24 22:02:04.248812,2025-02-24 22:02:18.919101,14.670289
channel-85077,60007,30285622,30285628,6,2025-02-24 22:04:54.247084,2025-02-24 22:05:06.386233,12.139149
channel-85077,60008,30285628,30285635,7,2025-02-24 22:05:06.386233,2025-02-24 22:05:15.892655,9.506422
channel-85077,60009,30285686,30285712,26,2025-02-24 22:06:23.063445,2025-02-24 22:06:58.028943,34.965498
channel-85077,60010,30285872,30285880,8,2025-02-24 22:10:35.578418,2025-02-24 22:10:47.157669,11.579251
channel-85077,60011,30286091,30286101,10,2025-02-24 22:15:33.968229,2025-02-24 22:15:46.889538,12.921309
channel-85077,60012,30286230,30286239,9,2025-02-24 22:18:41.440227,2025-02-24 22:18:55.040558,13.600331
channel-85077,60013,30286275,30286285,10,2025-02-24 22:19:41.747390,2025-02-24 22:19:54.551095,12.803705
channel-85077,60014,30286279,30286290,11,2025-02-24 22:19:47.666497,2025-02-24 22:20:00.520900,12.854403
channel-85077,60015,30286326,30286340,14,2025-02-24 22:20:50.314585,2025-02-24 22:21:07.213740,16.899155
channel-85077,60016,30286344,30286354,10,2025-02-24 22:21:11.955497,2025-02-24 22:21:26.456144,14.500647
channel-85077,60017,30286373,30286392,19,2025-02-24 22:21:52.779734,2025-02-24 22:22:17.465474,24.68574
channel-85077,60018,30286438,30286450,12,2025-02-24 22:23:21.032562,2025-02-24 22:23:35.142592,14.11003
channel-85077,60019,30286585,30286595,10,2025-02-24 22:26:36.909770,2025-02-24 22:26:49.542944,12.633174
channel-85077,60020,30286734,30286744,10,2025-02-24 22:29:47.614620,2025-02-24 22:30:00.526030,12.91141
channel-85077,60021,30286747,30286756,9,2025-02-24 22:30:03.893786,2025-02-24 22:30:17.744211,13.850425
channel-85077,60022,30286890,30286902,12,2025-02-24 22:33:12.410252,2025-02-24 22:33:26.375996,13.965744
channel-85077,60023,30286904,30286912,8,2025-02-24 22:33:28.694862,2025-02-24 22:33:40.905902,12.21104
channel-85077,60024,30286946,30286956,10,2025-02-24 22:34:23.470502,2025-02-24 22:34:36.503837,13.033335
channel-85077,60025,30287114,30287128,14,2025-02-24 22:38:10.150497,2025-02-24 22:38:29.040265,18.889768
channel-85077,60026,30287157,30287168,11,2025-02-24 22:39:05.267657,2025-02-24 22:39:18.085556,12.817899
channel-85077,60027,30287410,30287421,11,2025-02-24 22:44:40.800201,2025-02-24 22:44:54.084837,13.284636
channel-85077,60028,30287413,30287423,10,2025-02-24 22:44:44.841363,2025-02-24 22:44:56.482242,11.640879
channel-85077,60029,30287553,30287561,8,2025-02-24 22:47:51.001565,2025-02-24 22:48:01.524791,10.523226
channel-85077,60030,30287572,30287582,10,2025-02-24 22:48:14.142114,2025-02-24 22:48:26.495820,12.353706
channel-85077,60031,30287833,30287843,10,2025-02-24 22:54:07.449073,2025-02-24 22:54:19.951290,12.502217
channel-85077,60032,30288035,30288045,10,2025-02-24 22:58:38.891549,2025-02-24 22:58:57.026206,18.134657
channel-85077,60033,30288042,30288052,10,2025-02-24 22:58:49.895222,2025-02-24 22:59:08.071333,18.176111
channel-85077,60034,30288045,30288054,9,2025-02-24 22:58:57.026206,2025-02-24 22:59:10.493130,13.466924
channel-85077,60035,30288098,30288109,11,2025-02-24 23:00:05.731065,2025-02-24 23:00:20.787481,15.056416
channel-85077,60036,30288136,30288147,11,2025-02-24 23:00:56.921753,2025-02-24 23:01:15.962889,19.041136
channel-85077,60037,30288153,30288163,10,2025-02-24 23:01:23.041369,2025-02-24 23:01:36.572878,13.531509
channel-85077,60038,30288199,30288212,13,2025-02-24 23:02:23.181296,2025-02-24 23:02:39.109854,15.928558
channel-85077,60039,30288224,30288231,7,2025-02-24 23:02:54.876095,2025-02-24 23:03:10.732841,15.856746
channel-85077,60040,30288333,30288345,12,2025-02-24 23:05:26.338437,2025-02-24 23:05:40.859901,14.521464
channel-85077,60041,30288376,30288390,14,2025-02-24 23:06:22.755854,2025-02-24 23:06:39.548012,16.792158
channel-85077,60042,30288450,30288469,19,2025-02-24 23:08:02.429087,2025-02-24 23:08:25.886022,23.456935
channel-85077,60043,30288484,30288502,18,2025-02-24 23:08:47.716521,2025-02-24 23:09:12.398405,24.681884
channel-85077,60044,30288502,30288511,9,2025-02-24 23:09:12.398405,2025-02-24 23:09:24.386505,11.9881
channel-85077,60045,30288503,30288520,17,2025-02-24 23:09:14.880666,2025-02-24 23:09:35.476195,20.595529
channel-85077,60046,30288599,30288611,12,2025-02-24 23:11:20.946984,2025-02-24 23:11:35.702452,14.755468
channel-85077,60047,30288728,30288739,11,2025-02-24 23:14:08.657397,2025-02-24 23:14:21.731810,13.074413
channel-85077,60048,30288743,30288749,6,2025-02-24 23:14:27.326593,2025-02-24 23:14:38.045672,10.719079
channel-85077,60049,30288820,30288829,9,2025-02-24 23:16:06.744994,2025-02-24 23:16:19.875804,13.13081
channel-85077,60050,30288855,30288863,8,2025-02-24 23:16:55.511491,2025-02-24 23:17:05.765538,10.254047
channel-85077,60051,30288889,30288898,9,2025-02-24 23:17:39.878377,2025-02-24 23:17:51.290918,11.412541
channel-85077,60052,30288948,30288959,11,2025-02-24 23:18:54.856119,2025-02-24 23:19:08.923187,14.067068
channel-85077,60053,30289156,30289165,9,2025-02-24 23:23:28.972836,2025-02-24 23:23:40.308439,11.335603
channel-85077,60054,30289355,30289365,10,2025-02-24 23:28:01.542181,2025-02-24 23:28:13.784699,12.242518
channel-85077,60055,30289357,30289371,14,2025-02-24 23:28:03.927302,2025-02-24 23:28:22.012694,18.085392
channel-85077,60056,30289376,30289386,10,2025-02-24 23:28:29.087045,2025-02-24 23:28:42.238592,13.151547
channel-85077,60057,30289392,30289400,8,2025-02-24 23:28:50.631024,2025-02-24 23:29:00.001181,9.370157
channel-85077,60058,30289464,30289472,8,2025-02-24 23:30:26.375996,2025-02-24 23:30:41.244184,14.868188
channel-85077,60059,30289591,30289618,27,2025-02-24 23:33:14.516965,2025-02-24 23:33:53.636315,39.11935
channel-85077,60060,30289712,30289723,11,2025-02-24 23:36:00.056373,2025-02-24 23:36:17.539655,17.483282
channel-85077,60061,30289781,30289791,10,2025-02-24 23:37:29.728094,2025-02-24 23:37:45.608573,15.880479
channel-85077,60062,30289785,30289794,9,2025-02-24 23:37:37.840047,2025-02-24 23:37:49.007082,11.167035
channel-85077,60063,30289972,30289981,9,2025-02-24 23:41:54.049887,2025-02-24 23:42:05.166289,11.116402
channel-85077,60064,30290096,30290105,9,2025-02-24 23:44:37.594439,2025-02-24 23:44:48.271321,10.676882
channel-85077,60065,30290096,30290105,9,2025-02-24 23:44:37.594439,2025-02-24 23:44:48.271321,10.676882
channel-85077,60066,30290168,30290179,11,2025-02-24 23:46:13.638532,2025-02-24 23:46:26.643699,13.005167
channel-85077,60067,30290208,30290216,8,2025-02-24 23:47:03.814019,2025-02-24 23:47:13.833289,10.01927
channel-85077,60068,30290225,30290233,8,2025-02-24 23:47:28.787625,2025-02-24 23:47:38.683947,9.896322
channel-85077,60069,30290723,30290731,8,2025-02-24 23:58:24.410741,2025-02-24 23:58:36.207474,11.796733
channel-85077,60070,30291158,30291209,51,2025-02-25 00:08:04.545612,2025-02-25 00:09:15.566536,71.020924
channel-85077,60071,30291202,30291209,7,2025-02-25 00:09:01.046280,2025-02-25 00:09:15.566536,14.520256
channel-85077,60072,30291209,30291219,10,2025-02-25 00:09:15.566536,2025-02-25 00:09:28.197364,12.630828
channel-85077,60073,30291325,30291337,12,2025-02-25 00:11:45.987530,2025-02-25 00:12:01.270773,15.283243
channel-85077,60074,30291463,30291474,11,2025-02-25 00:15:00.183483,2025-02-25 00:15:13.817592,13.634109
channel-85077,60075,30291602,30291610,8,2025-02-25 00:18:10.896833,2025-02-25 00:18:21.877529,10.980696
channel-85077,60076,30291866,30291875,9,2025-02-25 00:24:02.515891,2025-02-25 00:24:13.729615,11.213724
channel-85077,60077,30291896,30291907,11,2025-02-25 00:24:39.958451,2025-02-25 00:24:53.418903,13.460452
channel-85077,60078,30291959,30291970,11,2025-02-25 00:26:03.677286,2025-02-25 00:26:21.005733,17.328447
channel-85077,60079,30291977,30291986,9,2025-02-25 00:26:32.310452,2025-02-25 00:26:45.016291,12.705839
channel-85077,60080,30292051,30292060,9,2025-02-25 00:28:10.279982,2025-02-25 00:28:21.501311,11.221329
channel-85077,60081,30292231,30292242,11,2025-02-25 00:32:04.564581,2025-02-25 00:32:18.338077,13.773496
channel-85077,60082,30292411,30292420,9,2025-02-25 00:36:02.547658,2025-02-25 00:36:14.616825,12.069167
channel-85077,60083,30292537,30292547,10,2025-02-25 00:38:47.388624,2025-02-25 00:38:58.797017,11.408393
channel-85077,60084,30292619,30292628,9,2025-02-25 00:40:34.345844,2025-02-25 00:40:47.102903,12.757059
channel-85077,60085,30292871,30292878,7,2025-02-25 00:46:05.758188,2025-02-25 00:46:15.783403,10.025215
channel-85077,60086,30293210,30293230,20,2025-02-25 00:53:34.184230,2025-02-25 00:54:02.763822,28.579592
channel-85077,60087,30293306,30293315,9,2025-02-25 00:55:41.995150,2025-02-25 00:55:54.311764,12.316614
channel-85077,60088,30293340,30293349,9,2025-02-25 00:56:28.548960,2025-02-25 00:56:39.691642,11.142682
channel-85077,60089,30293648,30293658,10,2025-02-25 01:03:18.968547,2025-02-25 01:03:31.679188,12.710641
channel-85077,60090,30293652,30293661,9,2025-02-25 01:03:24.743852,2025-02-25 01:03:35.202782,10.45893
channel-85077,60091,30293668,30293675,7,2025-02-25 01:03:43.188887,2025-02-25 01:03:53.055368,9.866481
channel-85077,60092,30294247,30294253,6,2025-02-25 01:16:31.070293,2025-02-25 01:16:42.072614,11.002321
channel-85077,60093,30294264,30294272,8,2025-02-25 01:16:56.011562,2025-02-25 01:17:07.321841,11.310279
channel-85077,60094,30294540,30294548,8,2025-02-25 01:22:58.405885,2025-02-25 01:23:09.173079,10.767194
channel-85077,60095,30294936,30294944,8,2025-02-25 01:31:43.256113,2025-02-25 01:31:53.667264,10.411151
channel-85077,60096,30295262,30295270,8,2025-02-25 01:38:57.459110,2025-02-25 01:39:08.252273,10.793163
channel-85077,60097,30296068,30296077,9,2025-02-25 01:56:39.468513,2025-02-25 01:56:50.976501,11.507988
channel-85077,60098,30296070,30296085,15,2025-02-25 01:56:41.869014,2025-02-25 01:57:00.771784,18.90277
channel-85077,60099,30296085,30296094,9,2025-02-25 01:57:00.771784,2025-02-25 01:57:12.782425,12.010641
channel-85077,60100,30296121,30296129,8,2025-02-25 01:57:50.730922,2025-02-25 01:58:01.566724,10.835802
channel-85077,60101,30296188,30296197,9,2025-02-25 01:59:16.296293,2025-02-25 01:59:28.323235,12.026942
channel-85077,60102,30296188,30296197,9,2025-02-25 01:59:16.296293,2025-02-25 01:59:28.323235,12.026942
channel-85077,60103,30296206,30296217,11,2025-02-25 01:59:39.149433,2025-02-25 01:59:53.188541,14.039108
channel-85077,60104,30296436,30296442,6,2025-02-25 02:04:42.117618,2025-02-25 02:04:50.331182,8.213564
channel-85077,60105,30296486,30296496,10,2025-02-25 02:05:47.110943,2025-02-25 02:05:58.577968,11.467025
channel-85077,60106,30296512,30296523,11,2025-02-25 02:06:20.229170,2025-02-25 02:06:33.603248,13.374078
channel-85077,60107,30296519,30296526,7,2025-02-25 02:06:28.945614,2025-02-25 02:06:38.577122,9.631508
channel-85077,60108,30296521,30296529,8,2025-02-25 02:06:31.238805,2025-02-25 02:06:43.129020,11.890215
channel-85077,60109,30296557,30296566,9,2025-02-25 02:07:23.380117,2025-02-25 02:07:34.879289,11.499172
channel-85077,60110,30296632,30296641,9,2025-02-25 02:09:02.094474,2025-02-25 02:09:13.733059,11.638585
channel-85077,60111,30296652,30296662,10,2025-02-25 02:09:28.511627,2025-02-25 02:09:40.063542,11.551915
channel-85077,60112,30296880,30296895,15,2025-02-25 02:14:37.014415,2025-02-25 02:14:58.568566,21.554151
channel-85077,60113,30296908,30296916,8,2025-02-25 02:15:14.520346,2025-02-25 02:15:25.497441,10.977095
channel-85077,60114,30297030,30297048,18,2025-02-25 02:17:56.504482,2025-02-25 02:18:19.036713,22.532231
channel-85077,60115,30297042,30297073,31,2025-02-25 02:18:10.890693,2025-02-25 02:18:55.560335,44.669642
channel-85077,60116,30297078,30297087,9,2025-02-25 02:19:02.022225,2025-02-25 02:19:12.175707,10.153482
channel-85077,60117,30297088,30297101,13,2025-02-25 02:19:13.253514,2025-02-25 02:19:29.475835,16.222321
channel-85077,60118,30297126,30297134,8,2025-02-25 02:20:01.491986,2025-02-25 02:20:12.658695,11.166709
channel-85077,60119,30297128,30297138,10,2025-02-25 02:20:05.694858,2025-02-25 02:20:17.473197,11.778339
channel-85077,60120,30297128,30297138,10,2025-02-25 02:20:05.694858,2025-02-25 02:20:17.473197,11.778339
channel-85077,60121,30297143,30297151,8,2025-02-25 02:20:23.820095,2025-02-25 02:20:37.277022,13.456927
channel-85077,60122,30297187,30297198,11,2025-02-25 02:21:27.673129,2025-02-25 02:21:41.671730,13.998601
channel-85077,60123,30297399,30297407,8,2025-02-25 02:26:09.666331,2025-02-25 02:26:20.286450,10.620119
channel-85077,60124,30297538,30297557,19,2025-02-25 02:29:06.069197,2025-02-25 02:29:29.643430,23.574233
channel-85077,60125,30297731,30297741,10,2025-02-25 02:33:18.697002,2025-02-25 02:33:32.304430,13.607428
channel-85077,60126,30297737,30297747,10,2025-02-25 02:33:27.732794,2025-02-25 02:33:39.225445,11.492651
channel-85077,60127,30297926,30297940,14,2025-02-25 02:37:35.602374,2025-02-25 02:37:56.073962,20.471588
channel-85077,60128,30297974,30297982,8,2025-02-25 02:38:40.780216,2025-02-25 02:38:53.607231,12.827015
channel-85077,60129,30297987,30297996,9,2025-02-25 02:38:59.606571,2025-02-25 02:39:10.264208,10.657637
channel-85077,60130,30298048,30298058,10,2025-02-25 02:40:19.291637,2025-02-25 02:40:31.082453,11.790816
channel-85077,60131,30298255,30298265,10,2025-02-25 02:44:53.945495,2025-02-25 02:45:07.149263,13.203768
channel-85077,60132,30298257,30298271,14,2025-02-25 02:44:56.142473,2025-02-25 02:45:14.368398,18.225925
channel-85077,60133,30298298,30298309,11,2025-02-25 02:45:48.309348,2025-02-25 02:46:02.030715,13.721367
channel-85077,60134,30298332,30298340,8,2025-02-25 02:46:31.159309,2025-02-25 02:46:42.867589,11.70828
channel-85077,60135,30298384,30298399,15,2025-02-25 02:47:44.974779,2025-02-25 02:48:03.375230,18.400451
channel-85077,60136,30298460,30298470,10,2025-02-25 02:49:24.635619,2025-02-25 02:49:37.735602,13.099983
channel-85077,60137,30298484,30298493,9,2025-02-25 02:49:57.387510,2025-02-25 02:50:10.204093,12.816583
channel-85077,60138,30298486,30298505,19,2025-02-25 02:50:00.663177,2025-02-25 02:50:24.956243,24.293066
channel-85077,60139,30298502,30298511,9,2025-02-25 02:50:21.194777,2025-02-25 02:50:32.896354,11.701577
channel-85077,60140,30298505,30298518,13,2025-02-25 02:50:24.956243,2025-02-25 02:50:42.868584,17.912341
channel-85077,60141,30298523,30298532,9,2025-02-25 02:50:48.807565,2025-02-25 02:51:01.776836,12.969271
channel-85077,60142,30298558,30298568,10,2025-02-25 02:51:36.037981,2025-02-25 02:51:48.724121,12.68614
channel-85077,60143,30298612,30298621,9,2025-02-25 02:52:52.491998,2025-02-25 02:53:05.034224,12.542226
channel-85077,60144,30298615,30298623,8,2025-02-25 02:52:57.760596,2025-02-25 02:53:07.786903,10.026307
channel-85077,60145,30298625,30298634,9,2025-02-25 02:53:10.376017,2025-02-25 02:53:22.085094,11.709077
channel-85077,60146,30298626,30298640,14,2025-02-25 02:53:11.570079,2025-02-25 02:53:30.243738,18.673659
channel-85077,60147,30298645,30298653,8,2025-02-25 02:53:37.172185,2025-02-25 02:53:47.585882,10.413697
channel-85077,60148,30298748,30298761,13,2025-02-25 02:55:56.976049,2025-02-25 02:56:20.961761,23.985712
channel-85077,60149,30298751,30298784,33,2025-02-25 02:56:01.578949,2025-02-25 02:56:56.391806,54.812857
channel-85077,60150,30298793,30298800,7,2025-02-25 02:57:10.474910,2025-02-25 02:57:20.041975,9.567065
channel-85077,60151,30298800,30298811,11,2025-02-25 02:57:20.041975,2025-02-25 02:57:34.207773,14.165798
channel-85077,60152,30298914,30298921,7,2025-02-25 03:00:00.201083,2025-02-25 03:00:12.608021,12.406938
channel-85077,60153,30298920,30298930,10,2025-02-25 03:00:07.558705,2025-02-25 03:00:27.465538,19.906833
channel-85077,60154,30299048,30299057,9,2025-02-25 03:03:12.946942,2025-02-25 03:03:25.887962,12.94102
channel-85077,60155,30299398,30299406,8,2025-02-25 03:11:06.798890,2025-02-25 03:11:17.792829,10.993939
channel-85077,60156,30299478,30299485,7,2025-02-25 03:12:55.025985,2025-02-25 03:13:06.164309,11.138324
channel-85077,60157,30299506,30299516,10,2025-02-25 03:13:54.388969,2025-02-25 03:14:08.806176,14.417207
channel-85077,60158,30299506,30299516,10,2025-02-25 03:13:54.388969,2025-02-25 03:14:08.806176,14.417207
channel-85077,60159,30299541,30299551,10,2025-02-25 03:14:41.084939,2025-02-25 03:14:55.179154,14.094215
channel-85077,60160,30299565,30299572,7,2025-02-25 03:15:15.999160,2025-02-25 03:15:26.299096,10.299936
channel-85077,60161,30299587,30299599,12,2025-02-25 03:15:49.502837,2025-02-25 03:16:03.689423,14.186586
channel-85077,60162,30299599,30299608,9,2025-02-25 03:16:03.689423,2025-02-25 03:16:20.528316,16.838893
channel-85077,60163,30299611,30299622,11,2025-02-25 03:16:27.807328,2025-02-25 03:16:42.673390,14.866062
channel-85077,60164,30299617,30299628,11,2025-02-25 03:16:37.046714,2025-02-25 03:16:51.167750,14.121036
channel-85077,60165,30299623,30299630,7,2025-02-25 03:16:44.078745,2025-02-25 03:16:53.728355,9.64961
channel-85077,60166,30299631,30299651,20,2025-02-25 03:16:54.949682,2025-02-25 03:17:20.915635,25.965953
channel-85077,60167,30299635,30299645,10,2025-02-25 03:17:00.483463,2025-02-25 03:17:13.197717,12.714254
channel-85077,60168,30299658,30299667,9,2025-02-25 03:17:36.707646,2025-02-25 03:17:52.759206,16.05156
channel-85077,60169,30299661,30299669,8,2025-02-25 03:17:44.551454,2025-02-25 03:17:55.214878,10.663424
channel-85077,60170,30299662,30299680,18,2025-02-25 03:17:45.684740,2025-02-25 03:18:09.689590,24.00485
channel-85077,60171,30299663,30299672,9,2025-02-25 03:17:46.920559,2025-02-25 03:17:58.628627,11.708068
channel-85077,60172,30299694,30299710,16,2025-02-25 03:18:27.613294,2025-02-25 03:19:04.008778,36.395484
channel-85077,60173,30299702,30299725,23,2025-02-25 03:18:48.822412,2025-02-25 03:19:29.720455,40.898043
channel-85077,60174,30299705,30299713,8,2025-02-25 03:18:55.670200,2025-02-25 03:19:09.240187,13.569987
channel-85077,60175,30299709,30299715,6,2025-02-25 03:19:02.113574,2025-02-25 03:19:17.115959,15.002385
channel-85077,60176,30299713,30299724,11,2025-02-25 03:19:09.240187,2025-02-25 03:19:28.624879,19.384692
channel-85077,60177,30299716,30299725,9,2025-02-25 03:19:18.478063,2025-02-25 03:19:29.720455,11.242392
channel-85077,60178,30299763,30299774,11,2025-02-25 03:20:21.583889,2025-02-25 03:20:35.259298,13.675409
channel-85077,60179,30299787,30299801,14,2025-02-25 03:20:51.851516,2025-02-25 03:21:07.719655,15.868139
channel-85077,60180,30299808,30299818,10,2025-02-25 03:21:15.842788,2025-02-25 03:21:30.174591,14.331803
channel-85077,60181,30299816,30299822,6,2025-02-25 03:21:27.559706,2025-02-25 03:21:38.206457,10.646751
channel-85077,60182,30299817,30299823,6,2025-02-25 03:21:28.709925,2025-02-25 03:21:39.300062,10.590137
channel-85077,60183,30299836,30299844,8,2025-02-25 03:22:01.466857,2025-02-25 03:22:11.356512,9.889655
channel-85077,60184,30299838,30299847,9,2025-02-25 03:22:03.972270,2025-02-25 03:22:16.406719,12.434449
channel-85077,60185,30299863,30299869,6,2025-02-25 03:22:37.476814,2025-02-25 03:22:45.117887,7.641073
channel-85077,60186,30299892,30299902,10,2025-02-25 03:23:17.720635,2025-02-25 03:23:30.389375,12.66874
channel-85077,60187,30299897,30299910,13,2025-02-25 03:23:23.478274,2025-02-25 03:23:41.193680,17.715406
channel-85077,60188,30299906,30299916,10,2025-02-25 03:23:34.899448,2025-02-25 03:23:48.167317,13.267869
channel-85077,60189,30299920,30299930,10,2025-02-25 03:23:54.130601,2025-02-25 03:24:05.666935,11.536334
channel-85077,60190,30299942,30299951,9,2025-02-25 03:24:22.869844,2025-02-25 03:24:34.618880,11.749036
channel-85077,60191,30299945,30299955,10,2025-02-25 03:24:27.931539,2025-02-25 03:24:39.295460,11.363921
channel-85077,60192,30299985,30299996,11,2025-02-25 03:25:17.352730,2025-02-25 03:25:30.519500,13.16677
channel-85077,60193,30299997,30300007,10,2025-02-25 03:25:31.654339,2025-02-25 03:25:46.470211,14.815872
channel-85077,60194,30300003,30300013,10,2025-02-25 03:25:40.962097,2025-02-25 03:25:54.324547,13.36245
channel-85077,60195,30300004,30300020,16,2025-02-25 03:25:42.181389,2025-02-25 03:26:02.282317,20.100928
channel-85077,60196,30300013,30300023,10,2025-02-25 03:25:54.324547,2025-02-25 03:26:05.744628,11.420081
channel-85077,60197,30300026,30300043,17,2025-02-25 03:26:09.246615,2025-02-25 03:26:30.295617,21.049002
channel-85077,60198,30300027,30300043,16,2025-02-25 03:26:10.414575,2025-02-25 03:26:30.295617,19.881042
channel-85077,60199,30300029,30300040,11,2025-02-25 03:26:12.601789,2025-02-25 03:26:26.454001,13.852212
channel-85077,60200,30300053,30300063,10,2025-02-25 03:26:46.545669,2025-02-25 03:26:57.811503,11.265834
channel-85077,60201,30300064,30300078,14,2025-02-25 03:26:58.866654,2025-02-25 03:27:20.243300,21.376646
channel-85077,60202,30300101,30300111,10,2025-02-25 03:27:50.498556,2025-02-25 03:28:04.540065,14.041509
channel-85077,60203,30300107,30300117,10,2025-02-25 03:27:59.479781,2025-02-25 03:28:11.952002,12.472221
channel-85077,60204,30300110,30300121,11,2025-02-25 03:28:03.339583,2025-02-25 03:28:16.601310,13.261727
channel-85077,60205,30300116,30300126,10,2025-02-25 03:28:10.905873,2025-02-25 03:28:23.513836,12.607963
channel-85077,60206,30300152,30300161,9,2025-02-25 03:28:56.090321,2025-02-25 03:29:09.702351,13.61203
channel-85077,60207,30300161,30300172,11,2025-02-25 03:29:09.702351,2025-02-25 03:29:22.496594,12.794243
channel-85077,60208,30300163,30300178,15,2025-02-25 03:29:12.020875,2025-02-25 03:29:32.235934,20.215059
channel-85077,60209,30300173,30300181,8,2025-02-25 03:29:23.598994,2025-02-25 03:29:35.573537,11.974543
channel-85077,60210,30300253,30300261,8,2025-02-25 03:31:05.721888,2025-02-25 03:31:15.912749,10.190861
channel-85077,60211,30300304,30300311,7,2025-02-25 03:32:21.101160,2025-02-25 03:32:29.381508,8.280348
channel-85077,60212,30300361,30300371,10,2025-02-25 03:33:34.203681,2025-02-25 03:33:46.951772,12.748091
channel-85077,60213,30300616,30300629,13,2025-02-25 03:39:12.857838,2025-02-25 03:39:28.440276,15.582438
channel-85077,60214,30300618,30300629,11,2025-02-25 03:39:15.034904,2025-02-25 03:39:28.440276,13.405372
channel-85077,60215,30300625,30300634,9,2025-02-25 03:39:22.888090,2025-02-25 03:39:35.325868,12.437778
channel-85077,60216,30300633,30300642,9,2025-02-25 03:39:34.234843,2025-02-25 03:39:44.549575,10.314732
channel-85077,60217,30300874,30300882,8,2025-02-25 03:44:50.556644,2025-02-25 03:45:00.543590,9.986946
channel-85077,60218,30301006,30301018,12,2025-02-25 03:47:43.243646,2025-02-25 03:47:58.356759,15.113113
channel-85077,60219,30301313,30301336,23,2025-02-25 03:54:24.811797,2025-02-25 03:54:57.289783,32.477986
channel-85077,60220,30301336,30301346,10,2025-02-25 03:54:57.289783,2025-02-25 03:55:08.684794,11.395011
channel-85077,60221,30301553,30301562,9,2025-02-25 03:59:36.466524,2025-02-25 03:59:48.406474,11.93995
channel-85077,60222,30302188,30302200,12,2025-02-25 04:13:15.416353,2025-02-25 04:13:30.336160,14.919807
channel-85077,60223,30302551,30302561,10,2025-02-25 04:21:01.508675,2025-02-25 04:21:13.547322,12.038647
channel-85077,60224,30302692,30302703,11,2025-02-25 04:24:06.236672,2025-02-25 04:24:21.556470,15.319798
channel-85077,60225,30302795,30302807,12,2025-02-25 04:26:21.338982,2025-02-25 04:26:35.183028,13.844046
channel-85077,60226,30302812,30302821,9,2025-02-25 04:26:43.745683,2025-02-25 04:26:53.967614,10.221931
channel-85077,60227,30302819,30302829,10,2025-02-25 04:26:51.682675,2025-02-25 04:27:05.221310,13.538635
channel-85077,60228,30302830,30302836,6,2025-02-25 04:27:06.735706,2025-02-25 04:27:14.037020,7.301314
channel-85077,60229,30303309,30303318,9,2025-02-25 04:37:23.612787,2025-02-25 04:37:35.048814,11.436027
channel-85077,60230,30303371,30303381,10,2025-02-25 04:38:42.595810,2025-02-25 04:38:55.919773,13.323963
channel-85077,60231,30303399,30303408,9,2025-02-25 04:39:21.978092,2025-02-25 04:39:33.942574,11.964482
channel-85077,60232,30303563,30303571,8,2025-02-25 04:42:50.174192,2025-02-25 04:43:00.177560,10.003368
channel-85077,60233,30303588,30303597,9,2025-02-25 04:43:22.246154,2025-02-25 04:43:32.992673,10.746519
channel-85077,60234,30303650,30303661,11,2025-02-25 04:44:47.135845,2025-02-25 04:44:59.653966,12.518121
channel-85077,60235,30304041,30304049,8,2025-02-25 04:53:06.282338,2025-02-25 04:53:17.242386,10.960048
channel-85077,60236,30304073,30304080,7,2025-02-25 04:53:47.791004,2025-02-25 04:53:58.148560,10.357556
channel-85077,60237,30304164,30304172,8,2025-02-25 04:55:45.351744,2025-02-25 04:55:57.016397,11.664653
channel-85077,60238,30304175,30304184,9,2025-02-25 04:56:00.559838,2025-02-25 04:56:10.807595,10.247757
channel-85077,60239,30304234,30304244,10,2025-02-25 04:57:16.587216,2025-02-25 04:57:28.032452,11.445236
channel-85077,60240,30304237,30304249,12,2025-02-25 04:57:19.940133,2025-02-25 04:57:33.863681,13.923548
channel-85077,60241,30304280,30304289,9,2025-02-25 04:58:16.103177,2025-02-25 04:58:26.651959,10.548782
channel-85077,60242,30304377,30304399,22,2025-02-25 05:00:20.156565,2025-02-25 05:00:48.305922,28.149357
channel-85077,60243,30304602,30304621,19,2025-02-25 05:05:12.220413,2025-02-25 05:05:34.940031,22.719618
channel-85077,60244,30304773,30304784,11,2025-02-25 05:08:52.212054,2025-02-25 05:09:04.831814,12.61976
channel-85077,60245,30304784,30304793,9,2025-02-25 05:09:04.831814,2025-02-25 05:09:18.423486,13.591672
channel-85077,60246,30304789,30304800,11,2025-02-25 05:09:13.286801,2025-02-25 05:09:27.512302,14.225501
channel-85077,60247,30304868,30304877,9,2025-02-25 05:10:57.168244,2025-02-25 05:11:07.599233,10.430989
channel-85077,60248,30305077,30305087,10,2025-02-25 05:15:34.156776,2025-02-25 05:15:46.940535,12.783759
channel-85077,60249,30305081,30305096,15,2025-02-25 05:15:39.963941,2025-02-25 05:15:58.121424,18.157483
channel-85077,60250,30305127,30305150,23,2025-02-25 05:16:40.093791,2025-02-25 05:17:08.272639,28.178848
channel-85077,60251,30305186,30305197,11,2025-02-25 05:17:53.131997,2025-02-25 05:18:06.113077,12.98108
channel-85077,60252,30305288,30305304,16,2025-02-25 05:20:06.740833,2025-02-25 05:20:29.980105,23.239272
channel-85077,60253,30305328,30305338,10,2025-02-25 05:21:02.155421,2025-02-25 05:21:14.938279,12.782858
channel-85077,60254,30305451,30305462,11,2025-02-25 05:23:38.519272,2025-02-25 05:23:51.067333,12.548061
channel-85077,60255,30305488,30305498,10,2025-02-25 05:24:29.951573,2025-02-25 05:24:41.702117,11.750544
channel-85077,60256,30305505,30305512,7,2025-02-25 05:24:49.537242,2025-02-25 05:24:58.972830,9.435588
channel-85077,60257,30305566,30305576,10,2025-02-25 05:26:10.808529,2025-02-25 05:26:22.564329,11.7558
channel-85077,60258,30305568,30305590,22,2025-02-25 05:26:13.044532,2025-02-25 05:26:41.066361,28.021829
channel-85077,60259,30305758,30305767,9,2025-02-25 05:30:15.281209,2025-02-25 05:30:28.355237,13.074028
channel-85077,60260,30306121,30306131,10,2025-02-25 05:38:06.745887,2025-02-25 05:38:17.856185,11.110298
channel-85077,60261,30306248,30306258,10,2025-02-25 05:40:47.695065,2025-02-25 05:40:59.040296,11.345231
channel-85077,60262,30306329,30306338,9,2025-02-25 05:42:32.106293,2025-02-25 05:42:46.386039,14.279746
channel-85077,60263,30306394,30306403,9,2025-02-25 05:43:56.750934,2025-02-25 05:44:07.157445,10.406511
channel-85077,60264,30306403,30306412,9,2025-02-25 05:44:07.157445,2025-02-25 05:44:18.214803,11.057358
channel-85077,60265,30306466,30306476,10,2025-02-25 05:45:29.509858,2025-02-25 05:45:41.418738,11.90888
channel-85077,60266,30306550,30306557,7,2025-02-25 05:47:19.138236,2025-02-25 05:47:29.146962,10.008726
channel-85077,60267,30306604,30306615,11,2025-02-25 05:48:29.141695,2025-02-25 05:48:41.755910,12.614215
channel-85077,60268,30306715,30306723,8,2025-02-25 05:50:50.116488,2025-02-25 05:51:03.735637,13.619149
channel-85077,60269,30306768,30306777,9,2025-02-25 05:52:03.153557,2025-02-25 05:52:15.796738,12.643181
channel-85077,60270,30306874,30306883,9,2025-02-25 05:54:19.696190,2025-02-25 05:54:30.349236,10.653046
channel-85077,60271,30306932,30306942,10,2025-02-25 05:55:30.947675,2025-02-25 05:55:47.791391,16.843716
channel-85077,60272,30306933,30306942,9,2025-02-25 05:55:31.998162,2025-02-25 05:55:47.791391,15.793229
channel-85077,60273,30306936,30306945,9,2025-02-25 05:55:39.678313,2025-02-25 05:55:51.297390,11.619077
channel-85077,60274,30306940,30306951,11,2025-02-25 05:55:45.665761,2025-02-25 05:55:58.389106,12.723345
channel-85077,60275,30306947,30306956,9,2025-02-25 05:55:53.573261,2025-02-25 05:56:04.894310,11.321049
channel-85077,60276,30306957,30306965,8,2025-02-25 05:56:05.994892,2025-02-25 05:56:16.743362,10.74847
channel-85077,60277,30307045,30307056,11,2025-02-25 05:58:02.646492,2025-02-25 05:58:15.521410,12.874918
channel-85077,60278,30307075,30307085,10,2025-02-25 05:58:44.043084,2025-02-25 05:58:56.956574,12.91349
channel-85077,60279,30307132,30307139,7,2025-02-25 05:59:55.964945,2025-02-25 06:00:05.340486,9.375541
channel-85077,60280,30307157,30307165,8,2025-02-25 06:00:33.457844,2025-02-25 06:00:43.105764,9.64792
channel-85077,60281,30307214,30307225,11,2025-02-25 06:01:47.514898,2025-02-25 06:02:01.517283,14.002385
channel-85077,60282,30307394,30307404,10,2025-02-25 06:05:43.175794,2025-02-25 06:05:56.372515,13.196721
channel-85077,60283,30307449,30307456,7,2025-02-25 06:06:52.012760,2025-02-25 06:07:02.402897,10.390137
channel-85077,60284,30307517,30307526,9,2025-02-25 06:08:19.482922,2025-02-25 06:08:30.919951,11.437029
channel-85077,60285,30307534,30307540,6,2025-02-25 06:08:40.693653,2025-02-25 06:08:50.104205,9.410552
channel-85077,60286,30307588,30307598,10,2025-02-25 06:09:51.519372,2025-02-25 06:10:06.110426,14.591054
channel-85077,60287,30307598,30307609,11,2025-02-25 06:10:06.110426,2025-02-25 06:10:19.783440,13.673014
channel-85077,60288,30307732,30307741,9,2025-02-25 06:13:00.194030,2025-02-25 06:13:12.723270,12.52924
channel-85077,60289,30307735,30307744,9,2025-02-25 06:13:04.754896,2025-02-25 06:13:16.711918,11.957022
channel-85077,60290,30307753,30307758,5,2025-02-25 06:13:28.296752,2025-02-25 06:13:37.767568,9.470816
channel-85077,60291,30307757,30307766,9,2025-02-25 06:13:32.886297,2025-02-25 06:13:48.326472,15.440175
channel-85077,60292,30307761,30307769,8,2025-02-25 06:13:41.570643,2025-02-25 06:13:51.740467,10.169824
channel-85077,60293,30307772,30307782,10,2025-02-25 06:13:55.042713,2025-02-25 06:14:06.461693,11.41898
channel-85077,60294,30307800,30307810,10,2025-02-25 06:14:30.176062,2025-02-25 06:14:44.349394,14.173332
channel-85077,60295,30307803,30307813,10,2025-02-25 06:14:35.426509,2025-02-25 06:14:47.949230,12.522721
channel-85077,60296,30307831,30307838,7,2025-02-25 06:15:09.216795,2025-02-25 06:15:18.446790,9.229995
channel-85077,60297,30307915,30307923,8,2025-02-25 06:16:56.986355,2025-02-25 06:17:07.711557,10.725202
channel-85077,60298,30307975,30307983,8,2025-02-25 06:18:16.128011,2025-02-25 06:18:28.225738,12.097727
channel-85077,60299,30307977,30307985,8,2025-02-25 06:18:18.551999,2025-02-25 06:18:30.540378,11.988379
channel-85077,60300,30307977,30307985,8,2025-02-25 06:18:18.551999,2025-02-25 06:18:30.540378,11.988379
channel-85077,60301,30308013,30308022,9,2025-02-25 06:19:03.591175,2025-02-25 06:19:15.222192,11.631017
channel-85077,60302,30308032,30308040,8,2025-02-25 06:19:29.557711,2025-02-25 06:19:38.794220,9.236509
channel-85077,60303,30308057,30308065,8,2025-02-25 06:19:59.625882,2025-02-25 06:20:11.601087,11.975205
channel-85077,60304,30308065,30308074,9,2025-02-25 06:20:11.601087,2025-02-25 06:20:21.604647,10.00356
channel-85077,60305,30308104,30308113,9,2025-02-25 06:20:59.526754,2025-02-25 06:21:11.198355,11.671601
channel-85077,60306,30308154,30308163,9,2025-02-25 06:22:03.647843,2025-02-25 06:22:14.368760,10.720917
channel-85077,60307,30308175,30308186,11,2025-02-25 06:22:30.009253,2025-02-25 06:22:47.096531,17.087278
channel-85077,60308,30308179,30308188,9,2025-02-25 06:22:38.052869,2025-02-25 06:22:50.038970,11.986101
channel-85077,60309,30308241,30308260,19,2025-02-25 06:23:56.832622,2025-02-25 06:24:22.813624,25.981002
channel-85077,60310,30308263,30308270,7,2025-02-25 06:24:26.185802,2025-02-25 06:24:35.160372,8.97457
channel-85077,60311,30308441,30308451,10,2025-02-25 06:28:14.160420,2025-02-25 06:28:25.338746,11.178326
channel-85077,60312,30308459,30308467,8,2025-02-25 06:28:36.400537,2025-02-25 06:28:46.551020,10.150483
channel-85077,60313,30308469,30308479,10,2025-02-25 06:28:50.206098,2025-02-25 06:29:01.954174,11.748076
channel-85077,60314,30308472,30308482,10,2025-02-25 06:28:53.663792,2025-02-25 06:29:05.397009,11.733217
channel-85077,60315,30308579,30308588,9,2025-02-25 06:31:12.100594,2025-02-25 06:31:26.197827,14.097233
channel-85077,60316,30308597,30308605,8,2025-02-25 06:31:41.575733,2025-02-25 06:31:50.421969,8.846236
channel-85077,60317,30308610,30308624,14,2025-02-25 06:31:57.631580,2025-02-25 06:32:14.583969,16.952389
channel-85077,60318,30308636,30308650,14,2025-02-25 06:32:28.523096,2025-02-25 06:32:45.938531,17.415435
channel-85077,60319,30308699,30308706,7,2025-02-25 06:33:47.000589,2025-02-25 06:33:56.321027,9.320438
channel-85077,60320,30308721,30308730,9,2025-02-25 06:34:16.490433,2025-02-25 06:34:28.988104,12.497671
channel-85077,60321,30308801,30308809,8,2025-02-25 06:35:58.613069,2025-02-25 06:36:12.799660,14.186591
channel-85077,60322,30308854,30308866,12,2025-02-25 06:37:12.368363,2025-02-25 06:37:26.379629,14.011266
channel-85077,60323,30308862,30308879,17,2025-02-25 06:37:21.760982,2025-02-25 06:37:42.525875,20.764893
channel-85077,60324,30308870,30308879,9,2025-02-25 06:37:30.956470,2025-02-25 06:37:42.525875,11.569405
channel-85077,60325,30308901,30308913,12,2025-02-25 06:38:12.795465,2025-02-25 06:38:26.336642,13.541177
channel-85077,60326,30309002,30309022,20,2025-02-25 06:40:18.921172,2025-02-25 06:40:48.858994,29.937822
channel-85077,60327,30309035,30309047,12,2025-02-25 06:41:04.533878,2025-02-25 06:41:20.441739,15.907861
channel-85077,60328,30309036,30309047,11,2025-02-25 06:41:06.750366,2025-02-25 06:41:20.441739,13.691373
channel-85077,60329,30309099,30309107,8,2025-02-25 06:42:25.356779,2025-02-25 06:42:39.755502,14.398723
channel-85077,60330,30309118,30309125,7,2025-02-25 06:42:53.206064,2025-02-25 06:43:01.054374,7.84831
channel-85077,60331,30309152,30309170,18,2025-02-25 06:43:35.592413,2025-02-25 06:43:56.513870,20.921457
channel-85077,60332,30309181,30309191,10,2025-02-25 06:44:10.785996,2025-02-25 06:44:24.769275,13.983279
channel-85077,60333,30309202,30309210,8,2025-02-25 06:44:38.463499,2025-02-25 06:44:49.727937,11.264438
channel-85077,60334,30309222,30309231,9,2025-02-25 06:45:07.257579,2025-02-25 06:45:17.416460,10.158881
channel-85077,60335,30309239,30309248,9,2025-02-25 06:45:29.274880,2025-02-25 06:45:43.529592,14.254712
channel-85077,60336,30309257,30309268,11,2025-02-25 06:45:54.380484,2025-02-25 06:46:07.228414,12.84793
channel-85077,60337,30309274,30309288,14,2025-02-25 06:46:15.073440,2025-02-25 06:46:34.348640,19.2752
channel-85077,60338,30309325,30309333,8,2025-02-25 06:47:19.784823,2025-02-25 06:47:30.995935,11.211112
channel-85077,60339,30309348,30309358,10,2025-02-25 06:47:49.987321,2025-02-25 06:48:03.223830,13.236509
channel-85077,60340,30309363,30309375,12,2025-02-25 06:48:08.994031,2025-02-25 06:48:24.118585,15.124554
channel-85077,60341,30309365,30309375,10,2025-02-25 06:48:12.820423,2025-02-25 06:48:24.118585,11.298162
channel-85077,60342,30309374,30309382,8,2025-02-25 06:48:22.968985,2025-02-25 06:48:35.768089,12.799104
channel-85077,60343,30309378,30309387,9,2025-02-25 06:48:28.057946,2025-02-25 06:48:41.555767,13.497821
channel-85077,60344,30309404,30309412,8,2025-02-25 06:49:02.045394,2025-02-25 06:49:12.944390,10.898996
channel-85077,60345,30309416,30309425,9,2025-02-25 06:49:17.371870,2025-02-25 06:49:30.827314,13.455444
channel-85077,60346,30309420,30309427,7,2025-02-25 06:49:21.913106,2025-02-25 06:49:34.241230,12.328124
channel-85077,60347,30309468,30309477,9,2025-02-25 06:50:29.290749,2025-02-25 06:50:40.227447,10.936698
channel-85077,60348,30309487,30309498,11,2025-02-25 06:50:52.738890,2025-02-25 06:51:06.028625,13.289735
channel-85077,60349,30309541,30309559,18,2025-02-25 06:52:02.232808,2025-02-25 06:52:22.877916,20.645108
channel-85077,60350,30309545,30309559,14,2025-02-25 06:52:06.573275,2025-02-25 06:52:22.877916,16.304641
channel-85077,60351,30309546,30309559,13,2025-02-25 06:52:07.981975,2025-02-25 06:52:22.877916,14.895941
channel-85077,60352,30309595,30309607,12,2025-02-25 06:53:10.586194,2025-02-25 06:53:24.782141,14.195947
channel-85077,60353,30309636,30309644,8,2025-02-25 06:54:04.613809,2025-02-25 06:54:17.317474,12.703665
channel-85077,60354,30309636,30309644,8,2025-02-25 06:54:04.613809,2025-02-25 06:54:17.317474,12.703665
channel-85077,60355,30309638,30309650,12,2025-02-25 06:54:06.771099,2025-02-25 06:54:24.174270,17.403171
channel-85077,60356,30309651,30309661,10,2025-02-25 06:54:25.385148,2025-02-25 06:54:38.226332,12.841184
channel-85077,60357,30309671,30309683,12,2025-02-25 06:54:51.863004,2025-02-25 06:55:06.472563,14.609559
channel-85077,60358,30309680,30309692,12,2025-02-25 06:55:02.996619,2025-02-25 06:55:17.211545,14.214926
channel-85077,60359,30309681,30309702,21,2025-02-25 06:55:04.064523,2025-02-25 06:55:28.304061,24.239538
channel-85077,60360,30309691,30309709,18,2025-02-25 06:55:16.059982,2025-02-25 06:55:37.812964,21.752982
channel-85077,60361,30309695,30309709,14,2025-02-25 06:55:20.410826,2025-02-25 06:55:37.812964,17.402138
channel-85077,60362,30309702,30309720,18,2025-02-25 06:55:28.304061,2025-02-25 06:55:52.009003,23.704942
channel-85077,60363,30309797,30309807,10,2025-02-25 06:57:30.693025,2025-02-25 06:57:44.548815,13.85579
channel-85077,60364,30309831,30309842,11,2025-02-25 06:58:13.677715,2025-02-25 06:58:27.535606,13.857891
channel-85077,60365,30309836,30309845,9,2025-02-25 06:58:20.307146,2025-02-25 06:58:30.970565,10.663419
channel-85077,60366,30309856,30309864,8,2025-02-25 06:58:47.212697,2025-02-25 06:58:58.298704,11.086007
channel-85077,60367,30309861,30309874,13,2025-02-25 06:58:53.788800,2025-02-25 06:59:12.996418,19.207618
channel-85077,60368,30309865,30309874,9,2025-02-25 06:58:59.449845,2025-02-25 06:59:12.996418,13.546573
channel-85077,60369,30309869,30309880,11,2025-02-25 06:59:06.359213,2025-02-25 06:59:20.203232,13.844019
channel-85077,60370,30309875,30309885,10,2025-02-25 06:59:14.292940,2025-02-25 06:59:25.743707,11.450767
channel-85077,60371,30309879,30309888,9,2025-02-25 06:59:19.071965,2025-02-25 06:59:30.807518,11.735553
channel-85077,60372,30309985,30309996,11,2025-02-25 07:01:36.565469,2025-02-25 07:01:50.400349,13.83488
channel-85077,60373,30310007,30310015,8,2025-02-25 07:02:04.187431,2025-02-25 07:02:14.756150,10.568719
channel-85077,60374,30310010,30310021,11,2025-02-25 07:02:09.003671,2025-02-25 07:02:22.568176,13.564505
channel-85077,60375,30310057,30310066,9,2025-02-25 07:03:08.423772,2025-02-25 07:03:24.386372,15.9626
channel-85077,60376,30310071,30310079,8,2025-02-25 07:03:31.771623,2025-02-25 07:03:41.832950,10.061327
channel-85077,60377,30310101,30310119,18,2025-02-25 07:04:08.548787,2025-02-25 07:04:31.399381,22.850594
channel-85077,60378,30310132,30310143,11,2025-02-25 07:04:49.308726,2025-02-25 07:05:02.972419,13.663693
channel-85077,60379,30310138,30310148,10,2025-02-25 07:04:56.822933,2025-02-25 07:05:11.616962,14.794029
channel-85077,60380,30310171,30310181,10,2025-02-25 07:05:39.710798,2025-02-25 07:05:52.347198,12.6364
channel-85077,60381,30310185,30310196,11,2025-02-25 07:05:57.041950,2025-02-25 07:06:09.606889,12.564939
channel-85077,60382,30310187,30310198,11,2025-02-25 07:05:59.349833,2025-02-25 07:06:12.039828,12.689995
channel-85077,60383,30310190,30310205,15,2025-02-25 07:06:02.621645,2025-02-25 07:06:22.176896,19.555251
channel-85077,60384,30310224,30310231,7,2025-02-25 07:06:46.397169,2025-02-25 07:06:58.555257,12.158088
channel-85077,60385,30310267,30310277,10,2025-02-25 07:07:49.406090,2025-02-25 07:08:02.807416,13.401326
channel-85077,60386,30310273,30310283,10,2025-02-25 07:07:58.427651,2025-02-25 07:08:09.729791,11.30214
channel-85077,60387,30310311,30310320,9,2025-02-25 07:08:46.323782,2025-02-25 07:08:59.584255,13.260473
channel-85077,60388,30310342,30310353,11,2025-02-25 07:09:27.474920,2025-02-25 07:09:41.634099,14.159179
channel-85077,60389,30310407,30310414,7,2025-02-25 07:10:50.804784,2025-02-25 07:11:01.628067,10.823283
channel-85077,60390,30310429,30310438,9,2025-02-25 07:11:19.590423,2025-02-25 07:11:33.076569,13.486146
channel-85077,60391,30310429,30310438,9,2025-02-25 07:11:19.590423,2025-02-25 07:11:33.076569,13.486146
channel-85077,60392,30310472,30310485,13,2025-02-25 07:12:18.397184,2025-02-25 07:12:33.393307,14.996123
channel-85077,60393,30310506,30310518,12,2025-02-25 07:13:02.308138,2025-02-25 07:13:16.257590,13.949452
channel-85077,60394,30310508,30310519,11,2025-02-25 07:13:04.526374,2025-02-25 07:13:17.319946,12.793572
channel-85077,60395,30310540,30310549,9,2025-02-25 07:13:42.910501,2025-02-25 07:13:56.367613,13.457112
channel-85077,60396,30310559,30310569,10,2025-02-25 07:14:07.901566,2025-02-25 07:14:19.771152,11.869586
channel-85077,60397,30310576,30310585,9,2025-02-25 07:14:30.124413,2025-02-25 07:14:42.257914,12.133501
channel-85077,60398,30310638,30310648,10,2025-02-25 07:15:49.860694,2025-02-25 07:16:02.338494,12.4778
channel-85077,60399,30310671,30310680,9,2025-02-25 07:16:33.525270,2025-02-25 07:16:48.491442,14.966172
channel-85077,60400,30310675,30310683,8,2025-02-25 07:16:41.456941,2025-02-25 07:16:52.210357,10.753416
channel-85077,60401,30310746,30310756,10,2025-02-25 07:18:12.962219,2025-02-25 07:18:26.727152,13.764933
channel-85077,60402,30310794,30310805,11,2025-02-25 07:19:16.083842,2025-02-25 07:19:30.023952,13.94011
channel-85077,60403,30310817,30310828,11,2025-02-25 07:19:44.087021,2025-02-25 07:19:57.994231,13.90721
channel-85077,60404,30310879,30310890,11,2025-02-25 07:21:05.380660,2025-02-25 07:21:19.753643,14.372983
channel-85077,60405,30310890,30310900,10,2025-02-25 07:21:19.753643,2025-02-25 07:21:33.587919,13.834276
channel-85077,60406,30310980,30310989,9,2025-02-25 07:23:19.080821,2025-02-25 07:23:28.864378,9.783557
channel-85077,60407,30311033,30311046,13,2025-02-25 07:24:26.883392,2025-02-25 07:24:42.644274,15.760882
channel-85077,60408,30311045,30311055,10,2025-02-25 07:24:41.572157,2025-02-25 07:24:52.771403,11.199246
channel-85077,60409,30311066,30311077,11,2025-02-25 07:25:10.758575,2025-02-25 07:25:25.704722,14.946147
channel-85077,60410,30311072,30311086,14,2025-02-25 07:25:17.817908,2025-02-25 07:25:43.148919,25.331011
channel-85077,60411,30311093,30311101,8,2025-02-25 07:25:52.822997,2025-02-25 07:26:03.984520,11.161523
channel-85077,60412,30311103,30311119,16,2025-02-25 07:26:06.262423,2025-02-25 07:26:25.641563,19.37914
channel-85077,60413,30311122,30311133,11,2025-02-25 07:26:30.418136,2025-02-25 07:26:44.514835,14.096699
channel-85077,60414,30311127,30311142,15,2025-02-25 07:26:37.226960,2025-02-25 07:26:55.237183,18.010223
channel-85077,60415,30311171,30311183,12,2025-02-25 07:27:32.083210,2025-02-25 07:27:45.885357,13.802147
channel-85077,60416,30311512,30311520,8,2025-02-25 07:34:57.050681,2025-02-25 07:35:09.080665,12.029984
channel-85077,60417,30311525,30311537,12,2025-02-25 07:35:16.086013,2025-02-25 07:35:32.101370,16.015357
channel-85077,60418,30311526,30311539,13,2025-02-25 07:35:17.204805,2025-02-25 07:35:34.446451,17.241646
channel-85077,60419,30311539,30311552,13,2025-02-25 07:35:34.446451,2025-02-25 07:35:49.067336,14.620885
channel-85077,60420,30311542,30311560,18,2025-02-25 07:35:37.834930,2025-02-25 07:36:01.530498,23.695568
channel-85077,60421,30311543,30311555,12,2025-02-25 07:35:38.966592,2025-02-25 07:35:53.148389,14.181797
channel-85077,60422,30311553,30311564,11,2025-02-25 07:35:50.869140,2025-02-25 07:36:06.520265,15.651125
channel-85077,60423,30311588,30311597,9,2025-02-25 07:36:37.404701,2025-02-25 07:36:48.036585,10.631884
channel-85077,60424,30311623,30311652,29,2025-02-25 07:37:22.699895,2025-02-25 07:37:59.417514,36.717619
channel-85077,60425,30311641,30311658,17,2025-02-25 07:37:45.215510,2025-02-25 07:38:08.129991,22.914481
channel-85077,60426,30311652,30311662,10,2025-02-25 07:37:59.417514,2025-02-25 07:38:12.865710,13.448196
channel-85077,60427,30311758,30311767,9,2025-02-25 07:40:22.948406,2025-02-25 07:40:33.827242,10.878836
channel-85077,60428,30311781,30311791,10,2025-02-25 07:40:50.891566,2025-02-25 07:41:03.769951,12.878385
channel-85077,60429,30311788,30311796,8,2025-02-25 07:40:59.365397,2025-02-25 07:41:13.702364,14.336967
channel-85077,60430,30311849,30311861,12,2025-02-25 07:42:24.389813,2025-02-25 07:42:37.847956,13.458143
channel-85077,60431,30311928,30311937,9,2025-02-25 07:44:05.931666,2025-02-25 07:44:16.387632,10.455966
channel-85077,60432,30311958,30311966,8,2025-02-25 07:44:46.787944,2025-02-25 07:44:58.442456,11.654512
channel-85077,60433,30311994,30312003,9,2025-02-25 07:45:32.995133,2025-02-25 07:45:43.855139,10.860006
channel-85077,60434,30312018,30312029,11,2025-02-25 07:46:02.605409,2025-02-25 07:46:16.836149,14.23074
channel-85077,60435,30312029,30312040,11,2025-02-25 07:46:16.836149,2025-02-25 07:46:30.578544,13.742395
channel-85077,60436,30312052,30312061,9,2025-02-25 07:46:50.180005,2025-02-25 07:47:02.031294,11.851289
channel-85077,60437,30312124,30312131,7,2025-02-25 07:48:24.237053,2025-02-25 07:48:33.284318,9.047265
channel-85077,60438,30312134,30312153,19,2025-02-25 07:48:38.595984,2025-02-25 07:49:03.366325,24.770341
channel-85077,60439,30312135,30312145,10,2025-02-25 07:48:39.801219,2025-02-25 07:48:52.677080,12.875861
channel-85077,60440,30312138,30312147,9,2025-02-25 07:48:44.476583,2025-02-25 07:48:56.546426,12.069843
channel-85077,60441,30312139,30312149,10,2025-02-25 07:48:45.560513,2025-02-25 07:48:58.821486,13.260973
channel-85077,60442,30312147,30312158,11,2025-02-25 07:48:56.546426,2025-02-25 07:49:10.149114,13.602688
channel-85077,60443,30312154,30312163,9,2025-02-25 07:49:04.550132,2025-02-25 07:49:17.252458,12.702326
channel-85077,60444,30312154,30312163,9,2025-02-25 07:49:04.550132,2025-02-25 07:49:17.252458,12.702326
channel-85077,60445,30312210,30312220,10,2025-02-25 07:50:17.846006,2025-02-25 07:50:30.052208,12.206202
channel-85077,60446,30312238,30312247,9,2025-02-25 07:50:57.048024,2025-02-25 07:51:07.978005,10.929981
channel-85077,60447,30312257,30312268,11,2025-02-25 07:51:19.839676,2025-02-25 07:51:33.612289,13.772613
channel-85077,60448,30312290,30312300,10,2025-02-25 07:52:02.520326,2025-02-25 07:52:15.223116,12.70279
channel-85077,60449,30312322,30312334,12,2025-02-25 07:52:46.442520,2025-02-25 07:53:02.615562,16.173042
channel-85077,60450,30312327,30312350,23,2025-02-25 07:52:52.439914,2025-02-25 07:53:25.930632,33.490718
channel-85077,60451,30312331,30312341,10,2025-02-25 07:52:57.957552,2025-02-25 07:53:14.995483,17.037931
channel-85077,60452,30312332,30312350,18,2025-02-25 07:53:00.363394,2025-02-25 07:53:25.930632,25.567238
channel-85077,60453,30312358,30312369,11,2025-02-25 07:53:35.204701,2025-02-25 07:53:49.182057,13.977356
channel-85077,60454,30312492,30312503,11,2025-02-25 07:56:30.264106,2025-02-25 07:56:42.962746,12.69864
channel-85077,60455,30312599,30312609,10,2025-02-25 07:58:50.050741,2025-02-25 07:59:02.131858,12.081117
channel-85077,60456,30312603,30312611,8,2025-02-25 07:58:54.602138,2025-02-25 07:59:04.506024,9.903886
channel-85077,60457,30312608,30312620,12,2025-02-25 07:59:01.054797,2025-02-25 07:59:15.896590,14.841793
channel-85077,60458,30312636,30312643,7,2025-02-25 07:59:34.250648,2025-02-25 07:59:43.426285,9.175637
channel-85077,60459,30312640,30312659,19,2025-02-25 07:59:39.483730,2025-02-25 08:00:05.525992,26.042262
channel-85077,60460,30312725,30312739,14,2025-02-25 08:01:28.663328,2025-02-25 08:01:46.931593,18.268265
channel-85077,60461,30312775,30312784,9,2025-02-25 08:02:42.197671,2025-02-25 08:02:52.660393,10.462722
channel-85077,60462,30312778,30312787,9,2025-02-25 08:02:45.857492,2025-02-25 08:02:56.169836,10.312344
channel-85077,60463,30312823,30312831,8,2025-02-25 08:03:42.119456,2025-02-25 08:03:56.346882,14.227426
channel-85077,60464,30312847,30312872,25,2025-02-25 08:04:16.005739,2025-02-25 08:04:50.441859,34.43612
channel-85077,60465,30312849,30312860,11,2025-02-25 08:04:18.488576,2025-02-25 08:04:32.498821,14.010245
channel-85077,60466,30312903,30312930,27,2025-02-25 08:05:27.975415,2025-02-25 08:06:04.405745,36.43033
channel-85077,60467,30312928,30312938,10,2025-02-25 08:06:02.110633,2025-02-25 08:06:14.302359,12.191726
channel-85077,60468,30313019,30313029,10,2025-02-25 08:07:58.998102,2025-02-25 08:08:12.223225,13.225123
channel-85077,60469,30313024,30313035,11,2025-02-25 08:08:05.664473,2025-02-25 08:08:19.622648,13.958175
channel-85077,60470,30313045,30313055,10,2025-02-25 08:08:32.811363,2025-02-25 08:08:44.365453,11.55409
channel-85077,60471,30313048,30313057,9,2025-02-25 08:08:36.401096,2025-02-25 08:08:47.871656,11.47056
channel-85077,60472,30313053,30313068,15,2025-02-25 08:08:42.020145,2025-02-25 08:09:01.730289,19.710144
channel-85077,60473,30313147,30313157,10,2025-02-25 08:10:44.305375,2025-02-25 08:10:57.751811,13.446436
channel-85077,60474,30313182,30313192,10,2025-02-25 08:11:36.808870,2025-02-25 08:11:48.438023,11.629153
channel-85077,60475,30313253,30313261,8,2025-02-25 08:13:08.776308,2025-02-25 08:13:19.040008,10.2637
channel-85077,60476,30313257,30313265,8,2025-02-25 08:13:13.249222,2025-02-25 08:13:25.119971,11.870749
channel-85077,60477,30313285,30313299,14,2025-02-25 08:13:49.366521,2025-02-25 08:14:07.542713,18.176192
channel-85077,60478,30313314,30313326,12,2025-02-25 08:14:25.279275,2025-02-25 08:14:39.594768,14.315493
channel-85077,60479,30313355,30313365,10,2025-02-25 08:15:19.057847,2025-02-25 08:15:30.851861,11.794014
channel-85077,60480,30313393,30313401,8,2025-02-25 08:16:10.378429,2025-02-25 08:16:21.262192,10.883763
channel-85077,60481,30313458,30313466,8,2025-02-25 08:17:33.452775,2025-02-25 08:17:43.789734,10.336959
channel-85077,60482,30313477,30313487,10,2025-02-25 08:17:57.874704,2025-02-25 08:18:11.302986,13.428282
channel-85077,60483,30313585,30313610,25,2025-02-25 08:20:18.796945,2025-02-25 08:20:51.904249,33.107304
channel-85077,60484,30313608,30313616,8,2025-02-25 08:20:49.510935,2025-02-25 08:21:01.340955,11.83002
channel-85077,60485,30313641,30313652,11,2025-02-25 08:21:32.781284,2025-02-25 08:21:46.820004,14.03872
channel-85077,60486,30313643,30313652,9,2025-02-25 08:21:35.301425,2025-02-25 08:21:46.820004,11.518579
channel-85077,60487,30313654,30313665,11,2025-02-25 08:21:49.071564,2025-02-25 08:22:04.559213,15.487649
channel-85077,60488,30313655,30313668,13,2025-02-25 08:21:51.237370,2025-02-25 08:22:08.083908,16.846538
channel-85077,60489,30313656,30313668,12,2025-02-25 08:21:53.538284,2025-02-25 08:22:08.083908,14.545624
channel-85077,60490,30313731,30313740,9,2025-02-25 08:23:32.057606,2025-02-25 08:23:44.074060,12.016454
channel-85077,60491,30313733,30313744,11,2025-02-25 08:23:34.526382,2025-02-25 08:23:48.523367,13.996985
channel-85077,60492,30313816,30313824,8,2025-02-25 08:25:22.552541,2025-02-25 08:25:31.706070,9.153529
channel-85077,60493,30314028,30314036,8,2025-02-25 08:29:56.746933,2025-02-25 08:30:06.566221,9.819288
channel-85077,60494,30314067,30314075,8,2025-02-25 08:30:48.454669,2025-02-25 08:30:59.583106,11.128437
channel-85077,60495,30314080,30314089,9,2025-02-25 08:31:05.187044,2025-02-25 08:31:16.186102,10.999058
channel-85077,60496,30314084,30314095,11,2025-02-25 08:31:10.654898,2025-02-25 08:31:23.847056,13.192158
channel-85077,60497,30314094,30314112,18,2025-02-25 08:31:22.655224,2025-02-25 08:31:45.100683,22.445459
channel-85077,60498,30314125,30314137,12,2025-02-25 08:32:02.032622,2025-02-25 08:32:17.191697,15.159075
channel-85077,60499,30314174,30314184,10,2025-02-25 08:33:05.501203,2025-02-25 08:33:21.321081,15.819878
channel-85077,60500,30314238,30314249,11,2025-02-25 08:34:34.309585,2025-02-25 08:34:47.092145,12.78256
channel-85077,60501,30314247,30314260,13,2025-02-25 08:34:44.848158,2025-02-25 08:35:01.271888,16.42373
channel-85077,60502,30314258,30314268,10,2025-02-25 08:34:58.040444,2025-02-25 08:35:11.808695,13.768251
channel-85077,60503,30314259,30314268,9,2025-02-25 08:34:59.148368,2025-02-25 08:35:11.808695,12.660327
channel-85077,60504,30314275,30314285,10,2025-02-25 08:35:19.998794,2025-02-25 08:35:32.477765,12.478971
channel-85077,60505,30314279,30314288,9,2025-02-25 08:35:25.692807,2025-02-25 08:35:36.016519,10.323712
channel-85077,60506,30314319,30314328,9,2025-02-25 08:36:17.020251,2025-02-25 08:36:28.785070,11.764819
channel-85077,60507,30314362,30314394,32,2025-02-25 08:37:10.640875,2025-02-25 08:37:51.742884,41.102009
channel-85077,60508,30314394,30314426,32,2025-02-25 08:37:51.742884,2025-02-25 08:38:37.637313,45.894429
channel-85077,60509,30314399,30314430,31,2025-02-25 08:37:58.728782,2025-02-25 08:38:42.331903,43.603121
channel-85077,60510,30314412,30314436,24,2025-02-25 08:38:16.372092,2025-02-25 08:38:50.111736,33.739644
channel-85077,60511,30314427,30314443,16,2025-02-25 08:38:38.846225,2025-02-25 08:38:58.808936,19.962711
channel-85077,60512,30314434,30314459,25,2025-02-25 08:38:47.888693,2025-02-25 08:39:18.885309,30.996616
channel-85077,60513,30314457,30314467,10,2025-02-25 08:39:16.579749,2025-02-25 08:39:31.269068,14.689319
channel-85077,60514,30314463,30314473,10,2025-02-25 08:39:25.695048,2025-02-25 08:39:38.248243,12.553195
channel-85077,60515,30314467,30314476,9,2025-02-25 08:39:31.269068,2025-02-25 08:39:41.726398,10.45733
channel-85077,60516,30314918,30314929,11,2025-02-25 08:49:16.279249,2025-02-25 08:49:29.487568,13.208319
channel-85077,60517,30315059,30315067,8,2025-02-25 08:52:18.535298,2025-02-25 08:52:28.912207,10.376909
channel-85077,60518,30316213,30316224,11,2025-02-25 09:17:33.603297,2025-02-25 09:17:47.838127,14.23483
channel-85077,60519,30316336,30316344,8,2025-02-25 09:20:12.390940,2025-02-25 09:20:22.349209,9.958269
channel-85077,60520,30316428,30316437,9,2025-02-25 09:22:13.440394,2025-02-25 09:22:25.035243,11.594849
channel-85077,60521,30316468,30316476,8,2025-02-25 09:23:06.555773,2025-02-25 09:23:17.064441,10.508668
channel-85077,60522,30316491,30316501,10,2025-02-25 09:23:40.332975,2025-02-25 09:23:52.093992,11.761017
channel-85077,60523,30316627,30316635,8,2025-02-25 09:26:35.108030,2025-02-25 09:26:45.900870,10.79284
channel-85077,60524,30316666,30316674,8,2025-02-25 09:27:27.903122,2025-02-25 09:27:37.993783,10.090661
channel-85077,60525,30316933,30316945,12,2025-02-25 09:33:21.490484,2025-02-25 09:33:35.354661,13.864177
channel-85077,60526,30316942,30316953,11,2025-02-25 09:33:31.784634,2025-02-25 09:33:45.840774,14.05614
channel-85077,60527,30317028,30317037,9,2025-02-25 09:35:25.028657,2025-02-25 09:35:35.007890,9.979233
channel-85077,60528,30317424,30317435,11,2025-02-25 09:44:01.469421,2025-02-25 09:44:17.922813,16.453392
channel-85077,60529,30317753,30317763,10,2025-02-25 09:51:12.577281,2025-02-25 09:51:24.247675,11.670394
channel-85077,60530,30317761,30317769,8,2025-02-25 09:51:21.844866,2025-02-25 09:51:35.561356,13.71649
channel-85077,60531,30317917,30317927,10,2025-02-25 09:54:54.718990,2025-02-25 09:55:06.336955,11.617965
channel-85077,60532,30317943,30317951,8,2025-02-25 09:55:30.720762,2025-02-25 09:55:43.875202,13.15444
channel-85077,60533,30317966,30317978,12,2025-02-25 09:56:02.417023,2025-02-25 09:56:17.428801,15.011778
channel-85077,60534,30318018,30318031,13,2025-02-25 09:57:12.678168,2025-02-25 09:57:29.850429,17.172261
channel-85077,60535,30318026,30318034,8,2025-02-25 09:57:24.209180,2025-02-25 09:57:34.329395,10.120215
channel-85077,60536,30318033,30318066,33,2025-02-25 09:57:32.182161,2025-02-25 09:58:18.018696,45.836535
channel-85077,60537,30318034,30318042,8,2025-02-25 09:57:34.329395,2025-02-25 09:57:47.296816,12.967421
channel-85077,60538,30318041,30318066,25,2025-02-25 09:57:46.166176,2025-02-25 09:58:18.018696,31.85252
channel-85077,60539,30318078,30318086,8,2025-02-25 09:58:31.807247,2025-02-25 09:58:46.016498,14.209251
channel-85077,60540,30318085,30318094,9,2025-02-25 09:58:44.671365,2025-02-25 09:58:56.428909,11.757544
channel-85077,60541,30318091,30318100,9,2025-02-25 09:58:52.970434,2025-02-25 09:59:04.257398,11.286964
channel-85077,60542,30318094,30318104,10,2025-02-25 09:58:56.428909,2025-02-25 09:59:08.750233,12.321324
channel-85077,60543,30318175,30318181,6,2025-02-25 10:00:47.643609,2025-02-25 10:00:56.705961,9.062352
channel-85077,60544,30318179,30318191,12,2025-02-25 10:00:54.429722,2025-02-25 10:01:08.604711,14.174989
channel-85077,60545,30318210,30318219,9,2025-02-25 10:01:35.449618,2025-02-25 10:01:47.365476,11.915858
channel-85077,60546,30318226,30318241,15,2025-02-25 10:01:57.016275,2025-02-25 10:02:18.810986,21.794711
channel-85077,60547,30318233,30318247,14,2025-02-25 10:02:08.577275,2025-02-25 10:02:26.713498,18.136223
channel-85077,60548,30318233,30318247,14,2025-02-25 10:02:08.577275,2025-02-25 10:02:26.713498,18.136223
channel-85077,60549,30318306,30318315,9,2025-02-25 10:03:44.935606,2025-02-25 10:03:57.051214,12.115608
channel-85077,60550,30318326,30318335,9,2025-02-25 10:04:10.712113,2025-02-25 10:04:21.477844,10.765731
channel-85077,60551,30318335,30318343,8,2025-02-25 10:04:21.477844,2025-02-25 10:04:31.865058,10.387214
channel-85077,60552,30318411,30318419,8,2025-02-25 10:06:05.117974,2025-02-25 10:06:18.040010,12.922036
channel-85077,60553,30318466,30318474,8,2025-02-25 10:07:23.114935,2025-02-25 10:07:35.455216,12.340281
channel-85077,60554,30318498,30318509,11,2025-02-25 10:08:04.773720,2025-02-25 10:08:17.505303,12.731583
channel-85077,60555,30318517,30318528,11,2025-02-25 10:08:27.737430,2025-02-25 10:08:41.325008,13.587578
channel-85077,60556,30318522,30318531,9,2025-02-25 10:08:34.497427,2025-02-25 10:08:45.808269,11.310842
channel-85077,60557,30318585,30318611,26,2025-02-25 10:10:09.442271,2025-02-25 10:10:41.508428,32.066157
channel-85077,60558,30318589,30318600,11,2025-02-25 10:10:14.020840,2025-02-25 10:10:28.108147,14.087307
channel-85077,60559,30318644,30318656,12,2025-02-25 10:11:24.222054,2025-02-25 10:11:40.440635,16.218581
channel-85077,60560,30318676,30318686,10,2025-02-25 10:12:07.043697,2025-02-25 10:12:19.215083,12.171386
channel-85077,60561,30318781,30318798,17,2025-02-25 10:14:25.947670,2025-02-25 10:14:50.497423,24.549753
channel-85077,60562,30318817,30318828,11,2025-02-25 10:15:21.180657,2025-02-25 10:15:33.954677,12.77402
channel-85077,60563,30318946,30318957,11,2025-02-25 10:18:12.686468,2025-02-25 10:18:27.563219,14.876751
channel-85077,60564,30318949,30318970,21,2025-02-25 10:18:16.112334,2025-02-25 10:18:46.279080,30.166746
channel-85077,60565,30318970,30318989,19,2025-02-25 10:18:46.279080,2025-02-25 10:19:10.639085,24.360005
channel-85077,60566,30318996,30319005,9,2025-02-25 10:19:19.805255,2025-02-25 10:19:34.783301,14.978046
channel-85077,60567,30319012,30319022,10,2025-02-25 10:19:43.506635,2025-02-25 10:19:54.859375,11.35274
channel-85077,60568,30319096,30319105,9,2025-02-25 10:21:37.012587,2025-02-25 10:21:50.020576,13.007989
channel-85077,60569,30319098,30319105,7,2025-02-25 10:21:39.532008,2025-02-25 10:21:50.020576,10.488568
channel-85077,60570,30319122,30319132,10,2025-02-25 10:22:11.422664,2025-02-25 10:22:23.059128,11.636464
channel-85077,60571,30319125,30319134,9,2025-02-25 10:22:15.164446,2025-02-25 10:22:25.249418,10.084972
channel-85077,60572,30319164,30319175,11,2025-02-25 10:23:08.143226,2025-02-25 10:23:25.204379,17.061153
channel-85077,60573,30319164,30319175,11,2025-02-25 10:23:08.143226,2025-02-25 10:23:25.204379,17.061153
channel-85077,60574,30319193,30319200,7,2025-02-25 10:23:47.851163,2025-02-25 10:24:00.018564,12.167401
channel-85077,60575,30319244,30319254,10,2025-02-25 10:24:54.894228,2025-02-25 10:25:09.580312,14.686084
channel-85077,60576,30319255,30319265,10,2025-02-25 10:25:10.720859,2025-02-25 10:25:25.320147,14.599288
channel-85077,60577,30319279,30319289,10,2025-02-25 10:25:46.225015,2025-02-25 10:25:59.737231,13.512216
channel-85077,60578,30319300,30319306,6,2025-02-25 10:26:13.842366,2025-02-25 10:26:21.845620,8.003254
channel-85077,60579,30319334,30319342,8,2025-02-25 10:26:57.073906,2025-02-25 10:27:09.613217,12.539311
channel-85077,60580,30319336,30319345,9,2025-02-25 10:27:00.102315,2025-02-25 10:27:13.949813,13.847498
channel-85077,60581,30319352,30319363,11,2025-02-25 10:27:21.926171,2025-02-25 10:27:34.399569,12.473398
channel-85077,60582,30319382,30319390,8,2025-02-25 10:27:57.831063,2025-02-25 10:28:11.642425,13.811362
channel-85077,60583,30319416,30319422,6,2025-02-25 10:28:52.150688,2025-02-25 10:29:01.598767,9.448079
channel-85077,60584,30319434,30319456,22,2025-02-25 10:29:17.609362,2025-02-25 10:29:45.616435,28.007073
channel-85077,60585,30319448,30319456,8,2025-02-25 10:29:34.904073,2025-02-25 10:29:45.616435,10.712362
channel-85077,60586,30319479,30319487,8,2025-02-25 10:30:17.162270,2025-02-25 10:30:28.827303,11.665033
channel-85077,60587,30319506,30319517,11,2025-02-25 10:31:00.643679,2025-02-25 10:31:13.580381,12.936702
channel-85077,60588,30319526,30319535,9,2025-02-25 10:31:25.497674,2025-02-25 10:31:38.792261,13.294587
channel-85077,60589,30319615,30319623,8,2025-02-25 10:33:24.786847,2025-02-25 10:33:41.616033,16.829186
channel-85077,60590,30319615,30319623,8,2025-02-25 10:33:24.786847,2025-02-25 10:33:41.616033,16.829186
channel-85077,60591,30319668,30319687,19,2025-02-25 10:34:40.851263,2025-02-25 10:35:08.880874,28.029611
channel-85077,60592,30319677,30319687,10,2025-02-25 10:34:55.928789,2025-02-25 10:35:08.880874,12.952085
channel-85077,60593,30319715,30319722,7,2025-02-25 10:35:43.926162,2025-02-25 10:35:53.063851,9.137689
channel-85077,60594,30319743,30319752,9,2025-02-25 10:36:25.300639,2025-02-25 10:36:36.392343,11.091704
channel-85077,60595,30319745,30319755,10,2025-02-25 10:36:27.370052,2025-02-25 10:36:39.980102,12.61005
channel-85077,60596,30319768,30319778,10,2025-02-25 10:36:58.682052,2025-02-25 10:37:11.775012,13.09296
channel-85077,60597,30319771,30319781,10,2025-02-25 10:37:02.526585,2025-02-25 10:37:15.183246,12.656661
channel-85077,60598,30319780,30319789,9,2025-02-25 10:37:14.062200,2025-02-25 10:37:25.673167,11.610967
channel-85077,60599,30319788,30319797,9,2025-02-25 10:37:24.480214,2025-02-25 10:37:36.516063,12.035849
channel-85077,60600,30319809,30319830,21,2025-02-25 10:37:50.410301,2025-02-25 10:38:20.112398,29.702097
channel-85077,60601,30319811,30319830,19,2025-02-25 10:37:52.683219,2025-02-25 10:38:20.112398,27.429179
channel-85077,60602,30319818,30319826,8,2025-02-25 10:38:01.122377,2025-02-25 10:38:15.737983,14.615606
channel-85077,60603,30319922,30319930,8,2025-02-25 10:40:23.617104,2025-02-25 10:40:33.645210,10.028106
channel-85077,60604,30319928,30319935,7,2025-02-25 10:40:30.734469,2025-02-25 10:40:41.970512,11.236043
channel-85077,60605,30319966,30319976,10,2025-02-25 10:41:24.052790,2025-02-25 10:41:37.374988,13.322198
channel-85077,60606,30320001,30320011,10,2025-02-25 10:42:06.456997,2025-02-25 10:42:18.409149,11.952152
channel-85077,60607,30320038,30320047,9,2025-02-25 10:42:54.304680,2025-02-25 10:43:09.390749,15.086069
channel-85077,60608,30320064,30320076,12,2025-02-25 10:43:35.504212,2025-02-25 10:43:52.925048,17.420836
channel-85077,60609,30320074,30320083,9,2025-02-25 10:43:50.675408,2025-02-25 10:44:00.958633,10.283225
channel-85077,60610,30320076,30320086,10,2025-02-25 10:43:52.925048,2025-02-25 10:44:04.470966,11.545918
channel-85077,60611,30320080,30320089,9,2025-02-25 10:43:57.399092,2025-02-25 10:44:07.977175,10.578083
channel-85077,60612,30320086,30320095,9,2025-02-25 10:44:04.470966,2025-02-25 10:44:15.386141,10.915175
channel-85077,60613,30320114,30320132,18,2025-02-25 10:44:41.593848,2025-02-25 10:45:04.089345,22.495497
channel-85077,60614,30320119,30320129,10,2025-02-25 10:44:48.626372,2025-02-25 10:45:00.646831,12.020459
channel-85077,60615,30320131,30320140,9,2025-02-25 10:45:02.774316,2025-02-25 10:45:14.704940,11.930624
channel-85077,60616,30320132,30320140,8,2025-02-25 10:45:04.089345,2025-02-25 10:45:14.704940,10.615595
channel-85077,60617,30320158,30320165,7,2025-02-25 10:45:37.514341,2025-02-25 10:45:48.489224,10.974883
channel-85077,60618,30320254,30320261,7,2025-02-25 10:47:47.626398,2025-02-25 10:47:58.488589,10.862191
channel-85077,60619,30320256,30320264,8,2025-02-25 10:47:50.839053,2025-02-25 10:48:01.875270,11.036217
channel-85077,60620,30320307,30320317,10,2025-02-25 10:49:02.275103,2025-02-25 10:49:13.637692,11.362589
channel-85077,60621,30320355,30320367,12,2025-02-25 10:50:00.545509,2025-02-25 10:50:16.280768,15.735259
channel-85077,60622,30320403,30320414,11,2025-02-25 10:51:03.685714,2025-02-25 10:51:18.431655,14.745941
channel-85077,60623,30320433,30320443,10,2025-02-25 10:51:44.228944,2025-02-25 10:51:57.008988,12.780044
channel-85077,60624,30320453,30320461,8,2025-02-25 10:52:13.142359,2025-02-25 10:52:24.824209,11.68185
channel-85077,60625,30320557,30320569,12,2025-02-25 10:54:33.060060,2025-02-25 10:54:47.688341,14.628281
channel-85077,60626,30320567,30320576,9,2025-02-25 10:54:45.039352,2025-02-25 10:54:56.359853,11.320501
channel-85077,60627,30320610,30320636,26,2025-02-25 10:55:39.816829,2025-02-25 10:56:14.192314,34.375485
channel-85077,60628,30320637,30320647,10,2025-02-25 10:56:15.308058,2025-02-25 10:56:28.382689,13.074631
channel-85077,60629,30320648,30320655,7,2025-02-25 10:56:29.488116,2025-02-25 10:56:43.979459,14.491343
channel-85077,60630,30320671,30320689,18,2025-02-25 10:57:05.182760,2025-02-25 10:57:27.464796,22.282036
channel-85077,60631,30320675,30320684,9,2025-02-25 10:57:09.636036,2025-02-25 10:57:20.093936,10.4579
channel-85077,60632,30320825,30320837,12,2025-02-25 11:00:29.143619,2025-02-25 11:00:43.239230,14.095611
channel-85077,60633,30320992,30321001,9,2025-02-25 11:04:15.114931,2025-02-25 11:04:26.100908,10.985977
channel-85077,60634,30320994,30321001,7,2025-02-25 11:04:17.597457,2025-02-25 11:04:26.100908,8.503451
channel-85077,60635,30320995,30321004,9,2025-02-25 11:04:18.917091,2025-02-25 11:04:32.677213,13.760122
channel-85077,60636,30321001,30321011,10,2025-02-25 11:04:26.100908,2025-02-25 11:04:40.755612,14.654704
channel-85077,60637,30321003,30321013,10,2025-02-25 11:04:31.645499,2025-02-25 11:04:43.542120,11.896621
channel-85077,60638,30321009,30321018,9,2025-02-25 11:04:38.343597,2025-02-25 11:04:50.434944,12.091347
channel-85077,60639,30321076,30321084,8,2025-02-25 11:06:08.256540,2025-02-25 11:06:18.623024,10.366484
channel-85077,60640,30321136,30321147,11,2025-02-25 11:07:29.337026,2025-02-25 11:07:42.851042,13.514016
channel-85077,60641,30321143,30321150,7,2025-02-25 11:07:37.372910,2025-02-25 11:07:50.390859,13.017949
channel-85077,60642,30321163,30321172,9,2025-02-25 11:08:06.929923,2025-02-25 11:08:17.701559,10.771636
channel-85077,60643,30321168,30321177,9,2025-02-25 11:08:13.055835,2025-02-25 11:08:24.792321,11.736486
channel-85077,60644,30321172,30321180,8,2025-02-25 11:08:17.701559,2025-02-25 11:08:28.158990,10.457431
channel-85077,60645,30321306,30321332,26,2025-02-25 11:11:14.938116,2025-02-25 11:11:48.623989,33.685873
channel-85077,60646,30321476,30321487,11,2025-02-25 11:14:59.086500,2025-02-25 11:15:12.266075,13.179575
channel-85077,60647,30321483,30321491,8,2025-02-25 11:15:07.626438,2025-02-25 11:15:16.864463,9.238025
channel-85077,60648,30321487,30321493,6,2025-02-25 11:15:12.266075,2025-02-25 11:15:22.232450,9.966375
channel-85077,60649,30321642,30321652,10,2025-02-25 11:18:45.047023,2025-02-25 11:18:56.883146,11.836123
channel-85077,60650,30321703,30321713,10,2025-02-25 11:20:09.492591,2025-02-25 11:20:23.103148,13.610557
channel-85077,60651,30321710,30321721,11,2025-02-25 11:20:18.973918,2025-02-25 11:20:32.240824,13.266906
channel-85077,60652,30321725,30321741,16,2025-02-25 11:20:37.599722,2025-02-25 11:20:56.558522,18.9588
channel-85077,60653,30321949,30321960,11,2025-02-25 11:25:38.713455,2025-02-25 11:25:52.239453,13.525998
channel-85077,60654,30321952,30321962,10,2025-02-25 11:25:41.964135,2025-02-25 11:25:54.703544,12.739409
channel-85077,60655,30322071,30322083,12,2025-02-25 11:28:18.205812,2025-02-25 11:28:33.073736,14.867924
channel-85077,60656,30322169,30322179,10,2025-02-25 11:30:31.497116,2025-02-25 11:30:43.962333,12.465217
channel-85077,60657,30322264,30322274,10,2025-02-25 11:32:38.417766,2025-02-25 11:32:52.375604,13.957838
channel-85077,60658,30322266,30322276,10,2025-02-25 11:32:40.880166,2025-02-25 11:32:54.787176,13.90701
channel-85077,60659,30322278,30322288,10,2025-02-25 11:32:58.705451,2025-02-25 11:33:10.680473,11.975022
channel-85077,60660,30322322,30322330,8,2025-02-25 11:33:57.875148,2025-02-25 11:34:09.999689,12.124541
channel-85077,60661,30322360,30322370,10,2025-02-25 11:34:48.160139,2025-02-25 11:35:02.603535,14.443396
channel-85077,60662,30322361,30322405,44,2025-02-25 11:34:50.845441,2025-02-25 11:35:49.618756,58.773315
channel-85077,60663,30322362,30322379,17,2025-02-25 11:34:52.109472,2025-02-25 11:35:17.014864,24.905392
channel-85077,60664,30322376,30322386,10,2025-02-25 11:35:13.471610,2025-02-25 11:35:25.421060,11.94945
channel-85077,60665,30322511,30322522,11,2025-02-25 11:38:06.846677,2025-02-25 11:38:19.437689,12.591012
channel-85077,60666,30322551,30322560,9,2025-02-25 11:39:04.347720,2025-02-25 11:39:14.611983,10.264263
channel-85077,60667,30322562,30322571,9,2025-02-25 11:39:17.011313,2025-02-25 11:39:28.269954,11.258641
channel-85077,60668,30322635,30322646,11,2025-02-25 11:40:58.485099,2025-02-25 11:41:12.159879,13.67478
channel-85077,60669,30322658,30322668,10,2025-02-25 11:41:26.834688,2025-02-25 11:41:40.014391,13.179703
channel-85077,60670,30322746,30322756,10,2025-02-25 11:43:29.190399,2025-02-25 11:43:42.142608,12.952209
channel-85077,60671,30322787,30322797,10,2025-02-25 11:44:21.179798,2025-02-25 11:44:34.025270,12.845472
channel-85077,60672,30322899,30322908,9,2025-02-25 11:46:55.439373,2025-02-25 11:47:05.869395,10.430022
channel-85077,60673,30322909,30322920,11,2025-02-25 11:47:07.083993,2025-02-25 11:47:21.668531,14.584538
channel-85077,60674,30322921,30322931,10,2025-02-25 11:47:22.787923,2025-02-25 11:47:38.715383,15.92746
channel-85077,60675,30322988,30323000,12,2025-02-25 11:48:56.613659,2025-02-25 11:49:12.871921,16.258262
channel-85077,60676,30323111,30323121,10,2025-02-25 11:51:33.325923,2025-02-25 11:51:47.603348,14.277425
channel-85077,60677,30323218,30323236,18,2025-02-25 11:53:54.167391,2025-02-25 11:54:22.299273,28.131882
channel-85077,60678,30323458,30323483,25,2025-02-25 11:59:09.026358,2025-02-25 11:59:39.153285,30.126927
channel-85077,60679,30323979,30323989,10,2025-02-25 12:10:26.086028,2025-02-25 12:10:39.457934,13.371906
channel-85077,60680,30324052,30324062,10,2025-02-25 12:11:59.325301,2025-02-25 12:12:11.809580,12.484279
channel-85077,60681,30324118,30324125,7,2025-02-25 12:13:23.854814,2025-02-25 12:13:32.362252,8.507438
channel-85077,60682,30324151,30324161,10,2025-02-25 12:14:07.496787,2025-02-25 12:14:20.055321,12.558534
channel-85077,60683,30324155,30324164,9,2025-02-25 12:14:13.038593,2025-02-25 12:14:23.513474,10.474881
channel-85077,60684,30324172,30324182,10,2025-02-25 12:14:34.155853,2025-02-25 12:14:47.548560,13.392707
channel-85077,60685,30324192,30324204,12,2025-02-25 12:15:00.654477,2025-02-25 12:15:17.544181,16.889704
channel-85077,60686,30324198,30324206,8,2025-02-25 12:15:10.684174,2025-02-25 12:15:19.938878,9.254704
channel-85077,60687,30324199,30324209,10,2025-02-25 12:15:11.861582,2025-02-25 12:15:23.324042,11.46246
channel-85077,60688,30324206,30324219,13,2025-02-25 12:15:19.938878,2025-02-25 12:15:34.548643,14.609765
channel-85077,60689,30324206,30324219,13,2025-02-25 12:15:19.938878,2025-02-25 12:15:34.548643,14.609765
channel-85077,60690,30324208,30324221,13,2025-02-25 12:15:22.099249,2025-02-25 12:15:37.574739,15.47549
channel-85077,60691,30324211,30324240,29,2025-02-25 12:15:25.490395,2025-02-25 12:16:03.015271,37.524876
channel-85077,60692,30324228,30324238,10,2025-02-25 12:15:47.247572,2025-02-25 12:15:59.685727,12.438155
channel-85077,60693,30324245,30324259,14,2025-02-25 12:16:08.877525,2025-02-25 12:16:28.651616,19.774091
channel-85077,60694,30324253,30324262,9,2025-02-25 12:16:19.833141,2025-02-25 12:16:32.048052,12.214911
channel-85077,60695,30324351,30324357,6,2025-02-25 12:18:23.930586,2025-02-25 12:18:36.051882,12.121296
channel-85077,60696,30324364,30324372,8,2025-02-25 12:18:44.485812,2025-02-25 12:18:56.675442,12.18963
channel-85077,60697,30324366,30324382,16,2025-02-25 12:18:47.694586,2025-02-25 12:19:09.338883,21.644297
channel-85077,60698,30324373,30324392,19,2025-02-25 12:18:57.768305,2025-02-25 12:19:21.513855,23.74555
channel-85077,60699,30324378,30324389,11,2025-02-25 12:19:04.531954,2025-02-25 12:19:18.102887,13.570933
channel-85077,60700,30324400,30324408,8,2025-02-25 12:19:32.023455,2025-02-25 12:19:42.271711,10.248256
channel-85077,60701,30324592,30324598,6,2025-02-25 12:23:39.795573,2025-02-25 12:23:48.230525,8.434952
channel-85077,60702,30324726,30324734,8,2025-02-25 12:26:40.202611,2025-02-25 12:26:50.744403,10.541792
channel-85077,60703,30325016,30325026,10,2025-02-25 12:32:54.373623,2025-02-25 12:33:09.076600,14.702977
channel-85077,60704,30325125,30325136,11,2025-02-25 12:35:17.686923,2025-02-25 12:35:31.427975,13.741052
channel-85077,60705,30325154,30325163,9,2025-02-25 12:35:55.154295,2025-02-25 12:36:05.969575,10.81528
channel-85077,60706,30325170,30325179,9,2025-02-25 12:36:14.953286,2025-02-25 12:36:26.569783,11.616497
channel-85077,60707,30325199,30325206,7,2025-02-25 12:36:51.151547,2025-02-25 12:37:00.835544,9.683997
channel-85077,60708,30325506,30325515,9,2025-02-25 12:43:34.500174,2025-02-25 12:43:44.628788,10.128614
channel-85077,60709,30325520,30325538,18,2025-02-25 12:43:50.264945,2025-02-25 12:44:12.601746,22.336801
channel-85077,60710,30325532,30325542,10,2025-02-25 12:44:04.365864,2025-02-25 12:44:17.670935,13.305071
channel-85077,60711,30325547,30325553,6,2025-02-25 12:44:23.326786,2025-02-25 12:44:33.611159,10.284373
channel-85077,60712,30325680,30325693,13,2025-02-25 12:47:23.014637,2025-02-25 12:47:38.318305,15.303668
channel-85077,60713,30325723,30325738,15,2025-02-25 12:48:15.189684,2025-02-25 12:48:35.377224,20.18754
channel-85077,60714,30325804,30325827,23,2025-02-25 12:50:01.612618,2025-02-25 12:50:29.025411,27.412793
channel-85077,60715,30325809,30325821,12,2025-02-25 12:50:07.299127,2025-02-25 12:50:20.945459,13.646332
channel-85077,60716,30325891,30325911,20,2025-02-25 12:51:53.958009,2025-02-25 12:52:17.673539,23.71553
channel-85077,60717,30325967,30325979,12,2025-02-25 12:53:30.097363,2025-02-25 12:53:44.743058,14.645695
channel-85077,60718,30326127,30326137,10,2025-02-25 12:57:02.491165,2025-02-25 12:57:14.335859,11.844694
channel-85077,60719,30326213,30326222,9,2025-02-25 12:58:53.418221,2025-02-25 12:59:05.033458,11.615237
channel-85077,60720,30326252,30326261,9,2025-02-25 12:59:46.082811,2025-02-25 12:59:57.388217,11.305406
channel-85077,60721,30326259,30326267,8,2025-02-25 12:59:55.114946,2025-02-25 13:00:09.133956,14.01901
channel-85077,60722,30326308,30326317,9,2025-02-25 13:01:03.301112,2025-02-25 13:01:15.199855,11.898743
channel-85077,60723,30326545,30326552,7,2025-02-25 13:06:05.243633,2025-02-25 13:06:15.089036,9.845403
channel-85077,60724,30326613,30326635,22,2025-02-25 13:07:33.960726,2025-02-25 13:08:02.823538,28.862812
channel-85077,60725,30326679,30326692,13,2025-02-25 13:08:57.533746,2025-02-25 13:09:17.196503,19.662757
channel-85077,60726,30326959,30326968,9,2025-02-25 13:15:04.221452,2025-02-25 13:15:16.249810,12.028358
channel-85077,60727,30327015,30327026,11,2025-02-25 13:16:13.248713,2025-02-25 13:16:26.941660,13.692947
channel-85077,60728,30327021,30327031,10,2025-02-25 13:16:20.693125,2025-02-25 13:16:34.986538,14.293413
channel-85077,60729,30327108,30327118,10,2025-02-25 13:18:14.458180,2025-02-25 13:18:30.261766,15.803586
channel-85077,60730,30327136,30327147,11,2025-02-25 13:18:52.768040,2025-02-25 13:19:06.753102,13.985062
channel-85077,60731,30327548,30327557,9,2025-02-25 13:27:46.090700,2025-02-25 13:27:58.223823,12.133123
channel-85077,60732,30327937,30327944,7,2025-02-25 13:36:08.226300,2025-02-25 13:36:19.555594,11.329294
channel-85077,60733,30328102,30328128,26,2025-02-25 13:39:43.799338,2025-02-25 13:40:17.850217,34.050879
channel-85077,60734,30328774,30328781,7,2025-02-25 13:54:15.177772,2025-02-25 13:54:25.980930,10.803158
channel-85077,60735,30328831,30328841,10,2025-02-25 13:55:27.530037,2025-02-25 13:55:39.677842,12.147805
channel-85077,60736,30328843,30328858,15,2025-02-25 13:55:43.095359,2025-02-25 13:56:00.509501,17.414142
channel-85077,60737,30328861,30328868,7,2025-02-25 13:56:04.248357,2025-02-25 13:56:14.894310,10.645953
channel-85077,60738,30328957,30328966,9,2025-02-25 13:58:08.646924,2025-02-25 13:58:21.171963,12.525039
channel-85077,60739,30329037,30329047,10,2025-02-25 13:59:58.330554,2025-02-25 14:00:12.464326,14.133772
channel-85077,60740,30329125,30329135,10,2025-02-25 14:01:54.290687,2025-02-25 14:02:07.650763,13.360076
channel-85077,60741,30329313,30329326,13,2025-02-25 14:05:55.703742,2025-02-25 14:06:10.674146,14.970404
channel-85077,60742,30329344,30329353,9,2025-02-25 14:06:35.606072,2025-02-25 14:06:46.076600,10.470528
channel-85077,60743,30329394,30329399,5,2025-02-25 14:07:40.493218,2025-02-25 14:07:50.167351,9.674133
channel-85077,60744,30329465,30329474,9,2025-02-25 14:09:14.531398,2025-02-25 14:09:26.598693,12.067295
channel-85077,60745,30329534,30329544,10,2025-02-25 14:10:40.219725,2025-02-25 14:10:52.567671,12.347946
channel-85077,60746,30329730,30329740,10,2025-02-25 14:14:58.861090,2025-02-25 14:15:14.114529,15.253439
channel-85077,60747,30329865,30329873,8,2025-02-25 14:17:55.580403,2025-02-25 14:18:08.091879,12.511476
channel-85077,60748,30329867,30329876,9,2025-02-25 14:17:58.181740,2025-02-25 14:18:11.722531,13.540791
channel-85077,60749,30329981,30329991,10,2025-02-25 14:20:25.193065,2025-02-25 14:20:38.466202,13.273137
channel-85077,60750,30330012,30330020,8,2025-02-25 14:21:06.143395,2025-02-25 14:21:19.822274,13.678879
channel-85077,60751,30330012,30330020,8,2025-02-25 14:21:06.143395,2025-02-25 14:21:19.822274,13.678879
channel-85077,60752,30330026,30330034,8,2025-02-25 14:21:27.322240,2025-02-25 14:21:37.703740,10.3815
channel-85077,60753,30330082,30330092,10,2025-02-25 14:22:40.977497,2025-02-25 14:22:53.852776,12.875279
channel-85077,60754,30330116,30330125,9,2025-02-25 14:23:21.447521,2025-02-25 14:23:33.403294,11.955773
channel-85077,60755,30330224,30330238,14,2025-02-25 14:25:38.977979,2025-02-25 14:26:00.126896,21.148917
channel-85077,60756,30330451,30330460,9,2025-02-25 14:30:41.370630,2025-02-25 14:30:52.472021,11.101391
channel-85077,60757,30330456,30330465,9,2025-02-25 14:30:47.701210,2025-02-25 14:31:00.653165,12.951955
channel-85077,60758,30330484,30330494,10,2025-02-25 14:31:23.257391,2025-02-25 14:31:35.512142,12.254751
channel-85077,60759,30330525,30330539,14,2025-02-25 14:32:17.237419,2025-02-25 14:32:33.265698,16.028279
channel-85077,60760,30330600,30330610,10,2025-02-25 14:33:51.390860,2025-02-25 14:34:08.021697,16.630837
channel-85077,60761,30330651,30330661,10,2025-02-25 14:35:01.245617,2025-02-25 14:35:13.295920,12.050303
channel-85077,60762,30330660,30330669,9,2025-02-25 14:35:12.150456,2025-02-25 14:35:23.514187,11.363731
channel-85077,60763,30330662,30330680,18,2025-02-25 14:35:15.569173,2025-02-25 14:35:35.835577,20.266404
channel-85077,60764,30330699,30330710,11,2025-02-25 14:36:02.569647,2025-02-25 14:36:16.377450,13.807803
channel-85077,60765,30330744,30330752,8,2025-02-25 14:37:00.541002,2025-02-25 14:37:12.322720,11.781718
channel-85077,60766,30330778,30330788,10,2025-02-25 14:37:47.300555,2025-02-25 14:37:59.362677,12.062122
channel-85077,60767,30330789,30330799,10,2025-02-25 14:38:00.530077,2025-02-25 14:38:11.929301,11.399224
channel-85077,60768,30330846,30330855,9,2025-02-25 14:39:14.007031,2025-02-25 14:39:25.953894,11.946863
channel-85077,60769,30330861,30330870,9,2025-02-25 14:39:32.940851,2025-02-25 14:39:45.260940,12.320089
channel-85077,60770,30330885,30330894,9,2025-02-25 14:40:04.760278,2025-02-25 14:40:15.415266,10.654988
channel-85077,60771,30330967,30330976,9,2025-02-25 14:41:54.503768,2025-02-25 14:42:05.064010,10.560242
channel-85077,60772,30330973,30330984,11,2025-02-25 14:42:01.715483,2025-02-25 14:42:15.501844,13.786361
channel-85077,60773,30331019,30331032,13,2025-02-25 14:43:00.908037,2025-02-25 14:43:15.958560,15.050523
channel-85077,60774,30331029,30331037,8,2025-02-25 14:43:12.675177,2025-02-25 14:43:21.616398,8.941221
channel-85077,60775,30331055,30331063,8,2025-02-25 14:43:47.603406,2025-02-25 14:44:01.320628,13.717222
channel-85077,60776,30331056,30331065,9,2025-02-25 14:43:50.183231,2025-02-25 14:44:05.635448,15.452217
channel-85077,60777,30331077,30331087,10,2025-02-25 14:44:20.630450,2025-02-25 14:44:33.695905,13.065455
channel-85077,60778,30331090,30331098,8,2025-02-25 14:44:37.087328,2025-02-25 14:44:47.592749,10.505421
channel-85077,60779,30331096,30331107,11,2025-02-25 14:44:44.024557,2025-02-25 14:44:58.147621,14.123064
channel-85077,60780,30331097,30331110,13,2025-02-25 14:44:46.247800,2025-02-25 14:45:01.660557,15.412757
channel-85077,60781,30331182,30331191,9,2025-02-25 14:46:35.735970,2025-02-25 14:46:47.026546,11.290576
channel-85077,60782,30331232,30331240,8,2025-02-25 14:47:41.535381,2025-02-25 14:47:52.028612,10.493231
channel-85077,60783,30331248,30331258,10,2025-02-25 14:48:02.294362,2025-02-25 14:48:15.918495,13.624133
channel-85077,60784,30331258,30331264,6,2025-02-25 14:48:15.918495,2025-02-25 14:48:26.056860,10.138365
channel-85077,60785,30331268,30331276,8,2025-02-25 14:48:30.833792,2025-02-25 14:48:40.900148,10.066356
channel-85077,60786,30331297,30331306,9,2025-02-25 14:49:09.780922,2025-02-25 14:49:19.956235,10.175313
channel-85077,60787,30331298,30331309,11,2025-02-25 14:49:10.926400,2025-02-25 14:49:23.268075,12.341675
channel-85077,60788,30331322,30331331,9,2025-02-25 14:49:39.563658,2025-02-25 14:49:50.562720,10.999062
channel-85077,60789,30331334,30331343,9,2025-02-25 14:49:54.164580,2025-02-25 14:50:06.974427,12.809847
channel-85077,60790,30331340,30331351,11,2025-02-25 14:50:02.315863,2025-02-25 14:50:16.800536,14.484673
channel-85077,60791,30331416,30331426,10,2025-02-25 14:51:43.484564,2025-02-25 14:51:56.330844,12.84628
channel-85077,60792,30331419,30331429,10,2025-02-25 14:51:48.121082,2025-02-25 14:51:59.679258,11.558176
channel-85077,60793,30331456,30331464,8,2025-02-25 14:52:33.551574,2025-02-25 14:52:42.601486,9.049912
channel-85077,60794,30331523,30331532,9,2025-02-25 14:54:03.727552,2025-02-25 14:54:16.349202,12.62165
channel-85077,60795,30331547,30331556,9,2025-02-25 14:54:34.906948,2025-02-25 14:54:46.793452,11.886504
channel-85077,60796,30331559,30331569,10,2025-02-25 14:54:52.769472,2025-02-25 14:55:05.297484,12.528012
channel-85077,60797,30331581,30331591,10,2025-02-25 14:55:22.025083,2025-02-25 14:55:33.621608,11.596525
channel-85077,60798,30331613,30331621,8,2025-02-25 14:56:02.165023,2025-02-25 14:56:11.588220,9.423197
channel-85077,60799,30331623,30331633,10,2025-02-25 14:56:13.853322,2025-02-25 14:56:27.234977,13.381655
channel-85077,60800,30331634,30331647,13,2025-02-25 14:56:28.295500,2025-02-25 14:56:44.246456,15.950956
channel-85077,60801,30331645,30331657,12,2025-02-25 14:56:41.880782,2025-02-25 14:56:57.246638,15.365856
channel-85077,60802,30331648,30331661,13,2025-02-25 14:56:47.084487,2025-02-25 14:57:01.792945,14.708458
channel-85077,60803,30331667,30331677,10,2025-02-25 14:57:08.675560,2025-02-25 14:57:20.646400,11.97084
channel-85077,60804,30331711,30331719,8,2025-02-25 14:58:09.142124,2025-02-25 14:58:19.634402,10.492278
channel-85077,60805,30331724,30331731,7,2025-02-25 14:58:25.566429,2025-02-25 14:58:40.859662,15.293233
channel-85077,60806,30331728,30331741,13,2025-02-25 14:58:33.342755,2025-02-25 14:58:52.898098,19.555343
channel-85077,60807,30331728,30331741,13,2025-02-25 14:58:33.342755,2025-02-25 14:58:52.898098,19.555343
channel-85077,60808,30331733,30331760,27,2025-02-25 14:58:43.208855,2025-02-25 14:59:16.660146,33.451291
channel-85077,60809,30331737,30331749,12,2025-02-25 14:58:48.264470,2025-02-25 14:59:02.820063,14.555593
channel-85077,60810,30331747,30331757,10,2025-02-25 14:59:00.439223,2025-02-25 14:59:12.974078,12.534855
channel-85077,60811,30331759,30331773,14,2025-02-25 14:59:15.288377,2025-02-25 14:59:33.855556,18.567179
channel-85077,60812,30331781,30331801,20,2025-02-25 14:59:43.298226,2025-02-25 15:00:07.387795,24.089569
channel-85077,60813,30331791,30331810,19,2025-02-25 14:59:55.779912,2025-02-25 15:00:18.892962,23.11305
channel-85077,60814,30331810,30331817,7,2025-02-25 15:00:18.892962,2025-02-25 15:00:30.320607,11.427645
channel-85077,60815,30331831,30331839,8,2025-02-25 15:00:49.429275,2025-02-25 15:00:58.492924,9.063649
channel-85077,60816,30331833,30331853,20,2025-02-25 15:00:51.672685,2025-02-25 15:01:17.015184,25.342499
channel-85077,60817,30331845,30331855,10,2025-02-25 15:01:06.680352,2025-02-25 15:01:19.558285,12.877933
channel-85077,60818,30331849,30331863,14,2025-02-25 15:01:12.334408,2025-02-25 15:01:28.685970,16.351562
channel-85077,60819,30331852,30331869,17,2025-02-25 15:01:15.914859,2025-02-25 15:01:37.340839,21.42598
channel-85077,60820,30331864,30331881,17,2025-02-25 15:01:30.161347,2025-02-25 15:01:56.369695,26.208348
channel-85077,60821,30331868,30331881,13,2025-02-25 15:01:35.079400,2025-02-25 15:01:56.369695,21.290295
channel-85077,60822,30331914,30331927,13,2025-02-25 15:02:38.594631,2025-02-25 15:02:56.187890,17.593259
channel-85077,60823,30331946,30331957,11,2025-02-25 15:03:20.119337,2025-02-25 15:03:32.819947,12.70061
channel-85077,60824,30331999,30332008,9,2025-02-25 15:04:29.782236,2025-02-25 15:04:42.538859,12.756623
channel-85077,60825,30332081,30332091,10,2025-02-25 15:06:19.533556,2025-02-25 15:06:31.502347,11.968791
channel-85077,60826,30332097,30332108,11,2025-02-25 15:06:41.639998,2025-02-25 15:06:55.663590,14.023592
channel-85077,60827,30332211,30332223,12,2025-02-25 15:09:08.557065,2025-02-25 15:09:22.471525,13.91446
channel-85077,60828,30332244,30332254,10,2025-02-25 15:09:49.111241,2025-02-25 15:10:07.051538,17.940297
channel-85077,60829,30332252,30332264,12,2025-02-25 15:10:03.803216,2025-02-25 15:10:19.866684,16.063468
channel-85077,60830,30332269,30332277,8,2025-02-25 15:10:26.103772,2025-02-25 15:10:36.957528,10.853756
channel-85077,60831,30332303,30332315,12,2025-02-25 15:11:11.551335,2025-02-25 15:11:27.743390,16.192055
channel-85077,60832,30332307,30332342,35,2025-02-25 15:11:17.278499,2025-02-25 15:12:02.840430,45.561931
channel-85077,60833,30332360,30332368,8,2025-02-25 15:12:26.037560,2025-02-25 15:12:36.983773,10.946213
channel-85077,60834,30332377,30332388,11,2025-02-25 15:12:48.660563,2025-02-25 15:13:02.164630,13.504067
channel-85077,60835,30332386,30332400,14,2025-02-25 15:12:59.938865,2025-02-25 15:13:16.732663,16.793798
channel-85077,60836,30332455,30332463,8,2025-02-25 15:14:32.369291,2025-02-25 15:14:42.537919,10.168628
channel-85077,60837,30332464,30332481,17,2025-02-25 15:14:43.669594,2025-02-25 15:15:05.840935,22.171341
channel-85077,60838,30332481,30332491,10,2025-02-25 15:15:05.840935,2025-02-25 15:15:18.828268,12.987333
channel-85077,60839,30332497,30332505,8,2025-02-25 15:15:25.454103,2025-02-25 15:15:37.369105,11.915002
channel-85077,60840,30332630,30332641,11,2025-02-25 15:18:23.934265,2025-02-25 15:18:37.279277,13.345012
channel-85077,60841,30332645,30332653,8,2025-02-25 15:18:44.118804,2025-02-25 15:18:54.986903,10.868099
channel-85077,60842,30332650,30332663,13,2025-02-25 15:18:51.528726,2025-02-25 15:19:06.366191,14.837465
channel-85077,60843,30332652,30332663,11,2025-02-25 15:18:53.857812,2025-02-25 15:19:06.366191,12.508379
channel-85077,60844,30332666,30332675,9,2025-02-25 15:19:10.414400,2025-02-25 15:19:20.740057,10.325657
channel-85077,60845,30332689,30332697,8,2025-02-25 15:19:39.570580,2025-02-25 15:19:50.516493,10.945913
channel-85077,60846,30332701,30332744,43,2025-02-25 15:19:59.420977,2025-02-25 15:20:56.573082,57.152105
channel-85077,60847,30332711,30332729,18,2025-02-25 15:20:10.728877,2025-02-25 15:20:36.728522,25.999645
channel-85077,60848,30332726,30332736,10,2025-02-25 15:20:33.063564,2025-02-25 15:20:45.701021,12.637457
channel-85077,60849,30332728,30332741,13,2025-02-25 15:20:35.512683,2025-02-25 15:20:51.756409,16.243726
channel-85077,60850,30332795,30332810,15,2025-02-25 15:22:02.865702,2025-02-25 15:22:21.022979,18.157277
channel-85077,60851,30332801,30332820,19,2025-02-25 15:22:10.374975,2025-02-25 15:22:34.949015,24.57404
channel-85077,60852,30332801,30332820,19,2025-02-25 15:22:10.374975,2025-02-25 15:22:34.949015,24.57404
channel-85077,60853,30332828,30332837,9,2025-02-25 15:22:44.830225,2025-02-25 15:22:55.424255,10.59403
channel-85077,60854,30332844,30332853,9,2025-02-25 15:23:04.668345,2025-02-25 15:23:15.262196,10.593851
channel-85077,60855,30332885,30332896,11,2025-02-25 15:24:00.229089,2025-02-25 15:24:14.791072,14.561983
channel-85077,60856,30332937,30332945,8,2025-02-25 15:25:10.166962,2025-02-25 15:25:22.227976,12.061014
channel-85077,60857,30332989,30332997,8,2025-02-25 15:26:17.397617,2025-02-25 15:26:27.409766,10.012149
channel-85077,60858,30333014,30333024,10,2025-02-25 15:26:50.335503,2025-02-25 15:27:01.832758,11.497255
channel-85077,60859,30333050,30333060,10,2025-02-25 15:27:38.665347,2025-02-25 15:27:50.370577,11.70523
channel-85077,60860,30333118,30333128,10,2025-02-25 15:29:05.389508,2025-02-25 15:29:17.448601,12.059093
channel-85077,60861,30333127,30333133,6,2025-02-25 15:29:15.790731,2025-02-25 15:29:28.970028,13.179297
channel-85077,60862,30333259,30333278,19,2025-02-25 15:32:14.580763,2025-02-25 15:32:37.961742,23.380979
channel-85077,60863,30333304,30333313,9,2025-02-25 15:33:12.247562,2025-02-25 15:33:22.761822,10.51426
channel-85077,60864,30333390,30333401,11,2025-02-25 15:35:07.557648,2025-02-25 15:35:22.245926,14.688278
channel-85077,60865,30333390,30333401,11,2025-02-25 15:35:07.557648,2025-02-25 15:35:22.245926,14.688278
channel-85077,60866,30333396,30333406,10,2025-02-25 15:35:16.178367,2025-02-25 15:35:29.463722,13.285355
channel-85077,60867,30333397,30333409,12,2025-02-25 15:35:17.388103,2025-02-25 15:35:33.039473,15.65137
channel-85077,60868,30333400,30333409,9,2025-02-25 15:35:21.207881,2025-02-25 15:35:33.039473,11.831592
channel-85077,60869,30333402,30333419,17,2025-02-25 15:35:23.344504,2025-02-25 15:35:46.445505,23.101001
channel-85077,60870,30333459,30333467,8,2025-02-25 15:36:38.293891,2025-02-25 15:36:47.478241,9.18435
channel-85077,60871,30333494,30333504,10,2025-02-25 15:37:25.761628,2025-02-25 15:37:38.668448,12.90682
channel-85077,60872,30333508,30333515,7,2025-02-25 15:37:45.233558,2025-02-25 15:37:54.520205,9.286647
channel-85077,60873,30333513,30333522,9,2025-02-25 15:37:51.179979,2025-02-25 15:38:02.739991,11.560012
channel-85077,60874,30333532,30333543,11,2025-02-25 15:38:18.563006,2025-02-25 15:38:32.546307,13.983301
channel-85077,60875,30333595,30333605,10,2025-02-25 15:39:43.648699,2025-02-25 15:39:56.554330,12.905631
channel-85077,60876,30333626,30333633,7,2025-02-25 15:40:25.333262,2025-02-25 15:40:34.057886,8.724624
channel-85077,60877,30333633,30333645,12,2025-02-25 15:40:34.057886,2025-02-25 15:40:52.208473,18.150587
channel-85077,60878,30333639,30333650,11,2025-02-25 15:40:45.013009,2025-02-25 15:40:57.968013,12.955004
channel-85077,60879,30333648,30333658,10,2025-02-25 15:40:55.696116,2025-02-25 15:41:08.006781,12.310665
channel-85077,60880,30333715,30333728,13,2025-02-25 15:42:23.736357,2025-02-25 15:42:40.959139,17.222782
channel-85077,60881,30333719,30333738,19,2025-02-25 15:42:28.103648,2025-02-25 15:42:54.831167,26.727519
channel-85077,60882,30333745,30333755,10,2025-02-25 15:43:03.174761,2025-02-25 15:43:18.492900,15.318139
channel-85077,60883,30333814,30333819,5,2025-02-25 15:44:32.548626,2025-02-25 15:44:42.557639,10.009013
channel-85077,60884,30333914,30333923,9,2025-02-25 15:46:53.139287,2025-02-25 15:47:04.427931,11.288644
channel-85077,60885,30333938,30333946,8,2025-02-25 15:47:22.779593,2025-02-25 15:47:34.346040,11.566447
channel-85077,60886,30334100,30334112,12,2025-02-25 15:51:00.874474,2025-02-25 15:51:14.690842,13.816368
channel-85077,60887,30334168,30334181,13,2025-02-25 15:52:26.091036,2025-02-25 15:52:45.841076,19.75004
channel-85077,60888,30334210,30334219,9,2025-02-25 15:53:28.141169,2025-02-25 15:53:39.198017,11.056848
channel-85077,60889,30334333,30334349,16,2025-02-25 15:56:12.947433,2025-02-25 15:56:33.253206,20.305773
channel-85077,60890,30334394,30334406,12,2025-02-25 15:57:36.771726,2025-02-25 15:57:51.192214,14.420488
channel-85077,60891,30334441,30334449,8,2025-02-25 15:58:38.958625,2025-02-25 15:58:49.828230,10.869605
channel-85077,60892,30334547,30334557,10,2025-02-25 16:00:58.538323,2025-02-25 16:01:11.630227,13.091904
channel-85077,60893,30334549,30334561,12,2025-02-25 16:01:01.309201,2025-02-25 16:01:17.313908,16.004707
channel-85077,60894,30334619,30334635,16,2025-02-25 16:02:34.844455,2025-02-25 16:02:56.720474,21.876019
channel-85077,60895,30334638,30334647,9,2025-02-25 16:03:00.045163,2025-02-25 16:03:12.206095,12.160932
channel-85077,60896,30334681,30334689,8,2025-02-25 16:03:55.579385,2025-02-25 16:04:08.787362,13.207977
channel-85077,60897,30334764,30334775,11,2025-02-25 16:05:46.844136,2025-02-25 16:06:00.642368,13.798232
channel-85077,60898,30334816,30334824,8,2025-02-25 16:06:55.141978,2025-02-25 16:07:06.610286,11.468308
channel-85077,60899,30334831,30334840,9,2025-02-25 16:07:14.700328,2025-02-25 16:07:25.320430,10.620102
channel-85077,60900,30334848,30334874,26,2025-02-25 16:07:36.192059,2025-02-25 16:08:12.334881,36.142822
channel-85077,60901,30334851,30334861,10,2025-02-25 16:07:44.427853,2025-02-25 16:07:56.228147,11.800294
channel-85077,60902,30334918,30334927,9,2025-02-25 16:09:07.035103,2025-02-25 16:09:19.101636,12.066533
channel-85077,60903,30334930,30334938,8,2025-02-25 16:09:23.005790,2025-02-25 16:09:34.063405,11.057615
channel-85077,60904,30335027,30335039,12,2025-02-25 16:11:38.120481,2025-02-25 16:11:51.988761,13.86828
channel-85077,60905,30335058,30335067,9,2025-02-25 16:12:14.595810,2025-02-25 16:12:27.975869,13.380059
channel-85077,60906,30335235,30335245,10,2025-02-25 16:16:10.875786,2025-02-25 16:16:23.020606,12.14482
channel-85077,60907,30335269,30335279,10,2025-02-25 16:16:53.908501,2025-02-25 16:17:06.878959,12.970458
channel-85077,60908,30335509,30335517,8,2025-02-25 16:22:08.435373,2025-02-25 16:22:18.465591,10.030218
channel-85077,60909,30335512,30335520,8,2025-02-25 16:22:12.635312,2025-02-25 16:22:22.046588,9.411276
channel-85077,60910,30335572,30335581,9,2025-02-25 16:23:31.911644,2025-02-25 16:23:43.140620,11.228976
channel-85077,60911,30335664,30335673,9,2025-02-25 16:25:37.257699,2025-02-25 16:25:48.418394,11.160695
channel-85077,60912,30335816,30335826,10,2025-02-25 16:28:51.814153,2025-02-25 16:29:05.465124,13.650971
channel-85077,60913,30335974,30335982,8,2025-02-25 16:32:18.446823,2025-02-25 16:32:31.502870,13.056047
channel-85077,60914,30336233,30336281,48,2025-02-25 16:38:00.373079,2025-02-25 16:39:05.557160,65.184081
channel-85077,60915,30336351,30336371,20,2025-02-25 16:40:43.104261,2025-02-25 16:41:09.013552,25.909291
channel-85077,60916,30336362,30336374,12,2025-02-25 16:40:57.845331,2025-02-25 16:41:12.518434,14.673103
channel-85077,60917,30336428,30336443,15,2025-02-25 16:42:21.530284,2025-02-25 16:42:40.924464,19.39418
channel-85077,60918,30336518,30336526,8,2025-02-25 16:44:22.802571,2025-02-25 16:44:35.810555,13.007984
channel-85077,60919,30336519,30336528,9,2025-02-25 16:44:23.997873,2025-02-25 16:44:38.634643,14.63677
channel-85077,60920,30336594,30336612,18,2025-02-25 16:46:04.556876,2025-02-25 16:46:25.572514,21.015638
channel-85077,60921,30336627,30336638,11,2025-02-25 16:46:44.823643,2025-02-25 16:46:59.190955,14.367312
channel-85077,60922,30336633,30336644,11,2025-02-25 16:46:52.949995,2025-02-25 16:47:06.718731,13.768736
channel-85077,60923,30336662,30336672,10,2025-02-25 16:47:29.360732,2025-02-25 16:47:42.262187,12.901455
channel-85077,60924,30336673,30336684,11,2025-02-25 16:47:43.359686,2025-02-25 16:48:03.740650,20.380964
channel-85077,60925,30336699,30336710,11,2025-02-25 16:48:24.990579,2025-02-25 16:48:38.826881,13.836302
channel-85077,60926,30336705,30336715,10,2025-02-25 16:48:32.223644,2025-02-25 16:48:45.757595,13.533951
channel-85077,60927,30336718,30336727,9,2025-02-25 16:48:49.342850,2025-02-25 16:49:02.476162,13.133312
channel-85077,60928,30336743,30336753,10,2025-02-25 16:49:22.324509,2025-02-25 16:49:33.851477,11.526968
channel-85077,60929,30336765,30336775,10,2025-02-25 16:49:51.432183,2025-02-25 16:50:03.783135,12.350952
channel-85077,60930,30336786,30336795,9,2025-02-25 16:50:16.466913,2025-02-25 16:50:28.721126,12.254213
channel-85077,60931,30336996,30337007,11,2025-02-25 16:54:54.045011,2025-02-25 16:55:10.311955,16.266944
channel-85077,60932,30337260,30337270,10,2025-02-25 17:00:49.987679,2025-02-25 17:01:01.419397,11.431718
channel-85077,60933,30337326,30337335,9,2025-02-25 17:02:18.272368,2025-02-25 17:02:30.503510,12.231142
channel-85077,60934,30337358,30337367,9,2025-02-25 17:03:01.607932,2025-02-25 17:03:13.341087,11.733155
channel-85077,60935,30337432,30337439,7,2025-02-25 17:04:33.456397,2025-02-25 17:04:44.483042,11.026645
channel-85077,60936,30337531,30337540,9,2025-02-25 17:06:49.027447,2025-02-25 17:07:02.258300,13.230853
channel-85077,60937,30337740,30337751,11,2025-02-25 17:11:23.473686,2025-02-25 17:11:37.724360,14.250674
channel-85077,60938,30337815,30337823,8,2025-02-25 17:13:01.091123,2025-02-25 17:13:10.681362,9.590239
channel-85077,60939,30337929,30337941,12,2025-02-25 17:15:32.434296,2025-02-25 17:15:47.084614,14.650318
channel-85077,60940,30337943,30337958,15,2025-02-25 17:15:49.461523,2025-02-25 17:16:08.509076,19.047553
channel-85077,60941,30337961,30337968,7,2025-02-25 17:16:11.803814,2025-02-25 17:16:52.732756,40.928942
channel-85077,60942,30337988,30337997,9,2025-02-25 17:17:31.656780,2025-02-25 17:17:43.618640,11.96186
channel-85077,60943,30338018,30338027,9,2025-02-25 17:18:13.688040,2025-02-25 17:18:25.097136,11.409096
channel-85077,60944,30338079,30338089,10,2025-02-25 17:19:32.636635,2025-02-25 17:19:45.816592,13.179957
channel-85077,60945,30338220,30338229,9,2025-02-25 17:22:40.203578,2025-02-25 17:22:51.204380,11.000802
channel-85077,60946,30338246,30338258,12,2025-02-25 17:23:16.270307,2025-02-25 17:23:31.010967,14.74066
channel-85077,60947,30338262,30338270,8,2025-02-25 17:23:36.816525,2025-02-25 17:23:47.289581,10.473056
channel-85077,60948,30338384,30338395,11,2025-02-25 17:26:20.838230,2025-02-25 17:26:34.612899,13.774669
channel-85077,60949,30338419,30338429,10,2025-02-25 17:27:07.594135,2025-02-25 17:27:19.427220,11.833085
channel-85077,60950,30338435,30338444,9,2025-02-25 17:27:26.465899,2025-02-25 17:27:37.466858,11.000959
channel-85077,60951,30338452,30338459,7,2025-02-25 17:27:47.935243,2025-02-25 17:27:56.820655,8.885412
channel-85077,60952,30338452,30338459,7,2025-02-25 17:27:47.935243,2025-02-25 17:27:56.820655,8.885412
channel-85077,60953,30338466,30338476,10,2025-02-25 17:28:07.003265,2025-02-25 17:28:19.530383,12.527118
channel-85077,60954,30338564,30338595,31,2025-02-25 17:30:23.924770,2025-02-25 17:31:07.296617,43.371847
channel-85077,60955,30338618,30338626,8,2025-02-25 17:31:37.190985,2025-02-25 17:31:47.587316,10.396331
channel-85077,60956,30338753,30338764,11,2025-02-25 17:34:39.209232,2025-02-25 17:34:54.384209,15.174977
channel-85077,60957,30338799,30338811,12,2025-02-25 17:35:38.969334,2025-02-25 17:35:54.258304,15.28897
channel-85077,60958,30338848,30338858,10,2025-02-25 17:36:48.869830,2025-02-25 17:37:00.834777,11.964947
channel-85077,60959,30339000,30339008,8,2025-02-25 17:40:07.314046,2025-02-25 17:40:18.333788,11.019742
channel-85077,60960,30339155,30339161,6,2025-02-25 17:43:31.229782,2025-02-25 17:43:42.369836,11.140054
channel-85077,60961,30339305,30339316,11,2025-02-25 17:46:54.448996,2025-02-25 17:47:07.344750,12.895754
channel-85077,60962,30339333,30339342,9,2025-02-25 17:47:30.229678,2025-02-25 17:47:45.097142,14.867464
channel-85077,60963,30339540,30339549,9,2025-02-25 17:52:06.631071,2025-02-25 17:52:18.584885,11.953814
channel-85077,60964,30339609,30339619,10,2025-02-25 17:53:37.572102,2025-02-25 17:53:51.595370,14.023268
channel-85077,60965,30339650,30339661,11,2025-02-25 17:54:30.667729,2025-02-25 17:54:43.844665,13.176936
channel-85077,60966,30339662,30339674,12,2025-02-25 17:54:46.230564,2025-02-25 17:54:59.696614,13.46605
channel-85077,60967,30339742,30339752,10,2025-02-25 17:56:33.057647,2025-02-25 17:56:45.607992,12.550345
channel-85077,60968,30339782,30339790,8,2025-02-25 17:57:25.154783,2025-02-25 17:57:37.802800,12.648017
channel-85077,60969,30339894,30339903,9,2025-02-25 17:59:53.096610,2025-02-25 18:00:03.592126,10.495516
channel-85077,60970,30339917,30339925,8,2025-02-25 18:00:21.805850,2025-02-25 18:00:31.968081,10.162231
channel-85077,60971,30339935,30339945,10,2025-02-25 18:00:45.558020,2025-02-25 18:00:56.831924,11.273904
channel-85077,60972,30340136,30340146,10,2025-02-25 18:05:06.764693,2025-02-25 18:05:21.643606,14.878913
channel-85077,60973,30340163,30340172,9,2025-02-25 18:05:46.723479,2025-02-25 18:05:58.304360,11.580881
channel-85077,60974,30340326,30340339,13,2025-02-25 18:09:20.409399,2025-02-25 18:09:40.413140,20.003741
channel-85077,60975,30340351,30340360,9,2025-02-25 18:09:54.279961,2025-02-25 18:10:06.447403,12.167442
channel-85077,60976,30340662,30340669,7,2025-02-25 18:16:42.440865,2025-02-25 18:16:53.601654,11.160789
channel-85077,60977,30340696,30340705,9,2025-02-25 18:17:29.510969,2025-02-25 18:17:39.787151,10.276182
channel-85077,60978,30340828,30340833,5,2025-02-25 18:20:19.898174,2025-02-25 18:20:30.444177,10.546003
channel-85077,60979,30340865,30340874,9,2025-02-25 18:21:10.755493,2025-02-25 18:21:23.180113,12.42462
channel-85077,60980,30340871,30340882,11,2025-02-25 18:21:18.484286,2025-02-25 18:21:32.653846,14.16956
channel-85077,60981,30340917,30340924,7,2025-02-25 18:22:16.695775,2025-02-25 18:22:26.033690,9.337915
channel-85077,60982,30340981,30340992,11,2025-02-25 18:23:41.747114,2025-02-25 18:23:54.642994,12.89588
channel-85077,60983,30340990,30340998,8,2025-02-25 18:23:52.285416,2025-02-25 18:24:06.077451,13.792035
channel-85077,60984,30340999,30341008,9,2025-02-25 18:24:07.644812,2025-02-25 18:24:20.311257,12.666445
channel-85077,60985,30341039,30341049,10,2025-02-25 18:25:02.487159,2025-02-25 18:25:15.573197,13.086038
channel-85077,60986,30341101,30341112,11,2025-02-25 18:26:21.810096,2025-02-25 18:26:35.537280,13.727184
channel-85077,60987,30341481,30341491,10,2025-02-25 18:34:43.538977,2025-02-25 18:34:54.991225,11.452248
channel-85077,60988,30341494,30341503,9,2025-02-25 18:35:01.977746,2025-02-25 18:35:13.696451,11.718705
channel-85077,60989,30341507,30341516,9,2025-02-25 18:35:18.233160,2025-02-25 18:35:29.607600,11.37444
channel-85077,60990,30341535,30341547,12,2025-02-25 18:35:53.785539,2025-02-25 18:36:08.224674,14.439135
channel-85077,60991,30341584,30341594,10,2025-02-25 18:36:54.159728,2025-02-25 18:37:07.119788,12.96006
channel-85077,60992,30341591,30341600,9,2025-02-25 18:37:03.586782,2025-02-25 18:37:16.163607,12.576825
channel-85077,60993,30341603,30341611,8,2025-02-25 18:37:19.908210,2025-02-25 18:37:31.216405,11.308195
channel-85077,60994,30341608,30341615,7,2025-02-25 18:37:27.146776,2025-02-25 18:37:37.104207,9.957431
channel-85077,60995,30341613,30341623,10,2025-02-25 18:37:33.324647,2025-02-25 18:37:46.243930,12.919283
channel-85077,60996,30341634,30341641,7,2025-02-25 18:38:00.068909,2025-02-25 18:38:09.193005,9.124096
channel-85077,60997,30341639,30341648,9,2025-02-25 18:38:06.882341,2025-02-25 18:38:18.888466,12.006125
channel-85077,60998,30341650,30341660,10,2025-02-25 18:38:22.331637,2025-02-25 18:38:34.925864,12.594227
channel-85077,60999,30341722,30341731,9,2025-02-25 18:40:03.797662,2025-02-25 18:40:13.868423,10.070761
channel-85077,61000,30341791,30341800,9,2025-02-25 18:41:32.561600,2025-02-25 18:41:44.131842,11.570242
channel-85077,61001,30341986,30342002,16,2025-02-25 18:45:45.091045,2025-02-25 18:46:05.342827,20.251782
channel-85077,61002,30342018,30342025,7,2025-02-25 18:46:26.197446,2025-02-25 18:46:34.731649,8.534203
channel-85077,61003,30342087,30342097,10,2025-02-25 18:47:56.165599,2025-02-25 18:48:09.691046,13.525447
channel-85077,61004,30342218,30342226,8,2025-02-25 18:50:39.175851,2025-02-25 18:50:51.747832,12.571981
channel-85077,61005,30342250,30342263,13,2025-02-25 18:51:23.897372,2025-02-25 18:51:38.711988,14.814616
channel-85077,61006,30342307,30342317,10,2025-02-25 18:52:38.558384,2025-02-25 18:52:50.537866,11.979482
channel-85077,61007,30342353,30342362,9,2025-02-25 18:53:35.859018,2025-02-25 18:53:46.309313,10.450295
channel-85077,61008,30342359,30342370,11,2025-02-25 18:53:42.856071,2025-02-25 18:53:56.158294,13.302223
channel-85077,61009,30342362,30342378,16,2025-02-25 18:53:46.309313,2025-02-25 18:54:07.039044,20.729731
channel-85077,61010,30342406,30342415,9,2025-02-25 18:54:43.249668,2025-02-25 18:54:56.438853,13.189185
channel-85077,61011,30342445,30342454,9,2025-02-25 18:55:33.300866,2025-02-25 18:55:44.833900,11.533034
channel-85077,61012,30342585,30342597,12,2025-02-25 18:58:34.250157,2025-02-25 18:58:49.479740,15.229583
channel-85077,61013,30342589,30342600,11,2025-02-25 18:58:38.775473,2025-02-25 18:58:52.814038,14.038565
channel-85077,61014,30342591,30342602,11,2025-02-25 18:58:41.130821,2025-02-25 18:58:54.976807,13.845986
channel-85077,61015,30342612,30342620,8,2025-02-25 18:59:08.313385,2025-02-25 18:59:18.681964,10.368579
channel-85077,61016,30342650,30342659,9,2025-02-25 18:59:55.162981,2025-02-25 19:00:12.782491,17.61951
channel-85077,61017,30342840,30342850,10,2025-02-25 19:04:10.412324,2025-02-25 19:04:22.014116,11.601792
channel-85077,61018,30342985,30342991,6,2025-02-25 19:07:21.830225,2025-02-25 19:07:33.400202,11.569977
channel-85077,61019,30343255,30343267,12,2025-02-25 19:13:16.427106,2025-02-25 19:13:31.752615,15.325509
channel-85077,61020,30343265,30343277,12,2025-02-25 19:13:29.566254,2025-02-25 19:13:43.208486,13.642232
channel-85077,61021,30343309,30343319,10,2025-02-25 19:14:24.403857,2025-02-25 19:14:39.851143,15.447286
channel-85077,61022,30343598,30343606,8,2025-02-25 19:20:42.385471,2025-02-25 19:20:55.723650,13.338179
channel-85077,61023,30343767,30343775,8,2025-02-25 19:24:25.934843,2025-02-25 19:24:37.017564,11.082721
channel-85077,61024,30343821,30343830,9,2025-02-25 19:25:36.681588,2025-02-25 19:25:47.086433,10.404845
channel-85077,61025,30343823,30343833,10,2025-02-25 19:25:38.848963,2025-02-25 19:25:51.425335,12.576372
channel-85077,61026,30343882,30343892,10,2025-02-25 19:26:54.030309,2025-02-25 19:27:05.598805,11.568496
channel-85077,61027,30344030,30344038,8,2025-02-25 19:30:02.794277,2025-02-25 19:30:16.138783,13.344506
channel-85077,61028,30344053,30344062,9,2025-02-25 19:30:34.908287,2025-02-25 19:30:47.109727,12.20144
channel-85077,61029,30344081,30344091,10,2025-02-25 19:31:09.591722,2025-02-25 19:31:21.344590,11.752868
channel-85077,61030,30344414,30344425,11,2025-02-25 19:38:17.337421,2025-02-25 19:38:29.927392,12.589971
channel-85077,61031,30344839,30344850,11,2025-02-25 19:47:27.996712,2025-02-25 19:47:40.874846,12.878134
channel-85077,61032,30345314,30345322,8,2025-02-25 19:57:47.696984,2025-02-25 19:57:58.819504,11.12252
channel-85077,61033,30345444,30345454,10,2025-02-25 20:00:45.172112,2025-02-25 20:00:57.727847,12.555735
channel-85077,61034,30345582,30345588,6,2025-02-25 20:03:39.288309,2025-02-25 20:03:52.137215,12.848906
channel-85077,61035,30345607,30345619,12,2025-02-25 20:04:19.727715,2025-02-25 20:04:34.177996,14.450281
channel-85077,61036,30345633,30345653,20,2025-02-25 20:04:52.570247,2025-02-25 20:05:19.056401,26.486154
channel-85077,61037,30345639,30345650,11,2025-02-25 20:04:59.266458,2025-02-25 20:05:13.117316,13.850858
channel-85077,61038,30345677,30345686,9,2025-02-25 20:05:49.500118,2025-02-25 20:06:01.174919,11.674801
channel-85077,61039,30345717,30345726,9,2025-02-25 20:06:39.245271,2025-02-25 20:06:49.833122,10.587851
channel-85077,61040,30345819,30345829,10,2025-02-25 20:08:50.562187,2025-02-25 20:09:03.202975,12.640788
channel-85077,61041,30345822,30345832,10,2025-02-25 20:08:54.020646,2025-02-25 20:09:06.566435,12.545789
channel-85077,61042,30345958,30345976,18,2025-02-25 20:11:50.180491,2025-02-25 20:12:13.093717,22.913226
channel-85077,61043,30345996,30346003,7,2025-02-25 20:12:37.988433,2025-02-25 20:12:47.171642,9.183209
channel-85077,61044,30346253,30346263,10,2025-02-25 20:18:13.470240,2025-02-25 20:18:25.115171,11.644931
channel-85077,61045,30346348,30346358,10,2025-02-25 20:20:17.253450,2025-02-25 20:20:32.707180,15.45373
channel-85077,61046,30346427,30346436,9,2025-02-25 20:22:09.237797,2025-02-25 20:22:20.091093,10.853296
channel-85077,61047,30346432,30346440,8,2025-02-25 20:22:15.068691,2025-02-25 20:22:25.457773,10.389082
channel-85077,61048,30346508,30346519,11,2025-02-25 20:23:56.929991,2025-02-25 20:24:11.948389,15.018398
channel-85077,61049,30346568,30346578,10,2025-02-25 20:25:21.476029,2025-02-25 20:25:33.411173,11.935144
channel-85077,61050,30346622,30346630,8,2025-02-25 20:26:28.474839,2025-02-25 20:26:39.586474,11.111635
channel-85077,61051,30346670,30346681,11,2025-02-25 20:27:32.877504,2025-02-25 20:27:45.818347,12.940843
channel-85077,61052,30347162,30347175,13,2025-02-25 20:38:10.209085,2025-02-25 20:38:25.079396,14.870311
channel-85077,61053,30347386,30347396,10,2025-02-25 20:42:59.704083,2025-02-25 20:43:11.519633,11.81555
channel-85077,61054,30347451,30347460,9,2025-02-25 20:44:21.091742,2025-02-25 20:44:36.220292,15.12855
channel-85077,61055,30347763,30347772,9,2025-02-25 20:51:03.861214,2025-02-25 20:51:15.411443,11.550229
channel-85077,61056,30347849,30347857,8,2025-02-25 20:52:54.597721,2025-02-25 20:53:05.186569,10.588848
channel-85077,61057,30347893,30347901,8,2025-02-25 20:53:53.207385,2025-02-25 20:54:05.310559,12.103174
channel-85077,61058,30347977,30347988,11,2025-02-25 20:55:40.964827,2025-02-25 20:55:54.342678,13.377851
channel-85077,61059,30348133,30348143,10,2025-02-25 20:59:03.032561,2025-02-25 20:59:14.496186,11.463625
channel-85077,61060,30348210,30348220,10,2025-02-25 21:00:38.793167,2025-02-25 21:00:52.815154,14.021987
channel-85077,61061,30348545,30348555,10,2025-02-25 21:07:57.741963,2025-02-25 21:08:10.614300,12.872337
channel-85077,61062,30348650,30348658,8,2025-02-25 21:10:14.765006,2025-02-25 21:10:25.248257,10.483251
channel-85077,61063,30348692,30348701,9,2025-02-25 21:11:07.773775,2025-02-25 21:11:19.433944,11.660169
channel-85077,61064,30348711,30348724,13,2025-02-25 21:11:35.081852,2025-02-25 21:11:50.752555,15.670703
channel-85077,61065,30348719,30348727,8,2025-02-25 21:11:45.084369,2025-02-25 21:11:55.377915,10.293546
channel-85077,61066,30348742,30348758,16,2025-02-25 21:12:14.399534,2025-02-25 21:12:34.723061,20.323527
channel-85077,61067,30348763,30348779,16,2025-02-25 21:12:41.472078,2025-02-25 21:13:02.599058,21.12698
channel-85077,61068,30348775,30348782,7,2025-02-25 21:12:57.053954,2025-02-25 21:13:10.081635,13.027681
channel-85077,61069,30348804,30348816,12,2025-02-25 21:13:35.489144,2025-02-25 21:13:49.222827,13.733683
channel-85077,61070,30348872,30348882,10,2025-02-25 21:15:02.909297,2025-02-25 21:15:16.651214,13.741917
channel-85077,61071,30348878,30348887,9,2025-02-25 21:15:11.891556,2025-02-25 21:15:23.537271,11.645715
channel-85077,61072,30349398,30349405,7,2025-02-25 21:26:21.724167,2025-02-25 21:26:31.730408,10.006241
channel-85077,61073,30349399,30349408,9,2025-02-25 21:26:22.905145,2025-02-25 21:26:36.239399,13.334254
channel-85077,61074,30349594,30349602,8,2025-02-25 21:30:32.413521,2025-02-25 21:30:41.633038,9.219517
channel-85077,61075,30349670,30349679,9,2025-02-25 21:32:08.290479,2025-02-25 21:32:18.589110,10.298631
channel-85077,61076,30350081,30350091,10,2025-02-25 21:40:56.981817,2025-02-25 21:41:10.374222,13.392405
channel-85077,61077,30350232,30350242,10,2025-02-25 21:44:08.208567,2025-02-25 21:44:19.291548,11.082981
channel-85077,61078,30350383,30350393,10,2025-02-25 21:47:24.509867,2025-02-25 21:47:35.936833,11.426966
channel-85077,61079,30350711,30350721,10,2025-02-25 21:54:25.800647,2025-02-25 21:54:37.180803,11.380156
channel-85077,61080,30350769,30350778,9,2025-02-25 21:55:38.483588,2025-02-25 21:55:53.776133,15.292545
channel-85077,61081,30351365,30351373,8,2025-02-25 22:08:32.127746,2025-02-25 22:08:43.827276,11.69953
channel-85077,61082,30351432,30351439,7,2025-02-25 22:09:59.582795,2025-02-25 22:10:08.129142,8.546347
channel-85077,61083,30351682,30351690,8,2025-02-25 22:15:22.306035,2025-02-25 22:15:32.816043,10.510008
channel-85077,61084,30351692,30351702,10,2025-02-25 22:15:34.986524,2025-02-25 22:15:46.832558,11.846034
channel-85077,61085,30351703,30351714,11,2025-02-25 22:15:47.925795,2025-02-25 22:16:01.662876,13.737081
channel-85077,61086,30351779,30351790,11,2025-02-25 22:17:28.552315,2025-02-25 22:17:41.237434,12.685119
channel-85077,61087,30351785,30351795,10,2025-02-25 22:17:35.592310,2025-02-25 22:17:47.709334,12.117024
channel-85077,61088,30351804,30351813,9,2025-02-25 22:18:02.962125,2025-02-25 22:18:15.281025,12.3189
channel-85077,61089,30351809,30351817,8,2025-02-25 22:18:09.489261,2025-02-25 22:18:21.267840,11.778579
channel-85077,61090,30352359,30352367,8,2025-02-25 22:29:53.477523,2025-02-25 22:30:03.348297,9.870774
channel-85077,61091,30352531,30352543,12,2025-02-25 22:33:34.680710,2025-02-25 22:33:49.224235,14.543525
channel-85077,61092,30352742,30352751,9,2025-02-25 22:38:05.307915,2025-02-25 22:38:16.766638,11.458723
channel-85077,61093,30353366,30353376,10,2025-02-25 22:51:29.637659,2025-02-25 22:51:41.606289,11.96863
channel-85077,61094,30353547,30353558,11,2025-02-25 22:55:20.724519,2025-02-25 22:55:34.694938,13.970419
channel-85077,61095,30353555,30353570,15,2025-02-25 22:55:31.209952,2025-02-25 22:55:49.717242,18.50729
channel-85077,61096,30354024,30354030,6,2025-02-25 23:05:29.112481,2025-02-25 23:05:40.513676,11.401195
channel-85077,61097,30354127,30354134,7,2025-02-25 23:07:43.229980,2025-02-25 23:07:52.268048,9.038068
channel-85077,61098,30354149,30354160,11,2025-02-25 23:08:14.400176,2025-02-25 23:08:27.861553,13.461377
channel-85077,61099,30355149,30355161,12,2025-02-25 23:29:44.727057,2025-02-25 23:29:59.088264,14.361207
channel-85077,61100,30355150,30355169,19,2025-02-25 23:29:45.838071,2025-02-25 23:30:09.960649,24.122578
channel-85077,61101,30355215,30355226,11,2025-02-25 23:31:09.756697,2025-02-25 23:31:22.592326,12.835629
channel-85077,61102,30355357,30355367,10,2025-02-25 23:34:12.337062,2025-02-25 23:34:23.725786,11.388724
channel-85077,61103,30355558,30355569,11,2025-02-25 23:38:28.437819,2025-02-25 23:38:42.465066,14.027247
channel-85077,61104,30356770,30356778,8,2025-02-26 00:04:28.631809,2025-02-26 00:04:42.165449,13.53364
channel-85077,61105,30356850,30356859,9,2025-02-26 00:06:13.532066,2025-02-26 00:06:24.608791,11.076725
channel-85077,61106,30357236,30357244,8,2025-02-26 00:14:28.762512,2025-02-26 00:14:39.655597,10.893085
channel-85077,61107,30357839,30357853,14,2025-02-26 00:27:31.031605,2025-02-26 00:27:49.404628,18.373023
channel-85077,61108,30357938,30357951,13,2025-02-26 00:29:37.481672,2025-02-26 00:29:53.070761,15.589089
channel-85077,61109,30358006,30358013,7,2025-02-26 00:31:03.200514,2025-02-26 00:31:12.295285,9.094771
channel-85077,61110,30358080,30358090,10,2025-02-26 00:32:40.109569,2025-02-26 00:32:52.448693,12.339124
channel-85077,61111,30358946,30358954,8,2025-02-26 00:51:16.760442,2025-02-26 00:51:26.603643,9.843201
channel-85077,61112,30359138,30359147,9,2025-02-26 00:55:23.768417,2025-02-26 00:55:35.100105,11.331688
channel-85077,61113,30359211,30359218,7,2025-02-26 00:56:55.472971,2025-02-26 00:57:07.058334,11.585363
channel-85077,61114,30359227,30359234,7,2025-02-26 00:57:17.570044,2025-02-26 00:57:29.388906,11.818862
channel-85077,61115,30360147,30360157,10,2025-02-26 01:17:14.769158,2025-02-26 01:17:26.587573,11.818415
channel-85077,61116,30360288,30360298,10,2025-02-26 01:20:21.197079,2025-02-26 01:20:33.766941,12.569862
channel-85077,61117,30360310,30360320,10,2025-02-26 01:20:48.199608,2025-02-26 01:21:02.708805,14.509197
channel-85077,61118,30360316,30360325,9,2025-02-26 01:20:57.106629,2025-02-26 01:21:08.373248,11.266619
channel-85077,61119,30360332,30360340,8,2025-02-26 01:21:16.237796,2025-02-26 01:21:27.115998,10.878202
channel-85077,61120,30360354,30360364,10,2025-02-26 01:21:47.111269,2025-02-26 01:21:58.308646,11.197377
channel-85077,61121,30360361,30360371,10,2025-02-26 01:21:54.880994,2025-02-26 01:22:07.074687,12.193693
channel-85077,61122,30360384,30360393,9,2025-02-26 01:22:23.942485,2025-02-26 01:22:35.693342,11.750857
channel-85077,61123,30360385,30360393,8,2025-02-26 01:22:25.181288,2025-02-26 01:22:35.693342,10.512054
channel-85077,61124,30360408,30360419,11,2025-02-26 01:22:53.598222,2025-02-26 01:23:06.066884,12.468662
channel-85077,61125,30360434,30360439,5,2025-02-26 01:23:25.318462,2025-02-26 01:23:36.184925,10.866463
channel-85077,61126,30360623,30360630,7,2025-02-26 01:27:30.641065,2025-02-26 01:27:41.853320,11.212255
channel-85077,61127,30360837,30360847,10,2025-02-26 01:32:11.025601,2025-02-26 01:32:22.632701,11.6071
channel-85077,61128,30361141,30361151,10,2025-02-26 01:38:45.068773,2025-02-26 01:38:57.530128,12.461355
channel-85077,61129,30361257,30361267,10,2025-02-26 01:41:16.777882,2025-02-26 01:41:28.441096,11.663214
channel-85077,61130,30361324,30361333,9,2025-02-26 01:42:39.267695,2025-02-26 01:42:53.648890,14.381195
channel-85077,61131,30361339,30361347,8,2025-02-26 01:43:00.573531,2025-02-26 01:43:10.576611,10.00308
channel-85077,61132,30361348,30361358,10,2025-02-26 01:43:11.818543,2025-02-26 01:43:25.185949,13.367406
channel-85077,61133,30361366,30361376,10,2025-02-26 01:43:34.583371,2025-02-26 01:43:47.072529,12.489158
channel-85077,61134,30361414,30361436,22,2025-02-26 01:44:36.109564,2025-02-26 01:45:02.914407,26.804843
channel-85077,61135,30361438,30361447,9,2025-02-26 01:45:05.068836,2025-02-26 01:45:17.595319,12.526483
channel-85077,61136,30361445,30361456,11,2025-02-26 01:45:14.041002,2025-02-26 01:45:28.950079,14.909077
channel-85077,61150,30361797,30361807,10,2025-02-26 01:52:45.945507,2025-02-26 01:52:57.372938,11.427431
channel-85077,61151,30361800,30361814,14,2025-02-26 01:52:49.301441,2025-02-26 01:53:06.359608,17.058167
channel-85077,61152,30361808,30361821,13,2025-02-26 01:52:58.495713,2025-02-26 01:53:15.756357,17.260644
channel-85077,61153,30361823,30361831,8,2025-02-26 01:53:19.262517,2025-02-26 01:53:29.592008,10.329491
channel-85077,61154,30361832,30361860,28,2025-02-26 01:53:30.659285,2025-02-26 01:54:05.159577,34.500292
channel-85077,61155,30361837,30361847,10,2025-02-26 01:53:37.717109,2025-02-26 01:53:49.329295,11.612186
channel-85077,61156,30361863,30361871,8,2025-02-26 01:54:08.979304,2025-02-26 01:54:19.284827,10.305523
channel-85077,61157,30361875,30361891,16,2025-02-26 01:54:23.666771,2025-02-26 01:54:45.038457,21.371686
channel-85077,61158,30361895,30361902,7,2025-02-26 01:54:50.304964,2025-02-26 01:55:02.433060,12.128096
channel-85077,61159,30361901,30361911,10,2025-02-26 01:54:57.132285,2025-02-26 01:55:12.510085,15.3778
channel-85077,61160,30361954,30361962,8,2025-02-26 01:56:08.930143,2025-02-26 01:56:18.788506,9.858363
channel-85077,61161,30361979,30361988,9,2025-02-26 01:56:40.750283,2025-02-26 01:56:53.466086,12.715803
channel-85077,61162,30361980,30361991,11,2025-02-26 01:56:41.945015,2025-02-26 01:56:56.902727,14.957712
channel-85077,61163,30362004,30362020,16,2025-02-26 01:57:12.765621,2025-02-26 01:57:32.441123,19.675502
channel-85077,61164,30362010,30362025,15,2025-02-26 01:57:19.800488,2025-02-26 01:57:38.699399,18.898911
channel-85077,61165,30362031,30362042,11,2025-02-26 01:57:46.964263,2025-02-26 01:58:00.523604,13.559341
channel-85077,61166,30362043,30362054,11,2025-02-26 01:58:01.832713,2025-02-26 01:58:15.676555,13.843842
channel-85077,61167,30362053,30362065,12,2025-02-26 01:58:14.332914,2025-02-26 01:58:29.175289,14.842375
channel-85077,61168,30362066,30362078,12,2025-02-26 01:58:30.442122,2025-02-26 01:58:46.603935,16.161813
channel-85077,61169,30362097,30362107,10,2025-02-26 01:59:08.975748,2025-02-26 01:59:21.859482,12.883734
channel-85077,61170,30362115,30362124,9,2025-02-26 01:59:31.108221,2025-02-26 01:59:43.412078,12.303857
channel-85077,61171,30362120,30362139,19,2025-02-26 01:59:36.837320,2025-02-26 02:00:01.469060,24.63174
channel-85077,61172,30362145,30362158,13,2025-02-26 02:00:12.098413,2025-02-26 02:00:26.848155,14.749742
channel-85077,61173,30362176,30362187,11,2025-02-26 02:00:51.791864,2025-02-26 02:01:04.746367,12.954503
channel-85077,61174,30362180,30362189,9,2025-02-26 02:00:56.599939,2025-02-26 02:01:07.012621,10.412682
channel-85077,61175,30362188,30362199,11,2025-02-26 02:01:05.839613,2025-02-26 02:01:19.036890,13.197277
channel-85077,61176,30362202,30362210,8,2025-02-26 02:01:22.557397,2025-02-26 02:01:34.072242,11.514845
channel-85077,61177,30362512,30362524,12,2025-02-26 02:08:01.395997,2025-02-26 02:08:15.180613,13.784616
channel-85077,61178,30362607,30362621,14,2025-02-26 02:10:00.041393,2025-02-26 02:10:16.241547,16.200154
channel-85077,61179,30362617,30362626,9,2025-02-26 02:10:11.845618,2025-02-26 02:10:23.050512,11.204894
channel-85077,61180,30362620,30362631,11,2025-02-26 02:10:15.160492,2025-02-26 02:10:30.670110,15.509618
channel-85077,61181,30362637,30362646,9,2025-02-26 02:10:37.494880,2025-02-26 02:10:48.029058,10.534178
channel-85077,61182,30362650,30362661,11,2025-02-26 02:10:52.593997,2025-02-26 02:11:06.094408,13.500411
channel-85077,61183,30362665,30362676,11,2025-02-26 02:11:10.875863,2025-02-26 02:11:23.525691,12.649828
channel-85077,61184,30362680,30362688,8,2025-02-26 02:11:29.024834,2025-02-26 02:11:40.631118,11.606284
channel-85077,61185,30362686,30362694,8,2025-02-26 02:11:38.340955,2025-02-26 02:11:48.381703,10.040748
channel-85077,61186,30362708,30362716,8,2025-02-26 02:12:07.753223,2025-02-26 02:12:18.421268,10.668045
channel-85077,61187,30362716,30362724,8,2025-02-26 02:12:18.421268,2025-02-26 02:12:28.567179,10.145911
channel-85077,61188,30362729,30362749,20,2025-02-26 02:12:34.363374,2025-02-26 02:12:59.759490,25.396116
channel-85077,61189,30362748,30362758,10,2025-02-26 02:12:57.681515,2025-02-26 02:13:09.935822,12.254307
channel-85077,61190,30362764,30362773,9,2025-02-26 02:13:17.085050,2025-02-26 02:13:29.629657,12.544607
channel-85077,61191,30362786,30362796,10,2025-02-26 02:13:50.009755,2025-02-26 02:14:02.605997,12.596242
channel-85077,61192,30362798,30362808,10,2025-02-26 02:14:04.925660,2025-02-26 02:14:16.720028,11.794368
channel-85077,61193,30362812,30362825,13,2025-02-26 02:14:21.229130,2025-02-26 02:14:37.578302,16.349172
channel-85077,61194,30362826,30362837,11,2025-02-26 02:14:38.720052,2025-02-26 02:14:51.620506,12.900454
channel-85077,61195,30362854,30362866,12,2025-02-26 02:15:14.646688,2025-02-26 02:15:29.567747,14.921059
channel-85077,61196,30362858,30362887,29,2025-02-26 02:15:19.229638,2025-02-26 02:15:54.790801,35.561163
channel-85077,61197,30362875,30362887,12,2025-02-26 02:15:41.126189,2025-02-26 02:15:54.790801,13.664612
channel-85077,61198,30362889,30362898,9,2025-02-26 02:15:57.075321,2025-02-26 02:16:09.545252,12.469931
channel-85077,61199,30362899,30362911,12,2025-02-26 02:16:10.707907,2025-02-26 02:16:24.605840,13.897933
channel-85077,61200,30362925,30362933,8,2025-02-26 02:16:40.678417,2025-02-26 02:16:52.588483,11.910066
channel-85077,61201,30362930,30362948,18,2025-02-26 02:16:46.998554,2025-02-26 02:17:14.461146,27.462592
channel-85077,61202,30362946,30362983,37,2025-02-26 02:17:12.218654,2025-02-26 02:17:59.127984,46.90933
channel-85077,61203,30362959,30362969,10,2025-02-26 02:17:27.831863,2025-02-26 02:17:39.844835,12.012972
channel-85077,61204,30362975,30362989,14,2025-02-26 02:17:46.675177,2025-02-26 02:18:08.745854,22.070677
channel-85077,61205,30363004,30363016,12,2025-02-26 02:18:27.766592,2025-02-26 02:18:41.437534,13.670942
channel-85077,61206,30363016,30363026,10,2025-02-26 02:18:41.437534,2025-02-26 02:18:52.774402,11.336868
channel-85077,61207,30363031,30363040,9,2025-02-26 02:19:00.111334,2025-02-26 02:19:12.553186,12.441852
channel-85077,61208,30363044,30363056,12,2025-02-26 02:19:17.064860,2025-02-26 02:19:30.741299,13.676439
channel-85077,61209,30363049,30363059,10,2025-02-26 02:19:22.567384,2025-02-26 02:19:34.253993,11.686609
channel-85077,61210,30363127,30363138,11,2025-02-26 02:21:01.885542,2025-02-26 02:21:15.735472,13.84993
channel-85077,61211,30363226,30363234,8,2025-02-26 02:23:12.932972,2025-02-26 02:23:23.456926,10.523954
channel-85077,61212,30363241,30363260,19,2025-02-26 02:23:31.219112,2025-02-26 02:23:54.983776,23.764664
channel-85077,61213,30363249,30363260,11,2025-02-26 02:23:42.169032,2025-02-26 02:23:54.983776,12.814744
channel-85077,61214,30363306,30363315,9,2025-02-26 02:24:53.260204,2025-02-26 02:25:04.435886,11.175682
channel-85077,61215,30363475,30363490,15,2025-02-26 02:28:29.990611,2025-02-26 02:28:47.103791,17.11318
channel-85077,61216,30363479,30363490,11,2025-02-26 02:28:34.594036,2025-02-26 02:28:47.103791,12.509755
channel-85077,61217,30363498,30363509,11,2025-02-26 02:28:57.218831,2025-02-26 02:29:11.960676,14.741845
channel-85077,61218,30363537,30363548,11,2025-02-26 02:29:46.382667,2025-02-26 02:30:00.653036,14.270369
channel-85077,61219,30363574,30363583,9,2025-02-26 02:30:33.814560,2025-02-26 02:30:44.405129,10.590569
channel-85077,61220,30363715,30363726,11,2025-02-26 02:33:39.653972,2025-02-26 02:33:52.148344,12.494372
channel-85077,61221,30363807,30363816,9,2025-02-26 02:35:31.578405,2025-02-26 02:35:43.067939,11.489534
channel-85077,61222,30363911,30363921,10,2025-02-26 02:37:45.419040,2025-02-26 02:37:58.010705,12.591665
channel-85077,61223,30364429,30364439,10,2025-02-26 02:48:48.127875,2025-02-26 02:49:01.389690,13.261815
channel-85077,61224,30364639,30364650,11,2025-02-26 02:53:17.377793,2025-02-26 02:53:33.329532,15.951739
channel-85077,61225,30364751,30364762,11,2025-02-26 02:55:48.110927,2025-02-26 02:56:00.704903,12.593976
channel-85077,61226,30365209,30365218,9,2025-02-26 03:05:39.619203,2025-02-26 03:05:51.428127,11.808924
channel-85077,61227,30365226,30365236,10,2025-02-26 03:06:00.565378,2025-02-26 03:06:12.329429,11.764051
channel-85077,61228,30365735,30365744,9,2025-02-26 03:16:47.690180,2025-02-26 03:16:59.197208,11.507028
channel-85077,61229,30365737,30365746,9,2025-02-26 03:16:50.351428,2025-02-26 03:17:02.083064,11.731636
channel-85077,61230,30365755,30365765,10,2025-02-26 03:17:13.420880,2025-02-26 03:17:25.167908,11.747028
channel-85077,61231,30366282,30366291,9,2025-02-26 03:28:23.637361,2025-02-26 03:28:37.798316,14.160955
channel-85077,61232,30366630,30366642,12,2025-02-26 03:35:51.154756,2025-02-26 03:36:04.718660,13.563904
channel-85077,61233,30366687,30366697,10,2025-02-26 03:37:05.584171,2025-02-26 03:37:17.017752,11.433581
channel-85077,61234,30367155,30367167,12,2025-02-26 03:47:14.296956,2025-02-26 03:47:29.909229,15.612273
channel-85077,61235,30367352,30367364,12,2025-02-26 03:51:28.172268,2025-02-26 03:51:41.793600,13.621332
channel-85077,61236,30367740,30367750,10,2025-02-26 03:59:48.359940,2025-02-26 04:00:00.830283,12.470343
channel-85077,61237,30368289,30368295,6,2025-02-26 04:11:28.233528,2025-02-26 04:11:39.383118,11.14959
channel-85077,61238,30368334,30368343,9,2025-02-26 04:12:29.401060,2025-02-26 04:12:42.494476,13.093416
channel-85077,61239,30368423,30368431,8,2025-02-26 04:14:22.663014,2025-02-26 04:14:32.672048,10.009034
channel-85077,61240,30368708,30368719,11,2025-02-26 04:20:26.117655,2025-02-26 04:20:38.642780,12.525125
channel-85077,61241,30368852,30368863,11,2025-02-26 04:23:30.014486,2025-02-26 04:23:42.493130,12.478644
channel-85077,61242,30369096,30369106,10,2025-02-26 04:28:36.753823,2025-02-26 04:28:49.593900,12.840077
channel-85077,61243,30369148,30369156,8,2025-02-26 04:29:44.336074,2025-02-26 04:29:55.937050,11.600976
channel-85077,61244,30369275,30369286,11,2025-02-26 04:32:31.250798,2025-02-26 04:32:43.428957,12.178159
channel-85077,61245,30369292,30369302,10,2025-02-26 04:32:50.142434,2025-02-26 04:33:02.877672,12.735238
channel-85077,61246,30369300,30369310,10,2025-02-26 04:32:59.380054,2025-02-26 04:33:13.919229,14.539175
channel-85077,61247,30369549,30369556,7,2025-02-26 04:38:18.442654,2025-02-26 04:38:27.504410,9.061756
channel-85077,61248,30369793,30369810,17,2025-02-26 04:43:28.973028,2025-02-26 04:43:49.838651,20.865623
channel-85077,61249,30369794,30369805,11,2025-02-26 04:43:30.150467,2025-02-26 04:43:43.811715,13.661248
channel-85077,61250,30369807,30369817,10,2025-02-26 04:43:46.245523,2025-02-26 04:43:57.526114,11.280591
channel-85077,61251,30369992,30370003,11,2025-02-26 04:47:40.943247,2025-02-26 04:47:53.500712,12.557465
channel-85077,61252,30370613,30370624,11,2025-02-26 05:00:57.570415,2025-02-26 05:01:10.268960,12.698545
channel-85077,61253,30371139,30371147,8,2025-02-26 05:12:10.735617,2025-02-26 05:12:24.961348,14.225731
channel-85077,61254,30371170,30371178,8,2025-02-26 05:12:51.243283,2025-02-26 05:13:01.577831,10.334548
channel-85077,61255,30372193,30372202,9,2025-02-26 05:34:46.207517,2025-02-26 05:34:57.404758,11.197241
channel-85077,61256,30372725,30372736,11,2025-02-26 05:46:07.379712,2025-02-26 05:46:19.986299,12.606587
channel-85077,61257,30372746,30372771,25,2025-02-26 05:46:33.405838,2025-02-26 05:47:04.112165,30.706327
channel-85077,61258,30372746,30372756,10,2025-02-26 05:46:33.405838,2025-02-26 05:46:46.154886,12.749048
channel-85077,61259,30372749,30372759,10,2025-02-26 05:46:37.929357,2025-02-26 05:46:49.689148,11.759791
channel-85077,61260,30372775,30372783,8,2025-02-26 05:47:08.709206,2025-02-26 05:47:18.345008,9.635802
channel-85077,61261,30372790,30372809,19,2025-02-26 05:47:30.588131,2025-02-26 05:47:52.782254,22.194123
channel-85077,61262,30372801,30372818,17,2025-02-26 05:47:42.706750,2025-02-26 05:48:04.181044,21.474294
channel-85077,61263,30372830,30372841,11,2025-02-26 05:48:19.329384,2025-02-26 05:48:32.059983,12.730599
channel-85077,61264,30372841,30372859,18,2025-02-26 05:48:32.059983,2025-02-26 05:48:56.840040,24.780057
channel-85077,61265,30372855,30372868,13,2025-02-26 05:48:51.084834,2025-02-26 05:49:09.118258,18.033424
channel-85077,61266,30372861,30372880,19,2025-02-26 05:48:59.068927,2025-02-26 05:49:24.590578,25.521651
channel-85077,61267,30372872,30372889,17,2025-02-26 05:49:15.274851,2025-02-26 05:49:34.677196,19.402345
channel-85077,61268,30372881,30372892,11,2025-02-26 05:49:25.759666,2025-02-26 05:49:38.191392,12.431726
channel-85077,61269,30372902,30372908,6,2025-02-26 05:49:50.431030,2025-02-26 05:50:00.563204,10.132174
channel-85077,61270,30372913,30372923,10,2025-02-26 05:50:07.633767,2025-02-26 05:50:20.223817,12.59005
channel-85077,61271,30372936,30372945,9,2025-02-26 05:50:35.775681,2025-02-26 05:50:46.259033,10.483352
channel-85077,61272,30372939,30372948,9,2025-02-26 05:50:39.326853,2025-02-26 05:50:49.704099,10.377246
channel-85077,61273,30372972,30372982,10,2025-02-26 05:51:21.825839,2025-02-26 05:51:35.755580,13.929741
channel-85077,61274,30372992,30373002,10,2025-02-26 05:51:48.237560,2025-02-26 05:52:00.006580,11.76902
channel-85077,61275,30373002,30373011,9,2025-02-26 05:52:00.006580,2025-02-26 05:52:10.349643,10.343063
channel-85077,61276,30373023,30373035,12,2025-02-26 05:52:25.436620,2025-02-26 05:52:39.761199,14.324579
channel-85077,61277,30373063,30373081,18,2025-02-26 05:53:15.679733,2025-02-26 05:53:39.506963,23.82723
channel-85077,61278,30373089,30373100,11,2025-02-26 05:53:50.405577,2025-02-26 05:54:02.886108,12.480531
channel-85077,61279,30373091,30373109,18,2025-02-26 05:53:52.680518,2025-02-26 05:54:14.493902,21.813384
channel-85077,61280,30373121,30373131,10,2025-02-26 05:54:32.818703,2025-02-26 05:54:45.586342,12.767639
channel-85077,61281,30373141,30373150,9,2025-02-26 05:54:58.432509,2025-02-26 05:55:09.689480,11.256971
channel-85077,61282,30373161,30373170,9,2025-02-26 05:55:23.390285,2025-02-26 05:55:33.573293,10.183008
channel-85077,61283,30373201,30373210,9,2025-02-26 05:56:13.071760,2025-02-26 05:56:25.412188,12.340428
channel-85077,61284,30373212,30373231,19,2025-02-26 05:56:29.205465,2025-02-26 05:56:51.319799,22.114334
channel-85077,61285,30373246,30373256,10,2025-02-26 05:57:09.301211,2025-02-26 05:57:21.861067,12.559856
channel-85077,61286,30373274,30373283,9,2025-02-26 05:57:42.172851,2025-02-26 05:57:52.915669,10.742818
channel-85077,61287,30373276,30373283,7,2025-02-26 05:57:44.364582,2025-02-26 05:57:52.915669,8.551087
channel-85077,61288,30373351,30373361,10,2025-02-26 05:59:25.294253,2025-02-26 05:59:37.053016,11.758763
channel-85077,61289,30373387,30373395,8,2025-02-26 06:00:12.223718,2025-02-26 06:00:24.737140,12.513422
channel-85077,61290,30373566,30373578,12,2025-02-26 06:04:10.849183,2025-02-26 06:04:24.937689,14.088506
channel-85077,61291,30373589,30373600,11,2025-02-26 06:04:38.990332,2025-02-26 06:04:52.693556,13.703224
channel-85077,61292,30373612,30373622,10,2025-02-26 06:05:11.085533,2025-02-26 06:05:23.122519,12.036986
channel-85077,61293,30373638,30373647,9,2025-02-26 06:05:42.359366,2025-02-26 06:05:54.335714,11.976348
channel-85077,61294,30373664,30373674,10,2025-02-26 06:06:14.462566,2025-02-26 06:06:26.660928,12.198362
channel-85077,61295,30373688,30373697,9,2025-02-26 06:06:44.118054,2025-02-26 06:06:54.269837,10.151783
channel-85077,61296,30373982,30373989,7,2025-02-26 06:13:05.211871,2025-02-26 06:13:14.052905,8.841034
channel-85077,61297,30374372,30374381,9,2025-02-26 06:21:22.140896,2025-02-26 06:21:36.611135,14.470239
channel-85077,61298,30374532,30374542,10,2025-02-26 06:24:43.115185,2025-02-26 06:24:54.477026,11.361841
channel-85077,61299,30374714,30374723,9,2025-02-26 06:28:39.788461,2025-02-26 06:28:51.012964,11.224503
channel-85077,61300,30374791,30374811,20,2025-02-26 06:30:18.968764,2025-02-26 06:30:43.874623,24.905859
channel-85077,61301,30374829,30374840,11,2025-02-26 06:31:04.861529,2025-02-26 06:31:18.276946,13.415417
channel-85077,61302,30374853,30374861,8,2025-02-26 06:31:35.539025,2025-02-26 06:31:47.151261,11.612236
channel-85077,61303,30375105,30375112,7,2025-02-26 06:36:58.932104,2025-02-26 06:37:09.466208,10.534104
channel-85077,61304,30375338,30375347,9,2025-02-26 06:41:52.959592,2025-02-26 06:42:03.700048,10.740456
channel-85077,61305,30375339,30375350,11,2025-02-26 06:41:54.201035,2025-02-26 06:42:07.256704,13.055669
channel-85077,61306,30375370,30375387,17,2025-02-26 06:42:31.755183,2025-02-26 06:42:54.093989,22.338806
channel-85077,61307,30375391,30375402,11,2025-02-26 06:42:59.840739,2025-02-26 06:43:13.492683,13.651944
channel-85077,61308,30375414,30375424,10,2025-02-26 06:43:28.110101,2025-02-26 06:43:45.387978,17.277877
channel-85077,61309,30375515,30375524,9,2025-02-26 06:45:42.284855,2025-02-26 06:45:53.961111,11.676256
channel-85077,61310,30375523,30375533,10,2025-02-26 06:45:52.832171,2025-02-26 06:46:04.139264,11.307093
channel-85077,61311,30375685,30375696,11,2025-02-26 06:49:22.608496,2025-02-26 06:49:35.544429,12.935933
channel-85077,61312,30375809,30375817,8,2025-02-26 06:51:59.460700,2025-02-26 06:52:11.424008,11.963308
channel-85077,61313,30375874,30375885,11,2025-02-26 06:53:22.057498,2025-02-26 06:53:35.018842,12.961344
channel-85077,61314,30375908,30375915,7,2025-02-26 06:54:05.353966,2025-02-26 06:54:14.965818,9.611852
channel-85077,61315,30375955,30375965,10,2025-02-26 06:55:02.921483,2025-02-26 06:55:15.405434,12.483951
channel-85077,61316,30375986,30375995,9,2025-02-26 06:55:43.749735,2025-02-26 06:55:54.263169,10.513434
channel-85077,61317,30376031,30376042,11,2025-02-26 06:56:41.873805,2025-02-26 06:56:54.390936,12.517131
channel-85077,61318,30376050,30376060,10,2025-02-26 06:57:05.645733,2025-02-26 06:57:18.680684,13.034951
channel-85077,61319,30376061,30376071,10,2025-02-26 06:57:21.005656,2025-02-26 06:57:36.000155,14.994499
channel-85077,61320,30376099,30376107,8,2025-02-26 06:58:12.252730,2025-02-26 06:58:22.609416,10.356686
channel-85077,61321,30376148,30376156,8,2025-02-26 06:59:10.897764,2025-02-26 06:59:21.802244,10.90448
channel-85077,61322,30376151,30376161,10,2025-02-26 06:59:14.241368,2025-02-26 06:59:28.048822,13.807454
channel-85077,61323,30376170,30376181,11,2025-02-26 06:59:39.374811,2025-02-26 06:59:53.121041,13.74623
channel-85077,61324,30376176,30376187,11,2025-02-26 06:59:46.320300,2025-02-26 06:59:59.791428,13.471128
channel-85077,61325,30376232,30376240,8,2025-02-26 07:00:56.601075,2025-02-26 07:01:06.613795,10.01272
channel-85077,61326,30376242,30376250,8,2025-02-26 07:01:11.654720,2025-02-26 07:01:23.807227,12.152507
channel-85077,61327,30376314,30376323,9,2025-02-26 07:02:43.545718,2025-02-26 07:02:58.074368,14.52865
channel-85077,61328,30376378,30376387,9,2025-02-26 07:04:06.726774,2025-02-26 07:04:19.080404,12.35363
channel-85077,61329,30376432,30376441,9,2025-02-26 07:05:17.479888,2025-02-26 07:05:31.262535,13.782647
channel-85077,61330,30376635,30376645,10,2025-02-26 07:09:34.237689,2025-02-26 07:09:46.023930,11.786241
channel-85077,61331,30376844,30376852,8,2025-02-26 07:14:03.839724,2025-02-26 07:14:15.537274,11.69755
channel-85077,61332,30377158,30377169,11,2025-02-26 07:20:45.104716,2025-02-26 07:20:58.526549,13.421833
channel-85077,61333,30377411,30377419,8,2025-02-26 07:26:06.148627,2025-02-26 07:26:16.957637,10.80901
channel-85077,61334,30377457,30377468,11,2025-02-26 07:27:04.622936,2025-02-26 07:27:19.328586,14.70565
channel-85077,61335,30378096,30378104,8,2025-02-26 07:40:38.696789,2025-02-26 07:40:51.128493,12.431704
channel-85077,61336,30378307,30378316,9,2025-02-26 07:45:16.847492,2025-02-26 07:45:28.258542,11.41105
channel-85077,61337,30378629,30378640,11,2025-02-26 07:52:07.550697,2025-02-26 07:52:20.832761,13.282064
channel-85077,61338,30378686,30378699,13,2025-02-26 07:53:18.909349,2025-02-26 07:53:36.354078,17.444729
channel-85077,61339,30378696,30378705,9,2025-02-26 07:53:32.893506,2025-02-26 07:53:43.479232,10.585726
channel-85077,61340,30378807,30378817,10,2025-02-26 07:55:52.944325,2025-02-26 07:56:05.575860,12.631535
channel-85077,61341,30378822,30378830,8,2025-02-26 07:56:12.164395,2025-02-26 07:56:22.831537,10.667142
channel-85077,61342,30378979,30378988,9,2025-02-26 07:59:36.019602,2025-02-26 07:59:48.476176,12.456574
channel-85077,61343,30379035,30379045,10,2025-02-26 08:00:48.515064,2025-02-26 08:01:00.956128,12.441064
channel-85077,61344,30379045,30379055,10,2025-02-26 08:01:00.956128,2025-02-26 08:01:12.616319,11.660191
channel-85077,61345,30379106,30379118,12,2025-02-26 08:02:18.211252,2025-02-26 08:02:31.785000,13.573748
channel-85077,61346,30379136,30379145,9,2025-02-26 08:02:56.489244,2025-02-26 08:03:07.637001,11.147757
channel-85077,61347,30379169,30379178,9,2025-02-26 08:03:40.309703,2025-02-26 08:03:56.020783,15.71108
channel-85077,61348,30379171,30379180,9,2025-02-26 08:03:47.139405,2025-02-26 08:03:59.415084,12.275679
channel-85077,61349,30379363,30379372,9,2025-02-26 08:07:47.874205,2025-02-26 08:07:59.213937,11.339732
channel-85077,61350,30379756,30379768,12,2025-02-26 08:16:14.035847,2025-02-26 08:16:28.802550,14.766703
channel-85077,61351,30379789,30379797,8,2025-02-26 08:16:55.429579,2025-02-26 08:17:05.724595,10.295016
channel-85077,61352,30379802,30379812,10,2025-02-26 08:17:11.564276,2025-02-26 08:17:23.827814,12.263538
channel-85077,61353,30379815,30379823,8,2025-02-26 08:17:27.179950,2025-02-26 08:17:37.530500,10.35055
channel-85077,61354,30379937,30379946,9,2025-02-26 08:20:00.242738,2025-02-26 08:20:12.179133,11.936395
